horse_num,oriental_1,oriental_2,oriental_3,oriental_sum,apple_1,apple_2,apple_3,apple_sum,pro_1,pro_2,pro_3,pro_sum,total_1,total_2,total_3,total_sum,w_h_odd,s_b_odd,result,file_name,sheet_name,W.H. FixOdd 60,S.B.Fix Odd 60
1,4,2,0,6,2,1,1,4,3,2,3,8,9,5,4,18,11,11,0.0,M2018-04-11D,Race(1),,
2,0,3,5,8,1,1,3,5,4,3,3,10,5,7,11,23,10,10,0.0,M2018-04-11D,Race(1),,
3,0,0,0,0,0,0,0,0,0,0,0,0,0,0,0,0,41,41,0.0,M2018-04-11D,Race(1),,
4,3,2,0,5,2,1,11,14,3,1,1,5,8,4,12,24,8,8,0.0,M2018-04-11D,Race(1),,
5,3,2,5,10,3,3,3,9,2,5,0,7,8,10,8,26,4.6,4.6,0.0,M2018-04-11D,Race(1),,
6,0,0,0,0,1,1,0,2,0,1,0,1,1,2,0,3,11,11,1.0,M2018-04-11D,Race(1),,
7,3,6,12,21,5,13,6,24,4,4,9,17,12,23,27,62,4.6,4.6,0.0,M2018-04-11D,Race(1),,
8,0,0,2,2,0,0,1,1,0,0,0,0,0,0,3,3,15,15,0.0,M2018-04-11D,Race(1),,
9,2,8,0,10,0,2,4,6,0,1,5,6,2,11,9,22,7,7,0.0,M2018-04-11D,Race(1),,
10,15,7,3,25,16,6,1,23,9,7,3,19,40,20,7,67,4.8,4.8,2.0,M2018-04-11D,Race(1),,
11,0,0,0,0,0,0,0,0,0,0,0,0,0,0,0,0,34,34,0.0,M2018-04-11D,Race(1),,
12,0,0,3,3,0,0,0,0,0,1,1,2,0,1,4,5,34,34,3.0,M2018-04-11D,Race(1),,
1,5,0,5,10,6,13,3,22,5,8,1,14,16,21,9,46,9,9,3.0,M2018-04-11D,Race(2),,
2,13,9,2,24,18,8,2,28,17,4,2,23,48,21,6,75,2.6,2.6,0.0,M2018-04-11D,Race(2),,
3,0,11,2,13,1,1,2,4,3,1,7,11,4,13,11,28,7,7,0.0,M2018-04-11D,Race(2),,
4,0,0,10,10,2,0,2,4,0,3,1,4,2,3,13,18,5.5,5.5,1.0,M2018-04-11D,Race(2),,
5,0,0,5,5,0,1,2,3,0,1,5,6,0,2,12,14,14,14,0.0,M2018-04-11D,Race(2),,
6,2,2,0,4,0,1,0,1,0,3,0,3,2,6,0,8,17,17,0.0,M2018-04-11D,Race(2),,
7,0,0,0,0,0,0,0,0,0,0,1,1,0,0,1,1,15,15,0.0,M2018-04-11D,Race(2),,
8,0,0,0,0,0,2,1,3,0,1,0,1,0,3,1,4,21,21,0.0,M2018-04-11D,Race(2),,
9,0,0,0,0,0,0,1,1,0,0,1,1,0,0,2,2,41,41,0.0,M2018-04-11D,Race(2),,
10,0,2,0,2,1,0,2,3,0,1,2,3,1,3,4,8,15,15,0.0,M2018-04-11D,Race(2),,
11,10,6,6,22,2,3,15,20,1,4,6,11,13,13,27,53,7,7,2.0,M2018-04-11D,Race(2),,
12,0,0,0,0,0,0,0,0,0,0,0,0,0,0,0,0,21,21,0.0,M2018-04-11D,Race(2),,
1,0,0,0,0,0,0,0,0,0,0,0,0,0,0,0,0,41,41,0.0,M2018-04-11D,Race(3),,
2,0,0,2,2,3,4,3,10,0,7,1,8,3,11,6,20,10,10,0.0,M2018-04-11D,Race(3),,
3,17,7,0,24,6,19,3,28,9,8,6,23,32,34,9,75,3.3,3.3,3.0,M2018-04-11D,Race(3),,
4,0,3,0,3,0,0,0,0,0,0,0,0,0,3,0,3,26,26,0.0,M2018-04-11D,Race(3),,
5,2,11,5,18,1,0,14,15,1,0,7,8,4,11,26,41,4.8,4.8,2.0,M2018-04-11D,Race(3),,
6,0,0,0,0,0,0,0,0,0,0,0,0,0,0,0,0,126,126,0.0,M2018-04-11D,Race(3),,
7,0,4,3,7,1,0,0,1,1,2,0,3,2,6,3,11,13,13,0.0,M2018-04-11D,Race(3),,
8,0,0,0,0,0,0,0,0,0,2,0,2,0,2,0,2,31,31,0.0,M2018-04-11D,Race(3),,
9,3,0,8,11,0,0,1,1,0,0,1,1,3,0,10,13,6,6,0.0,M2018-04-11D,Race(3),,
10,0,0,0,0,0,0,0,0,0,0,0,0,0,0,0,0,71,71,0.0,M2018-04-11D,Race(3),,
11,8,5,12,25,5,2,5,12,5,3,5,13,18,10,22,50,2.8,2.8,1.0,M2018-04-11D,Race(3),,
12,0,0,0,0,0,0,0,0,0,0,0,0,0,0,0,0,51,51,0.0,M2018-04-11D,Race(3),,
1,12,7,2,21,10,12,3,25,7,7,3,17,29,26,8,63,3.8,3.8,2.0,M2018-04-11D,Race(4),,
2,0,0,2,2,1,0,2,3,1,1,3,5,2,1,7,10,26,26,0.0,M2018-04-11D,Race(4),,
3,0,3,2,5,0,0,0,0,0,0,0,0,0,3,2,5,26,26,0.0,M2018-04-11D,Race(4),,
4,9,14,2,25,17,9,2,28,15,8,1,24,41,31,5,77,3,3,0.0,M2018-04-11D,Race(4),,
5,0,0,0,0,0,0,0,0,0,0,0,0,0,0,0,0,11,11,3.0,M2018-04-11D,Race(4),,
6,2,0,5,7,1,0,2,3,0,1,3,4,3,1,10,14,14,14,0.0,M2018-04-11D,Race(4),,
7,2,2,6,10,1,3,1,5,1,3,1,5,4,8,8,20,8,8,1.0,M2018-04-11D,Race(4),,
8,3,2,0,5,0,0,0,0,0,0,0,0,3,2,0,5,12,12,0.0,M2018-04-11D,Race(4),,
9,2,0,3,5,0,1,2,3,0,2,2,4,2,3,7,12,6,6,0.0,M2018-04-11D,Race(4),,
10,0,2,0,2,0,0,1,1,0,0,5,5,0,2,6,8,17,17,0.0,M2018-04-11D,Race(4),,
11,0,0,8,8,0,2,3,5,1,2,1,4,1,4,12,17,17,17,0.0,M2018-04-11D,Race(4),,
12,0,0,0,0,0,0,0,0,0,0,0,0,0,0,0,0,61,61,0.0,M2018-04-11D,Race(4),,
1,13,10,5,28,16,7,5,28,8,10,3,21,37,27,13,77,3.2,3.2,1.0,M2018-04-11D,Race(5),,
2,0,2,0,2,0,0,2,2,4,1,3,8,4,3,5,12,16,16,0.0,M2018-04-11D,Race(5),,
3,0,0,0,0,0,0,0,0,0,0,0,0,0,0,0,0,12,12,3.0,M2018-04-11D,Race(5),,
4,0,0,0,0,0,0,0,0,0,0,0,0,0,0,0,0,41,41,0.0,M2018-04-11D,Race(5),,
5,0,0,0,0,0,0,0,0,0,0,1,1,0,0,1,1,31,31,0.0,M2018-04-11D,Race(5),,
6,0,2,0,2,1,1,0,2,0,1,0,1,1,4,0,5,51,51,0.0,M2018-04-11D,Race(5),,
7,2,3,2,7,2,0,0,2,3,2,0,5,7,5,2,14,7,7,0.0,M2018-04-11D,Race(5),,
8,0,0,0,0,0,0,0,0,0,0,0,0,0,0,0,0,31,31,0.0,M2018-04-11D,Race(5),,
9,5,8,5,18,2,3,6,11,5,4,8,17,12,15,19,46,4.8,4.8,0.0,M2018-04-11D,Race(5),,
10,5,3,10,18,7,16,2,25,5,6,4,15,17,25,16,58,7,7,2.0,M2018-04-11D,Race(5),,
11,0,2,2,4,0,0,1,1,0,0,1,1,0,2,4,6,13,13,0.0,M2018-04-11D,Race(5),,
12,5,0,6,11,2,2,13,17,1,2,5,8,8,4,24,36,4.8,4.8,0.0,M2018-04-11D,Race(5),,
1,3,0,5,8,0,1,3,4,0,0,7,7,3,1,15,19,7.5,7.5,0.0,M2018-04-11D,Race(6),,
2,0,2,0,2,0,0,0,0,0,0,0,0,0,2,0,2,7.5,7.5,3.0,M2018-04-11D,Race(6),,
3,0,0,2,2,1,0,1,2,0,0,1,1,1,0,4,5,8.5,8.5,0.0,M2018-04-11D,Race(6),,
4,0,0,0,0,0,0,0,0,0,0,0,0,0,0,0,0,26,26,0.0,M2018-04-11D,Race(6),,
5,7,5,8,20,15,10,4,29,10,11,4,25,32,26,16,74,4.4,4.4,1.0,M2018-04-11D,Race(6),,
6,0,0,2,2,0,0,0,0,0,0,0,0,0,0,2,2,81,81,0.0,M2018-04-11D,Race(6),,
7,5,14,0,19,6,6,12,24,7,9,1,17,18,29,13,60,5.5,5.5,2.0,M2018-04-11D,Race(6),,
8,0,0,0,0,0,0,0,0,0,0,3,3,0,0,3,3,21,21,0.0,M2018-04-11D,Race(6),,
9,0,2,0,2,0,1,0,1,0,0,1,1,0,3,1,4,8.5,8.5,0.0,M2018-04-11D,Race(6),,
10,0,0,0,0,0,0,0,0,0,0,0,0,0,0,0,0,41,41,0.0,M2018-04-11D,Race(6),,
11,10,5,13,28,7,9,8,24,6,4,6,16,23,18,27,68,4,4,0.0,M2018-04-11D,Race(6),,
12,5,2,0,7,0,0,1,1,0,0,3,3,5,2,4,11,16,16,0.0,M2018-04-11D,Race(6),,
1,5,13,7,25,6,15,7,28,7,10,6,23,18,38,20,76,4.8,4.8,3.0,M2018-04-11D,Race(7),,
2,0,0,3,3,0,0,1,1,0,0,1,1,0,0,5,5,13,13,0.0,M2018-04-11D,Race(7),,
3,0,3,0,3,0,1,1,2,0,3,2,5,0,7,3,10,14,14,0.0,M2018-04-11D,Race(7),,
4,0,0,0,0,0,0,0,0,0,0,0,0,0,0,0,0,21,21,1.0,M2018-04-11D,Race(7),,
5,3,0,0,3,1,0,4,5,1,1,6,8,5,1,10,16,7,7,0.0,M2018-04-11D,Race(7),,
6,13,10,7,30,19,10,0,29,13,8,2,23,45,28,9,82,2.6,2.6,0.0,M2018-04-11D,Race(7),,
7,2,0,0,2,0,1,1,2,0,2,1,3,2,3,2,7,12,12,0.0,M2018-04-11D,Race(7),,
8,2,2,3,7,2,0,1,3,3,0,0,3,7,2,4,13,10,10,0.0,M2018-04-11D,Race(7),,
9,5,2,10,17,2,3,15,20,2,2,8,12,9,7,33,49,4.6,4.6,2.0,M2018-04-11D,Race(7),,
10,0,0,0,0,0,0,0,0,0,0,0,0,0,0,0,0,81,81,0.0,M2018-04-11D,Race(7),,
1,0,0,8,8,2,4,1,7,3,3,0,6,5,7,9,21,10,10,0.0,M2018-04-11D,Race(8),,
2,2,6,4,12,2,10,5,17,4,1,3,8,8,17,12,37,8.5,8.5,0.0,M2018-04-11D,Race(8),,
3,2,3,3,8,4,3,3,10,1,1,1,3,7,7,7,21,6,6,1.0,M2018-04-11D,Race(8),,
4,14,9,5,28,17,6,4,27,10,7,5,22,41,22,14,77,2.9,2.9,0.0,M2018-04-11D,Race(8),,
5,2,5,5,12,0,1,1,2,2,3,0,5,4,9,6,19,10,10,0.0,M2018-04-11D,Race(8),,
6,2,5,2,9,1,2,12,15,2,5,8,15,5,12,22,39,12,12,0.0,M2018-04-11D,Race(8),,
7,3,2,3,8,2,2,1,5,2,3,3,8,7,7,7,21,10,10,0.0,M2018-04-11D,Race(8),,
8,3,0,0,3,0,1,2,3,1,2,4,7,4,3,6,13,15,15,0.0,M2018-04-11D,Race(8),,
9,0,0,0,0,0,0,0,0,0,0,0,0,0,0,0,0,12,12,2.0,M2018-04-11D,Race(8),,
10,0,0,0,0,0,1,1,2,0,1,2,3,0,2,3,5,26,26,0.0,M2018-04-11D,Race(8),,
11,2,0,0,2,0,0,0,0,0,0,0,0,2,0,0,2,26,26,0.0,M2018-04-11D,Race(8),,
12,0,0,0,0,2,0,0,2,1,0,0,1,3,0,0,3,9.5,9.5,3.0,M2018-04-11D,Race(8),,
1,0,0,0,0,0,0,0,0,0,1,0,1,0,1,0,1,41,21,0.0,M2018-04-15D,Race(1),,
2,0,0,5,5,0,1,2,3,0,1,6,7,0,2,13,15,16,16,0.0,M2018-04-15D,Race(1),,
3,7,13,5,25,3,4,16,23,7,6,6,19,17,23,27,67,4,4.2,3.0,M2018-04-15D,Race(1),,
4,14,12,2,28,21,3,3,27,10,4,7,21,45,19,12,76,2.3,2.2,2.0,M2018-04-15D,Race(1),,
5,2,0,0,2,0,0,1,1,0,0,3,3,2,0,4,6,9,9.5,0.0,M2018-04-15D,Race(1),,
6,5,5,13,23,6,17,6,29,9,12,4,25,20,34,23,77,4,4.4,0.0,M2018-04-15D,Race(1),,
7,2,0,5,7,0,5,2,7,0,2,0,2,2,7,7,16,7,6,1.0,M2018-04-15D,Race(1),,
1,0,0,5,5,3,0,12,15,4,2,4,10,7,2,21,30,31,34,0.0,M2018-04-15D,Race(10),,
2,0,3,3,6,0,0,2,2,0,0,1,1,0,3,6,9,15,15,0.0,M2018-04-15D,Race(10),,
3,5,6,4,15,4,5,4,13,2,6,8,16,11,17,16,44,4.8,4.8,0.0,M2018-04-15D,Race(10),,
4,8,4,5,17,1,14,6,21,1,8,6,15,10,26,17,53,13,13,2.0,M2018-04-15D,Race(10),,
5,0,0,0,0,0,1,0,1,0,1,0,1,0,2,0,2,13,13,0.0,M2018-04-15D,Race(10),,
6,0,0,3,3,0,2,3,5,0,1,3,4,0,3,9,12,6.5,6.5,0.0,M2018-04-15D,Race(10),,
7,0,0,0,0,0,0,0,0,1,1,1,3,1,1,1,3,26,26,0.0,M2018-04-15D,Race(10),,
8,2,2,0,4,0,1,0,1,0,1,1,2,2,4,1,7,9,9,0.0,M2018-04-15D,Race(10),,
9,0,0,3,3,0,0,0,0,0,0,0,0,0,0,3,3,26,31,3.0,M2018-04-15D,Race(10),,
10,0,0,2,2,0,0,2,2,0,0,1,1,0,0,5,5,26,26,0.0,M2018-04-15D,Race(10),,
11,15,13,2,30,22,5,1,28,18,5,1,24,55,23,4,82,2.35,2.4,1.0,M2018-04-15D,Race(10),,
12,0,2,3,5,0,2,0,2,0,1,0,1,0,5,3,8,20,21,0.0,M2018-04-15D,Race(10),,
1,0,2,0,2,0,0,0,0,0,0,0,0,0,2,0,2,51,51,0.0,M2018-04-15D,Race(11),,
2,6,12,4,22,17,6,4,27,11,5,8,24,34,23,16,73,4,4,0.0,M2018-04-15D,Race(11),,
3,0,0,3,3,0,0,1,1,0,1,1,2,0,1,5,6,19,19,0.0,M2018-04-15D,Race(11),,
4,14,5,6,25,5,16,4,25,6,12,2,20,25,33,12,70,2.6,2.6,2.0,M2018-04-15D,Race(11),,
5,0,5,7,12,3,5,3,11,3,2,5,10,6,12,15,33,10,10,0.0,M2018-04-15D,Race(11),,
6,8,0,10,18,3,2,12,17,6,4,4,14,17,6,26,49,7,7,1.0,M2018-04-15D,Race(11),,
7,0,0,0,0,0,0,0,0,0,0,1,1,0,0,1,1,101,101,0.0,M2018-04-15D,Race(11),,
8,0,0,0,0,0,0,1,1,0,0,1,1,0,0,2,2,10,10,0.0,M2018-04-15D,Race(11),,
9,2,3,0,5,1,0,0,1,0,0,0,0,3,3,0,6,31,31,0.0,M2018-04-15D,Race(11),,
10,0,3,0,3,0,0,0,0,0,1,0,1,0,4,0,4,9,9,0.0,M2018-04-15D,Race(11),,
11,0,0,0,0,1,1,2,4,0,0,2,2,1,1,4,6,21,21,0.0,M2018-04-15D,Race(11),,
12,0,0,0,0,0,0,3,3,0,1,2,3,0,1,5,6,21,21,3.0,M2018-04-15D,Race(11),,
1,6,7,2,15,0,3,1,4,3,2,2,7,9,12,5,26,11,10,0.0,M2018-04-15D,Race(2),,
2,8,11,4,23,7,13,4,24,6,5,5,16,21,29,13,63,5.5,4.8,0.0,M2018-04-15D,Race(2),,
3,0,0,3,3,0,0,3,3,1,0,4,5,1,0,10,11,19,21,0.0,M2018-04-15D,Race(2),,
4,2,3,11,16,2,0,4,6,2,3,5,10,6,6,20,32,7,6.5,2.0,M2018-04-15D,Race(2),,
5,4,2,6,12,2,6,11,19,1,5,2,8,7,13,19,39,6,7,0.0,M2018-04-15D,Race(2),,
6,0,0,0,0,0,2,1,3,0,2,1,3,0,4,2,6,11,10,3.0,M2018-04-15D,Race(2),,
7,0,4,2,6,0,1,2,3,0,0,3,3,0,5,7,12,31,31,0.0,M2018-04-15D,Race(2),,
8,0,0,2,2,0,0,2,2,0,0,2,2,0,0,6,6,16,17,0.0,M2018-04-15D,Race(2),,
9,0,0,0,0,0,1,0,1,0,2,0,2,0,3,0,3,15,12,0.0,M2018-04-15D,Race(2),,
10,6,3,0,9,18,4,2,24,11,6,2,19,35,13,4,52,3.8,3.6,0.0,M2018-04-15D,Race(2),,
11,0,0,0,0,0,0,0,0,0,0,0,0,0,0,0,0,23,26,0.0,M2018-04-15D,Race(2),,
12,4,0,0,4,1,0,0,1,2,1,0,3,7,1,0,8,16,21,1.0,M2018-04-15D,Race(2),,
1,0,0,0,0,0,0,0,0,1,0,1,2,1,0,1,2,13,13,0.0,M2018-04-15D,Race(3),,
2,9,7,10,26,19,8,1,28,8,10,1,19,36,25,12,73,3,3,2.0,M2018-04-15D,Race(3),,
3,17,5,6,28,7,17,5,29,9,8,6,23,33,30,17,80,3.2,3.25,1.0,M2018-04-15D,Race(3),,
4,0,3,0,3,0,0,0,0,1,0,0,1,1,3,0,4,16,16,0.0,M2018-04-15D,Race(3),,
5,0,0,0,0,0,0,0,0,0,0,0,0,0,0,0,0,101,101,0.0,M2018-04-15D,Race(3),,
6,0,0,0,0,0,0,0,0,0,2,0,2,0,2,0,2,31,31,0.0,M2018-04-15D,Race(3),,
7,2,3,2,7,2,0,6,8,1,0,5,6,5,3,13,21,4.8,4.8,0.0,M2018-04-15D,Race(3),,
8,0,6,7,13,2,4,15,21,5,5,6,16,7,15,28,50,5.5,5.5,0.0,M2018-04-15D,Race(3),,
9,2,4,3,9,0,0,3,3,1,0,4,5,3,4,10,17,21,21,3.0,M2018-04-15D,Race(3),,
10,0,2,2,4,0,1,0,1,0,1,3,4,0,4,5,9,34,35,0.0,M2018-04-15D,Race(3),,
1,2,5,5,12,4,4,4,12,6,4,4,14,12,13,13,38,3.8,3.8,0.0,M2018-04-15D,Race(4),,
2,0,0,0,0,3,3,12,18,6,6,3,15,9,9,15,33,8,8,3.0,M2018-04-15D,Race(4),,
3,5,4,2,11,4,3,3,10,3,2,4,9,12,9,9,30,6.5,6.5,0.0,M2018-04-15D,Race(4),,
4,0,5,11,16,0,3,1,4,1,3,2,6,1,11,14,26,10,10,2.0,M2018-04-15D,Race(4),,
5,0,0,0,0,0,0,0,0,0,0,0,0,0,0,0,0,151,151,0.0,M2018-04-15D,Race(4),,
6,12,4,5,21,13,5,5,23,4,5,7,16,29,14,17,60,4.2,4.2,0.0,M2018-04-15D,Race(4),,
7,0,0,0,0,0,0,0,0,0,0,0,0,0,0,0,0,126,126,0.0,M2018-04-15D,Race(4),,
8,0,0,3,3,0,0,1,1,0,1,2,3,0,1,6,7,13,13,0.0,M2018-04-15D,Race(4),,
9,7,9,2,18,6,12,2,20,6,3,1,10,19,24,5,48,8,8,0.0,M2018-04-15D,Race(4),,
10,4,3,0,7,0,0,2,2,0,2,3,5,4,5,5,14,6.5,6.5,0.0,M2018-04-15D,Race(4),,
11,0,0,2,2,0,0,0,0,0,0,0,0,0,0,2,2,51,51,0.0,M2018-04-15D,Race(4),,
12,0,0,0,0,0,0,0,0,0,0,0,0,0,0,0,0,34,35,1.0,M2018-04-15D,Race(4),,
1,0,0,0,0,0,1,0,1,0,1,1,2,0,2,1,3,12,10,2.0,M2018-04-15D,Race(5),,
2,2,0,0,2,0,0,1,1,0,0,2,2,2,0,3,5,14,13,0.0,M2018-04-15D,Race(5),,
3,0,3,10,13,1,1,2,4,1,2,2,5,2,6,14,22,6.5,7.5,0.0,M2018-04-15D,Race(5),,
4,2,0,0,2,2,1,1,4,1,2,1,4,5,3,2,10,10,9,0.0,M2018-04-15D,Race(5),,
5,0,12,0,12,5,5,5,15,11,4,4,19,16,21,9,46,17,15,0.0,M2018-04-15D,Race(5),,
6,0,0,0,0,0,0,0,0,0,1,0,1,0,1,0,1,26,31,1.0,M2018-04-15D,Race(5),,
7,0,4,4,8,0,0,0,0,0,1,0,1,0,5,4,9,15,16,0.0,M2018-04-15D,Race(5),,
8,20,3,3,26,5,13,3,21,9,2,6,17,34,18,12,64,3.6,3.6,0.0,M2018-04-15D,Race(5),,
9,3,0,0,3,0,0,0,0,0,0,0,0,3,0,0,3,7,7,0.0,M2018-04-15D,Race(5),,
10,0,0,0,0,0,1,1,2,0,1,0,1,0,2,1,3,41,31,0.0,M2018-04-15D,Race(5),,
11,3,8,13,24,2,3,14,19,2,3,8,13,7,14,35,56,4.8,5.5,3.0,M2018-04-15D,Race(5),,
12,0,0,0,0,0,0,0,0,0,0,0,0,0,0,0,0,101,81,0.0,M2018-04-15D,Race(5),,
13,0,0,0,0,0,0,0,0,0,0,0,0,0,0,0,0,71,51,0.0,M2018-04-15D,Race(5),,
14,0,0,0,0,0,0,0,0,0,0,0,0,0,0,0,0,51,31,0.0,M2018-04-15D,Race(5),,
1,7,6,11,24,15,5,5,25,9,4,5,18,31,15,21,67,5,5,0.0,M2018-04-15D,Race(6),,
2,0,3,0,3,1,1,2,4,2,2,2,6,3,6,4,13,9,9,0.0,M2018-04-15D,Race(6),,
3,7,16,2,25,7,16,2,25,7,10,3,20,21,42,7,70,3.1,3.1,1.0,M2018-04-15D,Race(6),,
4,2,0,5,7,3,1,12,16,2,2,4,8,7,3,21,31,12,12,0.0,M2018-04-15D,Race(6),,
5,3,3,0,6,1,1,0,2,1,0,1,2,5,4,1,10,12,12,0.0,M2018-04-15D,Race(6),,
6,6,0,6,12,1,4,3,8,2,3,2,7,9,7,11,27,10,10,0.0,M2018-04-15D,Race(6),,
7,0,0,0,0,0,0,0,0,0,0,1,1,0,0,1,1,21,21,0.0,M2018-04-15D,Race(6),,
8,5,0,2,7,0,1,0,1,2,1,0,3,7,2,2,11,9,9,2.0,M2018-04-15D,Race(6),,
9,0,2,2,4,2,0,1,3,0,1,1,2,2,3,4,9,21,21,0.0,M2018-04-15D,Race(6),,
10,0,0,0,0,0,1,3,4,0,0,0,0,0,1,3,4,0,,0.0,M2018-04-15D,Race(6),,
11,0,0,0,0,0,0,0,0,0,0,0,0,0,0,0,0,31,31,0.0,M2018-04-15D,Race(6),,
12,0,0,0,0,0,0,2,2,0,0,3,3,0,0,5,5,9,9,0.0,M2018-04-15D,Race(6),,
13,0,0,0,0,0,0,0,0,0,1,0,1,0,1,0,1,151,151,0.0,M2018-04-15D,Race(6),,
14,0,0,2,2,0,0,0,0,1,1,0,2,1,1,2,4,26,26,3.0,M2018-04-15D,Race(6),,
1,0,0,0,0,0,0,1,1,0,0,3,3,0,0,4,4,34,35,0.0,M2018-04-15D,Race(7),,
2,0,0,0,0,0,0,0,0,0,0,0,0,0,0,0,0,26,26,2.0,M2018-04-15D,Race(7),,
3,26,0,2,28,24,2,2,28,22,2,0,24,72,4,4,80,2,2,0.0,M2018-04-15D,Race(7),,
4,2,5,5,12,3,13,6,22,0,4,8,12,5,22,19,46,6.5,6.5,0.0,M2018-04-15D,Race(7),,
5,0,0,0,0,0,0,1,1,0,0,1,1,0,0,2,2,15,15,0.0,M2018-04-15D,Race(7),,
6,0,0,0,0,0,0,0,0,1,0,0,1,1,0,0,1,51,51,0.0,M2018-04-15D,Race(7),,
7,0,0,0,0,0,0,0,0,0,0,0,0,0,0,0,0,34,35,0.0,M2018-04-15D,Race(7),,
8,0,18,2,20,2,4,4,10,2,7,3,12,4,29,9,42,10,10,0.0,M2018-04-15D,Race(7),,
9,2,0,2,4,0,0,4,4,0,0,3,3,2,0,9,11,19,19,0.0,M2018-04-15D,Race(7),,
10,0,0,0,0,0,0,0,0,0,1,0,1,0,1,0,1,26,26,0.0,M2018-04-15D,Race(7),,
11,0,3,5,8,0,6,10,16,0,3,2,5,0,12,17,29,19,19,1.0,M2018-04-15D,Race(7),,
12,0,4,14,18,1,5,2,8,1,9,6,16,2,18,22,42,6.5,6.5,3.0,M2018-04-15D,Race(7),,
13,0,0,0,0,0,0,0,0,0,0,0,0,0,0,0,0,34,35,0.0,M2018-04-15D,Race(7),,
14,0,0,0,0,0,0,0,0,0,0,0,0,0,0,0,0,34,35,0.0,M2018-04-15D,Race(7),,
1,18,0,12,30,20,5,3,28,20,2,4,26,58,7,19,84,2.8,2.8,2.0,M2018-04-15D,Race(8),,
2,0,0,0,0,1,0,0,1,0,1,1,2,1,1,1,3,16,16,0.0,M2018-04-15D,Race(8),,
3,5,15,5,25,5,23,1,29,3,17,3,23,13,55,9,77,4,4,0.0,M2018-04-15D,Race(8),,
4,2,0,0,2,0,1,1,2,0,1,2,3,2,2,3,7,10,10,1.0,M2018-04-15D,Race(8),,
5,0,0,0,0,0,0,1,1,0,0,1,1,0,0,2,2,21,21,0.0,M2018-04-15D,Race(8),,
6,0,0,3,3,0,0,0,0,0,0,0,0,0,0,3,3,19,19,3.0,M2018-04-15D,Race(8),,
7,0,3,0,3,1,0,2,3,1,0,2,3,2,3,4,9,34,35,0.0,M2018-04-15D,Race(8),,
8,0,0,0,0,0,0,0,0,0,1,0,1,0,1,0,1,19,19,0.0,M2018-04-15D,Race(8),,
9,5,7,7,19,2,1,19,22,1,2,10,13,8,10,36,54,5,5,0.0,M2018-04-15D,Race(8),,
10,0,5,3,8,1,0,3,4,1,2,3,6,2,7,9,18,7,7,0.0,M2018-04-15D,Race(8),,
1,3,3,2,8,2,0,2,4,0,0,1,1,5,3,5,13,13,13,0.0,M2018-04-15D,Race(9),,
2,0,0,3,3,0,1,1,2,1,1,3,5,1,2,7,10,13,13,0.0,M2018-04-15D,Race(9),,
3,9,10,5,24,15,5,7,27,10,4,6,20,34,19,18,71,7.5,7.5,0.0,M2018-04-15D,Race(9),,
4,8,10,6,24,7,17,3,27,4,10,8,22,19,37,17,73,3,3,3.0,M2018-04-15D,Race(9),,
5,0,0,0,0,0,0,0,0,0,1,0,1,0,1,0,1,26,26,0.0,M2018-04-15D,Race(9),,
6,0,0,0,0,1,0,0,1,0,0,0,0,1,0,0,1,101,101,0.0,M2018-04-15D,Race(9),,
7,0,0,2,2,0,0,0,0,1,1,1,3,1,1,3,5,13,13,2.0,M2018-04-15D,Race(9),,
8,0,0,0,0,0,0,0,0,0,0,0,0,0,0,0,0,6,6,0.0,M2018-04-15D,Race(9),,
9,0,0,4,4,0,1,4,5,0,2,3,5,0,3,11,14,17,17,0.0,M2018-04-15D,Race(9),,
10,0,0,0,0,0,0,0,0,0,0,0,0,0,0,0,0,61,61,0.0,M2018-04-15D,Race(9),,
11,2,0,3,5,0,1,0,1,0,0,0,0,2,1,3,6,41,41,1.0,M2018-04-15D,Race(9),,
12,0,0,0,0,0,0,0,0,0,0,0,0,0,0,0,0,61,61,0.0,M2018-04-15D,Race(9),,
13,8,7,5,20,5,5,13,23,10,7,4,21,23,19,22,64,3.8,3.8,0.0,M2018-04-15D,Race(9),,
14,0,0,0,0,0,0,0,0,0,0,0,0,0,0,0,0,126,126,0.0,M2018-04-15D,Race(9),,
1,16,12,2,30,22,4,1,27,12,7,1,20,50,23,4,77,2.35,2.35,1.0,M2018-04-18D,Race(1),,
2,0,0,3,3,0,0,0,0,0,0,0,0,0,0,3,3,34,34,0.0,M2018-04-18D,Race(1),,
3,7,2,3,12,2,3,12,17,1,3,3,7,10,8,18,36,9,9,0.0,M2018-04-18D,Race(1),,
4,3,2,8,13,0,4,5,9,2,3,10,15,5,9,23,37,6,6,0.0,M2018-04-18D,Race(1),,
5,0,8,7,15,2,15,3,20,3,8,2,13,5,31,12,48,8,8,0.0,M2018-04-18D,Race(1),,
6,2,0,0,2,1,1,0,2,2,1,2,5,5,2,2,9,15,15,3.0,M2018-04-18D,Race(1),,
7,2,3,0,5,2,1,3,6,1,1,3,5,5,5,6,16,7,7,0.0,M2018-04-18D,Race(1),,
8,0,0,0,0,0,0,0,0,0,0,0,0,0,0,0,0,71,71,0.0,M2018-04-18D,Race(1),,
9,0,0,7,7,1,0,1,2,3,0,0,3,4,0,8,12,9,9,0.0,M2018-04-18D,Race(1),,
10,0,0,0,0,0,2,3,5,2,3,5,10,2,5,8,15,21,21,0.0,M2018-04-18D,Race(1),,
11,0,3,0,3,0,0,2,2,0,0,0,0,0,3,2,5,26,26,0.0,M2018-04-18D,Race(1),,
12,0,0,0,0,0,0,0,0,0,0,0,0,0,0,0,0,51,51,2.0,M2018-04-18D,Race(1),,
1,2,2,6,10,6,4,11,21,7,3,6,16,15,9,23,47,4,4,1.0,M2018-04-18D,Race(2),,
2,0,0,0,0,0,0,0,0,0,1,0,1,0,1,0,1,41,41,0.0,M2018-04-18D,Race(2),,
3,10,10,4,24,15,5,6,26,10,3,3,16,35,18,13,66,4.8,4.8,3.0,M2018-04-18D,Race(2),,
4,0,0,0,0,2,4,1,7,4,5,3,12,6,9,4,19,7,7,2.0,M2018-04-18D,Race(2),,
5,5,6,5,16,1,1,2,4,1,4,3,8,7,11,10,28,7,7,0.0,M2018-04-18D,Race(2),,
6,3,7,2,12,0,3,5,8,0,4,4,8,3,14,11,28,7,7,0.0,M2018-04-18D,Race(2),,
7,2,0,0,2,0,0,0,0,0,0,1,1,2,0,1,3,14,14,0.0,M2018-04-18D,Race(2),,
8,0,0,2,2,0,0,1,1,0,0,1,1,0,0,4,4,19,19,0.0,M2018-04-18D,Race(2),,
9,0,0,0,0,0,0,0,0,0,1,0,1,0,1,0,1,81,81,0.0,M2018-04-18D,Race(2),,
10,8,5,5,18,6,13,3,22,4,5,3,12,18,23,11,52,8.5,8.5,0.0,M2018-04-18D,Race(2),,
11,0,0,6,6,0,0,1,1,0,0,1,1,0,0,8,8,11,11,0.0,M2018-04-18D,Race(2),,
12,0,0,0,0,0,0,0,0,0,0,1,1,0,0,1,1,26,26,0.0,M2018-04-18D,Race(2),,
1,0,0,0,0,1,0,2,3,1,0,1,2,2,0,3,5,26,26,0.0,M2018-04-18D,Race(3),,
2,0,2,2,4,0,2,0,2,0,1,0,1,0,5,2,7,19,19,0.0,M2018-04-18D,Race(3),,
3,8,13,2,23,1,5,11,17,4,3,7,14,13,21,20,54,7,7,0.0,M2018-04-18D,Race(3),,
4,0,0,0,0,0,0,0,0,0,0,0,0,0,0,0,0,21,21,0.0,M2018-04-18D,Race(3),,
5,10,9,2,21,8,11,4,23,9,6,5,20,27,26,11,64,3,3,0.0,M2018-04-18D,Race(3),,
6,3,0,16,19,16,6,5,27,8,7,4,19,27,13,25,65,4,4,0.0,M2018-04-18D,Race(3),,
7,7,3,3,13,1,6,4,11,3,6,5,14,11,15,12,38,6,6,2.0,M2018-04-18D,Race(3),,
8,0,3,0,3,2,0,3,5,0,0,1,1,2,3,4,9,9,9,3.0,M2018-04-18D,Race(3),,
9,0,0,0,0,0,0,0,0,1,0,0,1,1,0,0,1,13,13,1.0,M2018-04-18D,Race(3),,
10,2,0,5,7,1,0,1,2,0,3,3,6,3,3,9,15,13,13,0.0,M2018-04-18D,Race(3),,
1,0,2,0,2,1,4,4,9,2,3,2,7,3,9,6,18,10,10,0.0,M2018-04-18D,Race(4),,
2,3,0,2,5,1,1,3,5,0,2,5,7,4,3,10,17,16,16,0.0,M2018-04-18D,Race(4),,
3,21,3,2,26,6,8,11,25,10,6,4,20,37,17,17,71,3.4,3.4,0.0,M2018-04-18D,Race(4),,
4,0,0,0,0,0,0,1,1,0,0,0,0,0,0,1,1,15,15,0.0,M2018-04-18D,Race(4),,
5,0,0,0,0,0,0,0,0,0,3,0,3,0,3,0,3,71,67,0.0,M2018-04-18D,Race(4),,
6,0,0,0,0,0,0,2,2,1,0,1,2,1,0,3,4,21,21,0.0,M2018-04-18D,Race(4),,
7,0,0,3,3,0,0,1,1,0,0,0,0,0,0,4,4,26,26,3.0,M2018-04-18D,Race(4),,
8,0,15,8,23,2,15,3,20,2,6,8,16,4,36,19,59,5,5,2.0,M2018-04-18D,Race(4),,
9,0,3,0,3,1,0,0,1,1,0,0,1,2,3,0,5,14,14,0.0,M2018-04-18D,Race(4),,
10,4,5,15,24,18,1,5,24,10,6,5,21,32,12,25,69,3.3,3.3,1.0,M2018-04-18D,Race(4),,
11,0,2,0,2,0,0,0,0,0,0,0,0,0,2,0,2,34,34,0.0,M2018-04-18D,Race(4),,
12,2,0,0,2,1,1,0,2,0,0,1,1,3,1,1,5,14,14,0.0,M2018-04-18D,Race(4),,
1,0,3,6,9,0,2,4,6,0,1,5,6,0,6,15,21,16,16,3.0,M2018-04-18D,Race(5),,
2,0,0,0,0,0,0,0,0,0,0,0,0,0,0,0,0,81,81,0.0,M2018-04-18D,Race(5),,
3,0,3,2,5,3,0,1,4,3,1,0,4,6,4,3,13,8,8,2.0,M2018-04-18D,Race(5),,
4,17,5,2,24,8,11,7,26,10,8,5,23,35,24,14,73,2.5,2.5,0.0,M2018-04-18D,Race(5),,
5,0,2,0,2,0,0,1,1,0,0,1,1,0,2,2,4,21,21,0.0,M2018-04-18D,Race(5),,
6,0,4,5,9,1,0,0,1,1,1,2,4,2,5,7,14,7,7,0.0,M2018-04-18D,Race(5),,
7,0,3,2,5,0,1,1,2,1,0,1,2,1,4,4,9,10,10,1.0,M2018-04-18D,Race(5),,
8,7,5,10,22,16,6,4,26,8,6,4,18,31,17,18,66,4.8,4.8,0.0,M2018-04-18D,Race(5),,
9,6,3,0,9,1,2,0,3,0,4,1,5,7,9,1,17,13,13,0.0,M2018-04-18D,Race(5),,
10,0,2,0,2,0,0,0,0,0,0,0,0,0,2,0,2,21,21,0.0,M2018-04-18D,Race(5),,
11,0,0,3,3,0,0,0,0,0,0,0,0,0,0,3,3,15,15,0.0,M2018-04-18D,Race(5),,
12,0,0,0,0,0,0,0,0,0,0,0,0,0,0,0,0,101,101,0.0,M2018-04-18D,Race(5),,
1,3,3,4,10,1,0,2,3,0,1,2,3,4,4,8,16,10,10,0.0,M2018-04-18D,Race(6),,
2,7,5,0,12,1,4,4,9,1,3,4,8,9,12,8,29,12,12,0.0,M2018-04-18D,Race(6),,
3,0,2,10,12,1,3,22,26,4,4,5,13,5,9,37,51,10,10,0.0,M2018-04-18D,Race(6),,
4,2,10,3,15,5,1,7,13,4,1,6,11,11,12,16,39,6.5,6.5,0.0,M2018-04-18D,Race(6),,
5,0,0,0,0,0,2,0,2,1,0,0,1,1,2,0,3,10,10,0.0,M2018-04-18D,Race(6),,
6,16,2,4,22,20,4,4,28,10,7,4,21,46,13,12,71,2.7,2.7,1.0,M2018-04-18D,Race(6),,
7,0,0,0,0,1,0,0,1,1,0,0,1,2,0,0,2,31,31,0.0,M2018-04-18D,Race(6),,
8,0,0,0,0,0,0,0,0,0,0,1,1,0,0,1,1,26,26,0.0,M2018-04-18D,Race(6),,
9,0,0,0,0,0,0,0,0,1,1,0,2,1,1,0,2,31,31,3.0,M2018-04-18D,Race(6),,
10,2,0,3,5,1,0,0,1,3,3,2,8,6,3,5,14,17,17,0.0,M2018-04-18D,Race(6),,
11,0,3,0,3,0,1,1,2,0,0,0,0,0,4,1,5,10,10,0.0,M2018-04-18D,Race(6),,
12,0,5,6,11,0,15,0,15,1,6,2,9,1,26,8,35,8,8,2.0,M2018-04-18D,Race(6),,
1,5,0,5,10,2,2,2,6,2,3,2,7,9,5,9,23,10,10,0.0,M2018-04-18D,Race(7),,
2,2,2,0,4,0,0,2,2,1,0,1,2,3,2,3,8,21,21,0.0,M2018-04-18D,Race(7),,
3,5,8,6,19,2,16,6,24,2,8,7,17,9,32,19,60,5.5,5.5,3.0,M2018-04-18D,Race(7),,
4,6,0,6,12,2,6,11,19,3,5,4,12,11,11,21,43,6,6,0.0,M2018-04-18D,Race(7),,
5,10,4,11,25,22,3,3,28,14,6,3,23,46,13,17,76,4.6,4.6,0.0,M2018-04-18D,Race(7),,
6,0,3,0,3,0,0,1,1,0,0,1,1,0,3,2,5,7,7,0.0,M2018-04-18D,Race(7),,
7,0,0,0,0,1,1,0,2,0,1,0,1,1,2,0,3,26,26,0.0,M2018-04-18D,Race(7),,
8,0,0,0,0,0,0,1,1,0,1,2,3,0,1,3,4,41,41,0.0,M2018-04-18D,Race(7),,
9,0,5,0,5,0,0,1,1,0,0,4,4,0,5,5,10,7,7,2.0,M2018-04-18D,Race(7),,
10,0,0,0,0,0,0,1,1,0,0,0,0,0,0,1,1,13,13,0.0,M2018-04-18D,Race(7),,
11,2,8,2,12,1,2,2,5,3,2,2,7,6,12,6,24,7,7,1.0,M2018-04-18D,Race(7),,
12,0,0,0,0,0,0,0,0,1,0,0,1,1,0,0,1,61,61,0.0,M2018-04-18D,Race(7),,
1,0,0,0,0,0,2,1,3,0,0,1,1,0,2,2,4,26,26,0.0,M2018-04-18D,Race(8),,
2,0,0,0,0,0,0,0,0,0,0,0,0,0,0,0,0,61,61,0.0,M2018-04-18D,Race(8),,
3,2,2,4,8,0,0,1,1,0,0,4,4,2,2,9,13,8,8,0.0,M2018-04-18D,Race(8),,
4,0,0,3,3,1,1,2,4,2,1,3,6,3,2,8,13,10,10,0.0,M2018-04-18D,Race(8),,
5,0,0,0,0,0,0,0,0,0,1,0,1,0,1,0,1,51,51,0.0,M2018-04-18D,Race(8),,
6,10,7,5,22,7,11,5,23,9,4,3,16,26,22,13,61,5,5,3.0,M2018-04-18D,Race(8),,
7,7,3,3,13,3,6,12,21,2,7,3,12,12,16,18,46,8,8,0.0,M2018-04-18D,Race(8),,
8,11,11,4,26,18,5,5,28,10,7,5,22,39,23,14,76,3,3,2.0,M2018-04-18D,Race(8),,
9,0,0,0,0,0,1,1,2,0,0,2,2,0,1,3,4,26,26,0.0,M2018-04-18D,Race(8),,
10,0,0,0,0,0,0,0,0,0,0,0,0,0,0,0,0,51,51,0.0,M2018-04-18D,Race(8),,
11,0,0,11,11,0,3,3,6,1,4,4,9,1,7,18,26,5.5,5.5,1.0,M2018-04-18D,Race(8),,
12,0,7,0,7,1,1,0,2,2,2,1,5,3,10,1,14,10,10,0.0,M2018-04-18D,Race(8),,
1,2,4,3,9,1,2,4,7,1,2,4,7,4,8,11,23,8.5,8,0.0,M2018-04-21D,Race(1),,
2,0,0,0,0,0,0,0,0,0,0,0,0,0,0,0,0,81,71,0.0,M2018-04-21D,Race(1),,
3,8,5,3,16,8,5,2,15,8,6,2,16,24,16,7,47,6.5,6.5,0.0,M2018-04-21D,Race(1),,
4,8,6,0,14,3,8,5,16,3,5,6,14,14,19,11,44,4.4,4.8,2.0,M2018-04-21D,Race(1),,
5,3,2,5,10,2,2,4,8,2,3,7,12,7,7,16,30,8.5,8.5,0.0,M2018-04-21D,Race(1),,
6,0,0,0,0,0,0,0,0,1,0,0,1,1,0,0,1,41,41,0.0,M2018-04-21D,Race(1),,
7,2,2,7,11,3,8,3,14,2,1,4,7,7,11,14,32,12,13,0.0,M2018-04-21D,Race(1),,
8,0,6,2,8,0,2,0,2,1,2,0,3,1,10,2,13,12,11,0.0,M2018-04-21D,Race(1),,
9,0,0,0,0,0,2,0,2,2,1,1,4,2,3,1,6,12,12,1.0,M2018-04-21D,Race(1),,
10,0,3,5,8,8,0,8,16,0,1,1,2,8,4,14,26,7.5,7.5,3.0,M2018-04-21D,Race(1),,
11,7,0,2,9,5,1,4,10,6,5,0,11,18,6,6,30,6.5,6.5,0.0,M2018-04-21D,Race(1),,
12,0,2,3,5,0,0,0,0,0,0,1,1,0,2,4,6,18,15,0.0,M2018-04-21D,Race(1),,
13,0,0,0,0,0,0,0,0,0,0,0,0,0,0,0,0,81,81,0.0,M2018-04-21D,Race(1),,
14,0,0,0,0,0,0,0,0,0,0,0,0,0,0,0,0,71,67,0.0,M2018-04-21D,Race(1),,
1,0,0,0,0,4,1,3,8,5,1,0,6,9,2,3,14,14,15,0.0,M2018-04-21D,Race(10),,
2,0,3,6,9,1,6,7,14,1,4,4,9,2,13,17,32,18,17,3.0,M2018-04-21D,Race(10),,
3,4,0,3,7,0,8,1,9,1,2,0,3,5,10,4,19,15,15,2.0,M2018-04-21D,Race(10),,
4,3,4,5,12,1,2,2,5,0,5,7,12,4,11,14,29,8,8.5,0.0,M2018-04-21D,Race(10),,
5,0,0,0,0,0,0,0,0,0,0,0,0,0,0,0,0,51,51,0.0,M2018-04-21D,Race(10),,
6,5,2,2,9,0,3,3,6,0,3,6,9,5,8,11,24,5,5,0.0,M2018-04-21D,Race(10),,
7,0,0,0,0,0,0,0,0,0,1,0,1,0,1,0,1,101,101,0.0,M2018-04-21D,Race(10),,
8,0,0,0,0,0,0,0,0,0,0,0,0,0,0,0,0,81,81,0.0,M2018-04-21D,Race(10),,
9,9,14,2,25,14,3,4,21,15,3,3,21,38,20,9,67,2.45,2.4,0.0,M2018-04-21D,Race(10),,
10,0,2,0,2,0,0,0,0,0,0,0,0,0,2,0,2,41,41,0.0,M2018-04-21D,Race(10),,
11,0,0,5,5,0,0,0,0,0,0,0,0,0,0,5,5,15,16,0.0,M2018-04-21D,Race(10),,
12,9,5,7,21,2,6,9,17,3,7,4,14,14,18,20,52,4.8,5,1.0,M2018-04-21D,Race(10),,
13,0,0,0,0,8,1,1,10,1,0,2,3,9,1,3,13,31,31,0.0,M2018-04-21D,Race(10),,
14,0,0,0,0,0,0,0,0,0,0,0,0,0,0,0,0,126,126,0.0,M2018-04-21D,Race(10),,
1,10,7,7,24,2,12,4,18,5,10,4,19,17,29,15,61,4.6,4.4,2.0,M2018-04-21D,Race(2),,
2,7,10,3,20,5,5,6,16,7,5,6,18,19,20,15,54,4.2,4.4,0.0,M2018-04-21D,Race(2),,
3,0,0,0,0,0,0,0,0,0,0,2,2,0,0,2,2,23,23,0.0,M2018-04-21D,Race(2),,
4,11,8,5,24,14,1,7,22,13,3,6,22,38,12,18,68,3.4,3.4,0.0,M2018-04-21D,Race(2),,
5,0,0,5,5,0,3,2,5,0,3,1,4,0,6,8,14,7.5,7.5,0.0,M2018-04-21D,Race(2),,
6,0,2,5,7,0,0,0,0,1,5,2,8,1,7,7,15,16,16,1.0,M2018-04-21D,Race(2),,
7,0,0,0,0,1,0,8,9,0,0,2,2,1,0,10,11,21,21,0.0,M2018-04-21D,Race(2),,
8,0,3,2,5,0,0,0,0,0,0,3,3,0,3,5,8,11,11,0.0,M2018-04-21D,Race(2),,
9,0,0,0,0,0,0,8,8,0,0,0,0,0,0,8,8,26,27,0.0,M2018-04-21D,Race(2),,
10,0,0,0,0,8,0,0,8,0,0,0,0,8,0,0,8,16,16,3.0,M2018-04-21D,Race(2),,
11,2,0,3,5,0,0,0,0,0,0,0,0,2,0,3,5,17,17,0.0,M2018-04-21D,Race(2),,
1,4,3,2,9,2,4,1,7,2,4,0,6,8,11,3,22,13,13,0.0,M2018-04-21D,Race(3),,
2,8,6,8,22,5,6,3,14,7,4,3,14,20,16,14,50,4.6,4.8,0.0,M2018-04-21D,Race(3),,
3,2,0,2,4,3,3,7,13,4,5,4,13,9,8,13,30,9,9.5,2.0,M2018-04-21D,Race(3),,
4,8,3,2,13,0,1,2,3,3,3,4,10,11,7,8,26,6.5,6.5,1.0,M2018-04-21D,Race(3),,
5,2,0,0,2,0,0,0,0,0,0,0,0,2,0,0,2,17,18,0.0,M2018-04-21D,Race(3),,
6,0,0,13,13,8,1,3,12,1,0,6,7,9,1,22,32,10,8.5,0.0,M2018-04-21D,Race(3),,
7,0,0,0,0,0,0,0,0,0,0,1,1,0,0,1,1,31,31,0.0,M2018-04-21D,Race(3),,
8,0,2,0,2,1,1,3,5,1,3,0,4,2,6,3,11,14,14,0.0,M2018-04-21D,Race(3),,
9,3,8,3,14,0,0,0,0,7,6,6,19,10,14,9,33,4.8,4.8,0.0,M2018-04-21D,Race(3),,
10,3,0,0,3,1,0,1,2,0,0,1,1,4,0,2,6,16,16,3.0,M2018-04-21D,Race(3),,
11,0,0,0,0,9,6,4,19,0,0,0,0,9,6,4,19,16,15,0.0,M2018-04-21D,Race(3),,
12,0,0,0,0,0,0,0,0,0,0,0,0,0,0,0,0,34,31,0.0,M2018-04-21D,Race(3),,
13,0,5,0,5,0,8,0,8,1,1,1,3,1,14,1,16,13,13,0.0,M2018-04-21D,Race(3),,
14,0,3,0,3,0,0,0,0,0,0,0,0,0,3,0,3,34,35,0.0,M2018-04-21D,Race(3),,
1,3,12,7,22,2,13,6,21,1,17,6,24,6,42,19,67,6,6,3.0,M2018-04-21D,Race(4),,
2,17,10,3,30,18,4,1,23,20,4,0,24,55,18,4,77,1.65,1.65,2.0,M2018-04-21D,Race(4),,
3,5,5,2,12,1,3,6,10,1,2,3,6,7,10,11,28,5,5,0.0,M2018-04-21D,Race(4),,
4,2,3,8,13,1,1,4,6,4,2,7,13,7,6,19,32,8.5,9,0.0,M2018-04-21D,Race(4),,
5,0,0,0,0,0,0,0,0,0,0,0,0,0,0,0,0,41,41,0.0,M2018-04-21D,Race(4),,
6,0,0,5,5,0,0,3,3,0,1,5,6,0,1,13,14,23,23,0.0,M2018-04-21D,Race(4),,
7,0,0,0,0,0,0,0,0,0,0,0,0,0,0,0,0,91,81,0.0,M2018-04-21D,Race(4),,
8,0,0,3,3,0,0,0,0,0,0,0,0,0,0,3,3,34,34,0.0,M2018-04-21D,Race(4),,
9,0,0,0,0,0,0,0,0,0,0,0,0,0,0,0,0,51,51,0.0,M2018-04-21D,Race(4),,
10,0,0,0,0,0,8,0,8,0,0,1,1,0,8,1,9,41,41,1.0,M2018-04-21D,Race(4),,
11,3,0,2,5,0,0,8,8,0,0,1,1,3,0,11,14,34,35,0.0,M2018-04-21D,Race(4),,
12,0,0,0,0,0,0,0,0,0,0,0,0,0,0,0,0,41,41,0.0,M2018-04-21D,Race(4),,
1,2,0,0,2,0,1,0,1,1,1,2,4,3,2,2,7,9.5,9.5,0.0,M2018-04-21D,Race(5),,
2,5,11,6,22,10,3,7,20,12,4,7,23,27,18,20,65,5,5,2.0,M2018-04-21D,Race(5),,
3,0,0,0,0,0,0,9,9,1,0,0,1,1,0,9,10,16,17,0.0,M2018-04-21D,Race(5),,
4,7,10,8,25,6,9,4,19,4,9,8,21,17,28,20,65,3.5,3.6,3.0,M2018-04-21D,Race(5),,
5,0,0,0,0,0,0,0,0,0,0,0,0,0,0,0,0,6.5,7,1.0,M2018-04-21D,Race(5),,
6,10,0,5,15,3,3,5,11,5,4,5,14,18,7,15,40,7.5,7.5,0.0,M2018-04-21D,Race(5),,
7,0,2,5,7,0,9,0,9,0,1,0,1,0,12,5,17,15,13,0.0,M2018-04-21D,Race(5),,
8,3,4,6,13,3,4,5,12,2,6,3,11,8,14,14,36,10,9.5,0.0,M2018-04-21D,Race(5),,
9,0,0,0,0,0,0,0,0,0,0,0,0,0,0,0,0,101,101,0.0,M2018-04-21D,Race(5),,
10,3,3,0,6,8,1,0,9,1,1,1,3,12,5,1,18,5.5,5.5,0.0,M2018-04-21D,Race(5),,
1,0,8,3,11,2,9,3,14,2,3,4,9,4,20,10,34,6.5,6.5,3.0,M2018-04-21D,Race(6),,
2,5,3,15,23,7,6,5,18,6,5,6,17,18,14,26,58,6,6,0.0,M2018-04-21D,Race(6),,
3,3,10,5,18,1,7,8,16,5,6,6,17,9,23,19,51,8.5,8.5,0.0,M2018-04-21D,Race(6),,
4,0,0,0,0,0,0,8,8,0,0,2,2,0,0,10,10,21,21,0.0,M2018-04-21D,Race(6),,
5,13,5,2,20,9,5,3,17,8,5,4,17,30,15,9,54,4,4,0.0,M2018-04-21D,Race(6),,
6,0,0,0,0,0,0,0,0,0,0,0,0,0,0,0,0,26,27,0.0,M2018-04-21D,Race(6),,
7,0,0,0,0,0,0,0,0,0,1,0,1,0,1,0,1,23,23,0.0,M2018-04-21D,Race(6),,
8,4,0,3,7,2,0,0,2,1,2,0,3,7,2,3,12,7,7,0.0,M2018-04-21D,Race(6),,
9,0,4,2,6,1,3,0,4,1,4,2,7,2,11,4,17,6,6,2.0,M2018-04-21D,Race(6),,
10,0,0,0,0,0,0,0,0,0,0,0,0,0,0,0,0,51,51,0.0,M2018-04-21D,Race(6),,
11,3,0,0,3,8,0,3,11,3,0,2,5,14,0,5,19,16,15,0.0,M2018-04-21D,Race(6),,
12,2,0,0,2,0,0,0,0,0,0,0,0,2,0,0,2,23,23,1.0,M2018-04-21D,Race(6),,
13,0,0,0,0,0,0,0,0,0,0,0,0,0,0,0,0,21,21,0.0,M2018-04-21D,Race(6),,
14,0,0,0,0,0,0,0,0,0,0,0,0,0,0,0,0,101,101,0.0,M2018-04-21D,Race(6),,
1,2,0,8,10,0,0,5,5,1,0,6,7,3,0,19,22,6.5,7,0.0,M2018-04-21D,Race(7),,
2,0,2,7,9,8,9,9,26,0,1,9,10,8,12,25,45,15,15,0.0,M2018-04-21D,Race(7),,
3,0,0,0,0,0,0,8,8,0,0,0,0,0,0,8,8,0,,0.0,M2018-04-21D,Race(7),,
4,10,18,2,30,12,8,3,23,13,11,0,24,35,37,5,77,4.4,4.4,3.0,M2018-04-21D,Race(7),,
5,0,0,0,0,0,0,0,0,0,0,0,0,0,0,0,0,81,81,0.0,M2018-04-21D,Race(7),,
6,0,0,0,0,0,0,0,0,0,0,0,0,0,0,0,0,41,46,2.0,M2018-04-21D,Race(7),,
7,0,0,3,3,0,0,0,0,0,0,0,0,0,0,3,3,19,18,0.0,M2018-04-21D,Race(7),,
8,0,0,0,0,0,0,0,0,0,0,0,0,0,0,0,0,81,81,0.0,M2018-04-21D,Race(7),,
9,0,0,10,10,0,0,4,4,0,0,8,8,0,0,22,22,7.5,7.5,0.0,M2018-04-21D,Race(7),,
10,18,10,0,28,10,13,0,23,11,14,0,25,39,37,0,76,2,2,1.0,M2018-04-21D,Race(7),,
11,0,0,0,0,0,0,0,0,1,0,0,1,1,0,0,1,34,34,0.0,M2018-04-21D,Race(7),,
12,0,0,0,0,0,0,1,1,0,0,2,2,0,0,3,3,12,13,0.0,M2018-04-21D,Race(7),,
1,3,0,0,3,0,0,0,0,0,0,1,1,3,0,1,4,26,27,0.0,M2018-04-21D,Race(8),,
2,0,0,0,0,0,0,0,0,0,0,0,0,0,0,0,0,151,151,0.0,M2018-04-21D,Race(8),,
3,2,4,6,12,2,4,10,16,4,1,3,8,8,9,19,36,7.5,7.5,0.0,M2018-04-21D,Race(8),,
4,5,5,3,13,5,6,7,18,2,6,4,12,12,17,14,43,3.7,3.7,1.0,M2018-04-21D,Race(8),,
5,2,9,8,19,8,8,2,18,8,2,5,15,18,19,15,52,11,11,0.0,M2018-04-21D,Race(8),,
6,0,0,0,0,0,0,0,0,0,0,0,0,0,0,0,0,14,14,0.0,M2018-04-21D,Race(8),,
7,2,0,0,2,0,0,0,0,0,1,0,1,2,1,0,3,41,41,0.0,M2018-04-21D,Race(8),,
8,0,0,0,0,0,0,0,0,0,0,1,1,0,0,1,1,17,17,0.0,M2018-04-21D,Race(8),,
9,2,12,2,16,8,4,3,15,3,2,4,9,13,18,9,40,7,7,2.0,M2018-04-21D,Race(8),,
10,3,0,4,7,3,6,3,12,5,8,4,17,11,14,11,36,7.5,7.5,0.0,M2018-04-21D,Race(8),,
11,0,0,0,0,0,0,0,0,0,1,0,1,0,1,0,1,21,21,3.0,M2018-04-21D,Race(8),,
12,0,0,2,2,0,0,0,0,0,0,0,0,0,0,2,2,26,27,0.0,M2018-04-21D,Race(8),,
13,11,0,5,16,4,2,5,11,4,5,4,13,19,7,14,40,4.6,4.6,0.0,M2018-04-21D,Race(8),,
14,0,0,0,0,0,0,0,0,0,0,0,0,0,0,0,0,71,67,0.0,M2018-04-21D,Race(8),,
1,0,0,0,0,0,2,2,4,0,0,2,2,0,2,4,6,14,15,0.0,M2018-04-21D,Race(9),,
2,2,3,3,8,0,5,4,9,1,2,4,7,3,10,11,24,12,12,0.0,M2018-04-21D,Race(9),,
3,0,0,4,4,3,1,6,10,1,1,7,9,4,2,17,23,14,14,0.0,M2018-04-21D,Race(9),,
4,0,0,4,4,0,9,1,10,2,5,1,8,2,14,6,22,16,16,0.0,M2018-04-21D,Race(9),,
5,23,3,2,28,15,4,1,20,17,6,1,24,55,13,4,72,2.25,2.35,1.0,M2018-04-21D,Race(9),,
6,0,0,3,3,0,0,0,0,0,0,0,0,0,0,3,3,34,34,0.0,M2018-04-21D,Race(9),,
7,0,2,0,2,0,0,0,0,0,0,0,0,0,2,0,2,23,23,3.0,M2018-04-21D,Race(9),,
8,0,0,0,0,0,0,0,0,0,2,1,3,0,2,1,3,26,27,0.0,M2018-04-21D,Race(9),,
9,2,5,0,7,8,0,1,9,0,0,2,2,10,5,3,18,17,18,0.0,M2018-04-21D,Race(9),,
10,3,17,6,26,3,9,5,17,5,10,4,19,11,36,15,62,3.4,3.1,2.0,M2018-04-21D,Race(9),,
11,0,0,8,8,1,0,8,9,0,0,3,3,1,0,19,20,23,23,0.0,M2018-04-21D,Race(9),,
12,0,0,0,0,0,0,2,2,0,0,1,1,0,0,3,3,20,18,0.0,M2018-04-21D,Race(9),,
1,0,2,0,2,0,1,2,3,1,1,1,3,1,4,3,8,8.5,8.5,0.0,M2018-04-25D,Race(1),,
2,0,0,0,0,0,0,0,0,0,0,0,0,0,0,0,0,26,26,0.0,M2018-04-25D,Race(1),,
3,6,5,10,21,20,4,1,25,11,4,0,15,37,13,11,61,4.2,4.2,0.0,M2018-04-25D,Race(1),,
4,0,3,0,3,1,4,3,8,1,5,3,9,2,12,6,20,14,14,0.0,M2018-04-25D,Race(1),,
5,17,2,5,24,3,3,12,18,4,4,6,14,24,9,23,56,3.6,3.6,1.0,M2018-04-25D,Race(1),,
6,0,2,0,2,0,0,1,1,1,0,1,2,1,2,2,5,26,26,0.0,M2018-04-25D,Race(1),,
7,0,0,5,5,2,2,2,6,1,2,1,4,3,4,8,15,7.5,7.5,0.0,M2018-04-25D,Race(1),,
8,0,2,4,6,1,0,1,2,0,0,2,2,1,2,7,10,11,11,0.0,M2018-04-25D,Race(1),,
9,0,11,3,14,1,1,3,5,3,0,6,9,4,12,12,28,7.5,7.5,2.0,M2018-04-25D,Race(1),,
10,2,0,0,2,0,0,0,0,0,1,0,1,2,1,0,3,34,35,3.0,M2018-04-25D,Race(1),,
11,2,3,3,8,1,15,2,18,3,6,2,11,6,24,7,37,16,16,0.0,M2018-04-25D,Race(1),,
12,3,0,0,3,0,0,0,0,0,0,2,2,3,0,2,5,16,16,0.0,M2018-04-25D,Race(1),,
1,2,6,3,11,0,0,0,0,0,0,0,0,2,6,3,11,12,12,0.0,M2018-04-25D,Race(2),,
2,5,0,0,5,4,2,2,8,4,1,4,9,13,3,6,22,10,10,0.0,M2018-04-25D,Race(2),,
3,2,2,0,4,0,4,5,9,1,3,4,8,3,9,9,21,7,7,0.0,M2018-04-25D,Race(2),,
4,15,5,7,27,5,1,12,18,4,4,5,13,24,10,24,58,2.7,2.7,2.0,M2018-04-25D,Race(2),,
5,0,0,9,9,0,1,0,1,0,0,1,1,0,1,10,11,18,18,1.0,M2018-04-25D,Race(2),,
6,6,13,2,21,17,3,4,24,9,9,3,21,32,25,9,66,3.8,3.8,3.0,M2018-04-25D,Race(2),,
7,0,0,0,0,0,0,0,0,0,1,0,1,0,1,0,1,126,126,0.0,M2018-04-25D,Race(2),,
8,0,0,0,0,0,1,0,1,0,0,1,1,0,1,1,2,16,16,0.0,M2018-04-25D,Race(2),,
9,0,0,0,0,0,0,0,0,0,0,0,0,0,0,0,0,126,126,0.0,M2018-04-25D,Race(2),,
10,0,4,3,7,0,1,3,4,1,0,2,3,1,5,8,14,8.5,8.5,0.0,M2018-04-25D,Race(2),,
11,0,0,3,3,2,14,2,18,3,6,2,11,5,20,7,32,34,34,0.0,M2018-04-25D,Race(2),,
12,0,0,3,3,0,0,0,0,0,0,0,0,0,0,3,3,17,17,0.0,M2018-04-25D,Race(2),,
1,0,2,0,2,0,1,1,2,0,0,1,1,0,3,2,5,16,16,0.0,M2018-04-25D,Race(3),,
2,0,0,0,0,0,0,0,0,0,0,0,0,0,0,0,0,41,41,0.0,M2018-04-25D,Race(3),,
3,2,0,2,4,1,0,0,1,1,0,1,2,4,0,3,7,13,13,0.0,M2018-04-25D,Race(3),,
4,0,7,3,10,0,2,4,6,1,3,4,8,1,12,11,24,9,9,0.0,M2018-04-25D,Race(3),,
5,25,0,0,25,20,5,3,28,12,9,5,26,57,14,8,79,3.2,3.2,2.0,M2018-04-25D,Race(3),,
6,0,3,5,8,1,2,12,15,1,2,4,7,2,7,21,30,6,6,1.0,M2018-04-25D,Race(3),,
7,3,7,17,27,5,14,6,25,5,6,7,18,13,27,30,70,3.8,3.8,0.0,M2018-04-25D,Race(3),,
8,0,0,0,0,0,0,0,0,0,0,1,1,0,0,1,1,16,16,0.0,M2018-04-25D,Race(3),,
9,0,0,0,0,0,0,1,1,0,0,1,1,0,0,2,2,71,71,0.0,M2018-04-25D,Race(3),,
10,0,11,3,14,3,6,3,12,6,6,2,14,9,23,8,40,5.5,5.5,3.0,M2018-04-25D,Race(3),,
11,0,0,0,0,0,0,0,0,0,0,0,0,0,0,0,0,41,41,0.0,M2018-04-25D,Race(3),,
1,3,5,4,12,10,8,6,24,11,1,5,17,24,14,15,53,8,8,0.0,M2018-04-25D,Race(4),,
2,15,5,0,20,17,6,4,27,10,4,5,19,42,15,9,66,2.8,2.8,1.0,M2018-04-25D,Race(4),,
3,10,12,6,28,1,7,15,23,3,11,5,19,14,30,26,70,3.6,3.6,0.0,M2018-04-25D,Race(4),,
4,2,8,0,10,0,1,2,3,1,3,1,5,3,12,3,18,16,16,2.0,M2018-04-25D,Race(4),,
5,0,0,3,3,1,2,3,6,0,3,3,6,1,5,9,15,11,11,0.0,M2018-04-25D,Race(4),,
6,0,0,0,0,0,0,0,0,0,0,0,0,0,0,0,0,11,11,0.0,M2018-04-25D,Race(4),,
7,0,0,10,10,0,1,0,1,0,0,4,4,0,1,14,15,15,15,0.0,M2018-04-25D,Race(4),,
8,0,0,5,5,1,4,0,5,1,4,1,6,2,8,6,16,17,17,3.0,M2018-04-25D,Race(4),,
9,0,0,0,0,0,1,0,1,0,0,1,1,0,1,1,2,21,21,0.0,M2018-04-25D,Race(4),,
10,0,0,0,0,0,0,0,0,0,0,0,0,0,0,0,0,17,17,0.0,M2018-04-25D,Race(4),,
11,0,0,0,0,0,0,0,0,0,0,0,0,0,0,0,0,34,35,0.0,M2018-04-25D,Race(4),,
12,0,0,2,2,0,0,0,0,0,0,1,1,0,0,3,3,34,35,0.0,M2018-04-25D,Race(4),,
1,12,13,3,28,24,4,1,29,13,8,2,23,49,25,6,80,2.4,2.4,1.0,M2018-04-25D,Race(5),,
2,6,10,3,19,2,14,6,22,7,4,3,14,15,28,12,55,6.5,6.5,3.0,M2018-04-25D,Race(5),,
3,0,0,0,0,0,0,0,0,0,1,0,1,0,1,0,1,34,35,0.0,M2018-04-25D,Race(5),,
4,0,0,0,0,0,0,0,0,0,0,0,0,0,0,0,0,21,21,0.0,M2018-04-25D,Race(5),,
5,2,0,2,4,0,0,2,2,3,1,2,6,5,1,6,12,9,9,0.0,M2018-04-25D,Race(5),,
6,0,0,0,0,0,0,1,1,0,2,1,3,0,2,2,4,15,15,0.0,M2018-04-25D,Race(5),,
7,3,3,5,11,2,10,12,24,2,7,9,18,7,20,26,53,6,6,2.0,M2018-04-25D,Race(5),,
8,0,0,3,3,0,0,0,0,0,0,0,0,0,0,3,3,81,81,0.0,M2018-04-25D,Race(5),,
9,0,0,2,2,0,0,2,2,0,0,0,0,0,0,4,4,17,17,0.0,M2018-04-25D,Race(5),,
10,3,0,7,10,0,0,3,3,0,0,5,5,3,0,15,18,8,8,0.0,M2018-04-25D,Race(5),,
11,2,4,3,9,0,2,3,5,0,3,4,7,2,9,10,21,17,17,0.0,M2018-04-25D,Race(5),,
12,2,0,2,4,2,0,0,2,1,0,0,1,5,0,2,7,19,19,0.0,M2018-04-25D,Race(5),,
1,9,7,6,22,2,14,4,20,5,3,6,14,16,24,16,56,4.4,4.4,0.0,M2018-04-25D,Race(6),,
2,0,0,0,0,0,0,2,2,1,2,1,4,1,2,3,6,9,9,3.0,M2018-04-25D,Race(6),,
3,2,6,5,13,3,1,2,6,5,0,2,7,10,7,9,26,26,26,0.0,M2018-04-25D,Race(6),,
4,9,6,6,21,4,1,12,17,5,3,8,16,18,10,26,54,5.5,5.5,1.0,M2018-04-25D,Race(6),,
5,7,7,5,19,17,7,3,27,6,9,6,21,30,23,14,67,3,3,0.0,M2018-04-25D,Race(6),,
6,0,0,0,0,0,0,0,0,0,0,0,0,0,0,0,0,15,15,0.0,M2018-04-25D,Race(6),,
7,0,0,0,0,0,0,0,0,0,0,0,0,0,0,0,0,0,0,0.0,M2018-04-25D,Race(6),,
8,0,4,4,8,2,4,5,11,1,1,2,4,3,9,11,23,13,13,0.0,M2018-04-25D,Race(6),,
9,3,0,4,7,0,3,1,4,0,5,0,5,3,8,5,16,10,10,0.0,M2018-04-25D,Race(6),,
10,0,0,0,0,2,0,0,2,2,1,0,3,4,1,0,5,21,21,0.0,M2018-04-25D,Race(6),,
11,0,0,0,0,0,0,1,1,0,1,0,1,0,1,1,2,26,26,2.0,M2018-04-25D,Race(6),,
12,0,0,0,0,0,0,0,0,1,1,1,3,1,1,1,3,13,13,0.0,M2018-04-25D,Race(6),,
1,15,8,0,23,16,8,3,27,11,9,0,20,42,25,3,70,3.2,3.2,1.0,M2018-04-25D,Race(7),,
2,0,0,0,0,0,0,0,0,0,0,0,0,0,0,0,0,7,7,0.0,M2018-04-25D,Race(7),,
3,0,0,0,0,0,0,0,0,0,0,0,0,0,0,0,0,41,41,0.0,M2018-04-25D,Race(7),,
4,0,0,0,0,0,0,0,0,0,1,1,2,0,1,1,2,14,14,0.0,M2018-04-25D,Race(7),,
5,2,0,0,2,1,0,0,1,0,0,0,0,3,0,0,3,8,8,0.0,M2018-04-25D,Race(7),,
6,0,0,0,0,0,0,0,0,1,0,0,1,1,0,0,1,34,35,0.0,M2018-04-25D,Race(7),,
7,0,0,2,2,0,2,1,3,0,1,2,3,0,3,5,8,26,27,0.0,M2018-04-25D,Race(7),,
8,2,10,10,22,4,4,14,22,5,3,11,19,11,17,35,63,11,11,3.0,M2018-04-25D,Race(7),,
9,0,2,0,2,0,1,0,1,0,2,0,2,0,5,0,5,41,41,2.0,M2018-04-25D,Race(7),,
10,11,7,5,23,7,12,6,25,5,5,4,14,23,24,15,62,3.8,3.8,0.0,M2018-04-25D,Race(7),,
11,0,0,0,0,0,0,0,0,0,0,0,0,0,0,0,0,34,35,0.0,M2018-04-25D,Race(7),,
12,0,3,13,16,0,0,3,3,2,1,5,8,2,4,21,27,7,7,0.0,M2018-04-25D,Race(7),,
1,3,3,4,10,5,3,3,11,12,2,3,17,20,8,10,38,8,8,0.0,M2018-04-25D,Race(8),,
2,6,10,4,20,5,1,11,17,4,1,3,8,15,12,18,45,4,4,2.0,M2018-04-25D,Race(8),,
3,0,0,0,0,0,0,1,1,0,0,1,1,0,0,2,2,31,31,0.0,M2018-04-25D,Race(8),,
4,2,7,2,11,1,2,0,3,1,2,3,6,4,11,5,20,10,10,0.0,M2018-04-25D,Race(8),,
5,10,2,3,15,14,3,6,23,1,5,9,15,25,10,18,53,4,4,1.0,M2018-04-25D,Race(8),,
6,0,0,3,3,0,0,0,0,0,0,0,0,0,0,3,3,21,21,0.0,M2018-04-25D,Race(8),,
7,0,0,6,6,0,4,2,6,0,6,4,10,0,10,12,22,12,12,0.0,M2018-04-25D,Race(8),,
8,0,5,0,5,0,2,2,4,0,2,2,4,0,9,4,13,21,21,0.0,M2018-04-25D,Race(8),,
9,0,0,3,3,0,0,0,0,0,0,0,0,0,0,3,3,19,19,3.0,M2018-04-25D,Race(8),,
10,9,3,2,14,5,14,5,24,7,7,1,15,21,24,8,53,4,4,0.0,M2018-04-25D,Race(8),,
11,0,0,3,3,0,1,0,1,1,1,0,2,1,2,3,6,18,18,0.0,M2018-04-25D,Race(8),,
12,0,0,0,0,0,0,0,0,0,0,0,0,0,0,0,0,61,61,0.0,M2018-04-25D,Race(8),,
1,6,3,0,9,0,0,0,0,0,0,3,3,6,3,3,12,17,17,0.0,M2018-04-29D,Race(1),,
2,6,6,5,17,5,4,6,15,4,6,5,15,15,16,16,47,2.5,2.5,0.0,M2018-04-29D,Race(1),,
3,3,0,7,10,0,8,2,10,1,1,2,4,4,9,11,24,7.5,7.5,3.0,M2018-04-29D,Race(1),,
4,10,0,5,15,2,4,3,9,2,5,5,12,14,9,13,36,11,11,0.0,M2018-04-29D,Race(1),,
5,0,5,0,5,6,4,3,13,8,2,1,11,14,11,4,29,10,10,0.0,M2018-04-29D,Race(1),,
6,2,9,9,20,8,8,1,17,6,10,1,17,16,27,11,54,3.8,3.8,2.0,M2018-04-29D,Race(1),,
7,3,5,2,10,9,2,7,18,5,2,8,15,17,9,17,43,15,15,0.0,M2018-04-29D,Race(1),,
8,0,2,0,2,0,0,8,8,0,0,1,1,0,2,9,11,13,13,1.0,M2018-04-29D,Race(1),,
9,0,0,0,0,0,0,0,0,0,0,0,0,0,0,0,0,21,21,0.0,M2018-04-29D,Race(1),,
10,0,0,0,0,0,0,0,0,0,0,0,0,0,0,0,0,81,81,0.0,M2018-04-29D,Race(1),,
11,0,0,2,2,0,0,0,0,0,0,0,0,0,0,2,2,26,27,0.0,M2018-04-29D,Race(1),,
1,0,5,7,12,0,8,5,13,1,0,8,9,1,13,20,34,14,14,0.0,M2018-04-29D,Race(10),,
2,16,5,2,23,14,5,4,23,9,9,5,23,39,19,11,69,3.9,3.9,0.0,M2018-04-29D,Race(10),,
3,9,2,6,17,7,12,2,21,12,9,1,22,28,23,9,60,8,8,0.0,M2018-04-29D,Race(10),,
4,0,0,0,0,0,0,0,0,0,0,0,0,0,0,0,0,17,17,0.0,M2018-04-29D,Race(10),,
5,0,2,8,10,0,2,4,6,1,3,4,8,1,7,16,24,3.9,4,3.0,M2018-04-29D,Race(10),,
6,0,0,0,0,0,0,0,0,0,0,1,1,0,0,1,1,17,18,0.0,M2018-04-29D,Race(10),,
7,0,0,0,0,0,0,0,0,0,0,0,0,0,0,0,0,81,67,0.0,M2018-04-29D,Race(10),,
8,0,0,0,0,0,0,0,0,0,0,0,0,0,0,0,0,51,46,0.0,M2018-04-29D,Race(10),,
9,0,16,5,21,8,3,7,18,2,2,4,8,10,21,16,47,4.8,4.8,1.0,M2018-04-29D,Race(10),,
10,0,0,0,0,0,0,0,0,0,0,0,0,0,0,0,0,21,19,2.0,M2018-04-29D,Race(10),,
11,2,0,2,4,1,0,8,9,1,3,2,6,4,3,12,19,14,15,0.0,M2018-04-29D,Race(10),,
12,0,0,0,0,0,0,0,0,0,0,0,0,0,0,0,0,71,71,0.0,M2018-04-29D,Race(10),,
13,3,0,0,3,0,0,0,0,0,0,1,1,3,0,1,4,51,46,0.0,M2018-04-29D,Race(10),,
14,0,0,0,0,0,0,0,0,0,0,0,0,0,0,0,0,17,17,0.0,M2018-04-29D,Race(10),,
1,2,5,0,7,8,0,0,8,2,0,1,3,12,5,1,18,12,11,0.0,M2018-04-29D,Race(2),,
2,3,0,3,6,5,9,4,18,6,10,4,20,14,19,11,44,6.5,6.5,3.0,M2018-04-29D,Race(2),,
3,3,0,0,3,0,0,0,0,0,1,0,1,3,1,0,4,19,19,0.0,M2018-04-29D,Race(2),,
4,0,0,0,0,0,0,0,0,0,0,1,1,0,0,1,1,26,27,0.0,M2018-04-29D,Race(2),,
5,2,8,3,13,2,2,2,6,0,3,4,7,4,13,9,26,5,5,2.0,M2018-04-29D,Race(2),,
6,0,0,0,0,0,0,0,0,0,0,0,0,0,0,0,0,201,201,0.0,M2018-04-29D,Race(2),,
7,2,0,2,4,0,8,2,10,1,1,1,3,3,9,5,17,12,12,0.0,M2018-04-29D,Race(2),,
8,3,0,0,3,0,0,0,0,0,0,0,0,3,0,0,3,21,21,0.0,M2018-04-29D,Race(2),,
9,2,3,3,8,0,0,0,0,0,0,0,0,2,3,3,8,17,17,0.0,M2018-04-29D,Race(2),,
10,3,0,0,3,0,0,0,0,0,0,1,1,3,0,1,4,21,21,1.0,M2018-04-29D,Race(2),,
11,0,0,0,0,0,0,0,0,0,0,0,0,0,0,0,0,41,41,0.0,M2018-04-29D,Race(2),,
12,8,4,10,22,13,6,3,22,15,5,1,21,36,15,14,65,3.5,3.6,0.0,M2018-04-29D,Race(2),,
13,2,6,4,12,2,4,11,17,2,4,10,16,6,14,25,45,7,7,0.0,M2018-04-29D,Race(2),,
14,0,4,5,9,0,1,8,9,0,2,3,5,0,7,16,23,16,16,0.0,M2018-04-29D,Race(2),,
1,0,0,5,5,0,8,0,8,0,0,0,0,0,8,5,13,26,26,0.0,M2018-04-29D,Race(3),,
2,2,8,2,12,8,5,3,16,1,6,2,9,11,19,7,37,15,15,3.0,M2018-04-29D,Race(3),,
3,16,4,7,27,13,6,3,22,10,8,5,23,39,18,15,72,3,3,0.0,M2018-04-29D,Race(3),,
4,0,10,3,13,4,0,11,15,7,2,12,21,11,12,26,49,6,6,0.0,M2018-04-29D,Race(3),,
5,12,3,10,25,5,11,2,18,7,7,2,16,24,21,14,59,3.3,3.3,2.0,M2018-04-29D,Race(3),,
6,0,0,0,0,0,0,0,0,0,0,2,2,0,0,2,2,11,11,0.0,M2018-04-29D,Race(3),,
7,0,0,0,0,0,0,0,0,1,0,0,1,1,0,0,1,21,21,0.0,M2018-04-29D,Race(3),,
8,0,0,0,0,0,0,8,8,0,0,1,1,0,0,9,9,26,27,0.0,M2018-04-29D,Race(3),,
9,0,0,0,0,0,0,0,0,0,0,0,0,0,0,0,0,126,126,0.0,M2018-04-29D,Race(3),,
10,0,0,0,0,0,0,0,0,0,0,0,0,0,0,0,0,31,31,0.0,M2018-04-29D,Race(3),,
11,0,3,0,3,0,0,0,0,0,2,0,2,0,5,0,5,26,27,0.0,M2018-04-29D,Race(3),,
12,0,0,3,3,0,0,0,0,0,0,0,0,0,0,3,3,26,26,1.0,M2018-04-29D,Race(3),,
13,0,2,0,2,0,0,0,0,0,1,2,3,0,3,2,5,13,13,0.0,M2018-04-29D,Race(3),,
14,0,0,0,0,0,0,3,3,0,0,0,0,0,0,3,3,91,91,0.0,M2018-04-29D,Race(3),,
1,7,7,5,19,5,8,5,18,8,7,7,22,20,22,17,59,4.6,4.6,0.0,M2018-04-29D,Race(4),,
2,2,0,0,2,2,0,1,3,0,0,1,1,4,0,2,6,16,15,0.0,M2018-04-29D,Race(4),,
3,3,10,5,18,8,5,0,13,1,3,2,6,12,18,7,37,7.5,7.5,3.0,M2018-04-29D,Race(4),,
4,5,5,7,17,6,2,3,11,5,7,3,15,16,14,13,43,5.5,5.5,0.0,M2018-04-29D,Race(4),,
5,0,0,3,3,0,0,2,2,0,0,1,1,0,0,6,6,21,21,2.0,M2018-04-29D,Race(4),,
6,0,0,0,0,0,0,0,0,0,0,0,0,0,0,0,0,34,35,0.0,M2018-04-29D,Race(4),,
7,0,0,0,0,0,0,1,1,0,0,1,1,0,0,2,2,34,34,0.0,M2018-04-29D,Race(4),,
8,2,3,0,5,0,2,2,4,0,2,3,5,2,7,5,14,17,17,0.0,M2018-04-29D,Race(4),,
9,0,0,0,0,0,8,3,11,0,1,2,3,0,9,5,14,14,14,0.0,M2018-04-29D,Race(4),,
10,11,5,10,26,9,5,5,19,12,6,6,24,32,16,21,69,2.4,2.4,1.0,M2018-04-29D,Race(4),,
11,0,0,0,0,0,0,8,8,0,0,0,0,0,0,8,8,41,41,0.0,M2018-04-29D,Race(4),,
1,0,4,2,6,8,0,1,9,1,1,3,5,9,5,6,20,7.5,7.5,0.0,M2018-04-29D,Race(5),,
2,0,0,2,2,0,1,8,9,0,0,2,2,0,1,12,13,14,14,0.0,M2018-04-29D,Race(5),,
3,0,2,0,2,1,2,5,8,0,1,3,4,1,5,8,14,31,31,0.0,M2018-04-29D,Race(5),,
4,0,0,0,0,0,0,0,0,0,0,0,0,0,0,0,0,31,31,0.0,M2018-04-29D,Race(5),,
5,12,13,3,28,17,1,2,20,16,5,2,23,45,19,7,71,2.75,2.8,2.0,M2018-04-29D,Race(5),,
6,5,6,12,23,3,12,3,18,7,9,2,18,15,27,17,59,5,5,1.0,M2018-04-29D,Race(5),,
7,0,2,3,5,0,3,5,8,1,3,5,9,1,8,13,22,16,16,0.0,M2018-04-29D,Race(5),,
8,0,0,0,0,0,0,0,0,0,0,0,0,0,0,0,0,91,81,0.0,M2018-04-29D,Race(5),,
9,3,0,3,6,1,2,4,7,1,3,3,7,5,5,10,20,8,8,0.0,M2018-04-29D,Race(5),,
10,0,0,0,0,0,0,0,0,0,0,0,0,0,0,0,0,51,51,0.0,M2018-04-29D,Race(5),,
11,0,0,3,3,0,0,0,0,0,0,0,0,0,0,3,3,26,26,3.0,M2018-04-29D,Race(5),,
12,0,0,0,0,0,0,0,0,0,0,1,1,0,0,1,1,26,27,0.0,M2018-04-29D,Race(5),,
13,10,3,2,15,0,1,2,3,0,3,4,7,10,7,8,25,6.5,6.5,0.0,M2018-04-29D,Race(5),,
14,0,0,0,0,0,8,0,8,0,1,1,2,0,9,1,10,51,51,0.0,M2018-04-29D,Race(5),,
1,13,10,7,30,10,7,2,19,11,10,2,23,34,27,11,72,4,4.5,1.0,M2018-04-29D,Race(6),,
2,-,-,-,0,0,0,0,0,0,0,0,0,,,,0,0,0,0.0,M2018-04-29D,Race(6),,
3,15,13,0,28,11,10,2,23,15,9,2,26,41,32,4,77,2.25,3,0.0,M2018-04-29D,Race(6),,
4,0,0,3,3,1,9,4,14,0,2,4,6,1,11,11,23,10,10,0.0,M2018-04-29D,Race(6),,
5,0,2,5,7,8,0,3,11,0,0,8,8,8,2,16,26,10,10,2.0,M2018-04-29D,Race(6),,
6,0,0,0,0,0,0,0,0,0,0,1,1,0,0,1,1,34,21,0.0,M2018-04-29D,Race(6),,
7,0,0,0,0,0,0,8,8,0,0,2,2,0,0,10,10,14,10,3.0,M2018-04-29D,Race(6),,
8,0,0,6,6,0,0,4,4,0,1,3,4,0,1,13,14,6.5,6,0.0,M2018-04-29D,Race(6),,
9,2,5,9,16,0,4,7,11,0,4,4,8,2,13,20,35,9.5,12,0.0,M2018-04-29D,Race(6),,
1,20,6,2,28,18,10,2,30,12,11,3,26,50,27,7,84,3.4,3.25,2.0,M2018-04-29D,Race(7),,
2,3,15,12,30,12,8,1,21,12,11,2,25,27,34,15,76,3.3,3.25,3.0,M2018-04-29D,Race(7),,
3,0,2,2,4,0,1,4,5,0,0,5,5,0,3,11,14,14,12,0.0,M2018-04-29D,Race(7),,
4,0,0,0,0,0,0,8,8,0,0,1,1,0,0,9,9,23,21,0.0,M2018-04-29D,Race(7),,
5,0,0,3,3,0,0,0,0,0,0,1,1,0,0,4,4,26,26,0.0,M2018-04-29D,Race(7),,
6,3,3,0,6,0,8,0,8,0,0,2,2,3,11,2,16,5.5,5,0.0,M2018-04-29D,Race(7),,
7,0,0,3,3,0,0,6,6,0,0,5,5,0,0,14,14,12,12,0.0,M2018-04-29D,Race(7),,
8,0,0,0,0,0,0,0,0,0,0,0,0,0,0,0,0,51,51,0.0,M2018-04-29D,Race(7),,
9,4,4,8,16,0,3,9,12,2,4,7,13,6,11,24,41,4.2,7.5,1.0,M2018-04-29D,Race(7),,
1,18,8,4,30,15,7,1,23,22,3,1,26,55,18,6,79,3,3.2,0.0,M2018-04-29D,Race(8),,
2,0,0,3,3,0,3,6,9,0,3,6,9,0,6,15,21,7.5,7,0.0,M2018-04-29D,Race(8),,
3,5,8,9,22,0,9,11,20,0,5,11,16,5,22,31,58,6.5,6.5,1.0,M2018-04-29D,Race(8),,
4,0,3,0,3,0,0,0,0,0,0,0,0,0,3,0,3,15,13,0.0,M2018-04-29D,Race(8),,
5,7,9,9,25,15,11,4,30,4,15,6,25,26,35,19,80,2.45,2.6,0.0,M2018-04-29D,Race(8),,
6,0,0,2,2,0,0,8,8,0,0,1,1,0,0,11,11,26,21,3.0,M2018-04-29D,Race(8),,
7,0,2,3,5,0,0,0,0,0,0,1,1,0,2,4,6,15,13,2.0,M2018-04-29D,Race(8),,
8,0,0,0,0,0,0,0,0,0,0,0,0,0,0,0,0,31,26,0.0,M2018-04-29D,Race(8),,
1,26,2,2,30,18,5,0,23,20,3,1,24,64,10,3,77,2.25,2.25,2.0,M2018-04-29D,Race(9),,
2,0,5,0,5,0,0,0,0,0,0,1,1,0,5,1,6,15,15,0.0,M2018-04-29D,Race(9),,
3,0,0,3,3,0,0,0,0,0,0,0,0,0,0,3,3,61,61,0.0,M2018-04-29D,Race(9),,
4,0,0,0,0,0,0,0,0,0,0,1,1,0,0,1,1,19,20,0.0,M2018-04-29D,Race(9),,
5,0,2,3,5,1,10,2,13,0,3,4,7,1,15,9,25,14,13,0.0,M2018-04-29D,Race(9),,
6,2,5,4,11,0,3,5,8,3,5,3,11,5,13,12,30,6.5,6.5,0.0,M2018-04-29D,Race(9),,
7,0,0,0,0,0,0,0,0,0,0,0,0,0,0,0,0,41,35,0.0,M2018-04-29D,Race(9),,
8,0,0,3,3,0,0,1,1,0,0,0,0,0,0,4,4,51,46,0.0,M2018-04-29D,Race(9),,
9,0,0,3,3,0,0,8,8,0,0,3,3,0,0,14,14,9,9.5,0.0,M2018-04-29D,Race(9),,
10,0,0,0,0,8,0,1,9,1,1,1,3,9,1,2,12,21,21,0.0,M2018-04-29D,Race(9),,
11,2,11,7,20,2,6,5,13,1,5,4,10,5,22,16,43,20,20,3.0,M2018-04-29D,Race(9),,
12,0,0,0,0,0,0,0,0,0,1,0,1,0,1,0,1,18,18,0.0,M2018-04-29D,Race(9),,
13,0,0,0,0,0,0,0,0,0,0,0,0,0,0,0,0,61,61,0.0,M2018-04-29D,Race(9),,
14,0,5,5,10,1,6,8,15,1,8,8,17,2,19,21,42,6.5,6.5,1.0,M2018-04-29D,Race(9),,
1,0,0,2,2,0,1,2,3,1,2,5,8,1,3,9,13,17,17,0.0,M2018-05-02D,Race(1),,
2,2,0,2,4,1,1,1,3,1,5,1,7,4,6,4,14,17,17,0.0,M2018-05-02D,Race(1),,
3,5,6,6,17,6,2,11,19,5,2,4,11,16,10,21,47,5.5,5.5,0.0,M2018-05-02D,Race(1),,
4,9,11,8,28,16,8,3,27,14,6,1,21,39,25,12,76,2.8,2.8,0.0,M2018-05-02D,Race(1),,
5,6,6,7,19,7,13,2,22,5,5,2,12,18,24,11,53,4,4,0.0,M2018-05-02D,Race(1),,
6,8,2,0,10,0,3,2,5,0,4,1,5,8,9,3,20,15,15,0.0,M2018-05-02D,Race(1),,
7,0,0,0,0,0,0,0,0,0,0,0,0,0,0,0,0,71,71,0.0,M2018-05-02D,Race(1),,
8,0,3,0,3,0,1,2,3,0,1,2,3,0,5,4,9,26,26,0.0,M2018-05-02D,Race(1),,
9,0,0,0,0,0,0,0,0,0,0,1,1,0,0,1,1,21,21,2.0,M2018-05-02D,Race(1),,
10,0,0,5,5,0,1,2,3,0,0,1,1,0,1,8,9,13,13,3.0,M2018-05-02D,Race(1),,
11,0,0,0,0,0,0,3,3,0,0,4,4,0,0,7,7,17,17,1.0,M2018-05-02D,Race(1),,
12,0,2,0,2,0,0,1,1,0,0,3,3,0,2,4,6,11,11,0.0,M2018-05-02D,Race(1),,
13,0,0,0,0,0,0,0,0,0,0,0,0,0,0,0,0,0,0,0.0,M2018-05-02D,Race(1),,
14,0,0,0,0,0,0,0,0,0,0,0,0,0,0,0,0,0,0,0.0,M2018-05-02D,Race(1),,
1,8,4,3,15,5,13,2,20,5,5,2,12,18,22,7,47,5.5,5.5,3.0,M2018-05-02D,Race(2),,
2,3,6,7,16,4,1,11,16,4,4,5,13,11,11,23,45,8.5,8.5,0.0,M2018-05-02D,Race(2),,
3,0,0,2,2,0,0,0,0,0,1,0,1,0,1,2,3,41,41,0.0,M2018-05-02D,Race(2),,
4,10,2,0,12,16,6,2,24,6,4,6,16,32,12,8,52,3.8,3.8,1.0,M2018-05-02D,Race(2),,
5,5,5,0,10,0,2,2,4,3,3,3,9,8,10,5,23,6,6,0.0,M2018-05-02D,Race(2),,
6,0,3,13,16,3,2,3,8,3,2,0,5,6,7,16,29,8.5,8.5,0.0,M2018-05-02D,Race(2),,
7,0,0,0,0,0,0,0,0,0,0,0,0,0,0,0,0,41,41,0.0,M2018-05-02D,Race(2),,
8,0,0,0,0,0,0,0,0,0,0,0,0,0,0,0,0,51,51,2.0,M2018-05-02D,Race(2),,
9,0,0,0,0,0,0,0,0,0,0,0,0,0,0,0,0,81,81,0.0,M2018-05-02D,Race(2),,
10,0,0,0,0,0,0,0,0,0,0,0,0,0,0,0,0,51,51,0.0,M2018-05-02D,Race(2),,
11,0,0,0,0,0,1,2,3,1,2,0,3,1,3,2,6,15,15,0.0,M2018-05-02D,Race(2),,
12,0,0,0,0,0,2,3,5,0,0,5,5,0,2,8,10,21,21,0.0,M2018-05-02D,Race(2),,
13,4,8,2,14,2,3,5,10,4,5,5,14,10,16,12,38,5.5,5.5,0.0,M2018-05-02D,Race(2),,
14,0,2,3,5,0,0,0,0,0,0,0,0,0,2,3,5,19,19,0.0,M2018-05-02D,Race(2),,
1,4,0,12,16,4,14,4,22,3,10,4,17,11,24,20,55,7,7,2.0,M2018-05-02D,Race(3),,
2,0,8,3,11,4,3,3,10,9,2,5,16,13,13,11,37,4.4,4.4,0.0,M2018-05-02D,Race(3),,
3,0,0,0,0,0,0,0,0,0,0,0,0,0,0,0,0,71,67,0.0,M2018-05-02D,Race(3),,
4,3,4,6,13,1,3,4,8,2,3,3,8,6,10,13,29,4.4,4.4,0.0,M2018-05-02D,Race(3),,
5,0,0,0,0,1,0,1,2,1,0,4,5,2,0,5,7,26,26,3.0,M2018-05-02D,Race(3),,
6,15,8,5,28,17,6,4,27,10,6,6,22,42,20,15,77,3.4,3.4,1.0,M2018-05-02D,Race(3),,
7,0,0,0,0,0,0,0,0,0,0,0,0,0,0,0,0,41,41,0.0,M2018-05-02D,Race(3),,
8,2,0,0,2,0,0,0,0,0,0,0,0,2,0,0,2,61,61,0.0,M2018-05-02D,Race(3),,
9,0,5,0,5,3,3,8,14,1,1,0,2,4,9,8,21,10,10,0.0,M2018-05-02D,Race(3),,
10,6,3,4,13,0,1,6,7,0,4,4,8,6,8,14,28,5,5,0.0,M2018-05-02D,Race(3),,
11,0,0,0,0,0,0,0,0,0,0,0,0,0,0,0,0,71,67,0.0,M2018-05-02D,Race(3),,
12,0,2,0,2,0,0,0,0,0,0,0,0,0,2,0,2,51,51,0.0,M2018-05-02D,Race(3),,
1,0,0,0,0,0,0,0,0,0,0,1,1,0,0,1,1,41,41,0.0,M2018-05-02D,Race(4),,
2,5,12,8,25,6,6,13,25,10,8,1,19,21,26,22,69,5,5,0.0,M2018-05-02D,Race(4),,
3,0,0,0,0,0,0,0,0,1,0,0,1,1,0,0,1,18,18,0.0,M2018-05-02D,Race(4),,
4,0,2,0,2,0,1,3,4,0,0,4,4,0,3,7,10,8,8,3.0,M2018-05-02D,Race(4),,
5,8,11,9,28,4,17,5,26,2,10,8,20,14,38,22,74,4.8,4.8,0.0,M2018-05-02D,Race(4),,
6,17,5,8,30,20,4,5,29,13,4,6,23,50,13,19,82,1.9,1.9,2.0,M2018-05-02D,Race(4),,
7,0,0,5,5,0,1,3,4,0,2,4,6,0,3,12,15,8.5,8.5,1.0,M2018-05-02D,Race(4),,
8,0,0,0,0,0,0,0,0,0,1,0,1,0,1,0,1,21,21,0.0,M2018-05-02D,Race(4),,
1,3,5,7,15,3,5,4,12,1,6,3,10,7,16,14,37,6,6,2.0,M2018-05-02D,Race(5),,
2,0,3,0,3,0,0,3,3,1,1,2,4,1,4,5,10,7.5,7.5,0.0,M2018-05-02D,Race(5),,
3,8,2,0,10,7,11,3,21,4,1,5,10,19,14,8,41,7.5,7.5,3.0,M2018-05-02D,Race(5),,
4,10,6,5,21,4,3,12,19,9,2,3,14,23,11,20,54,5,5,0.0,M2018-05-02D,Race(5),,
5,5,5,5,15,1,2,2,5,3,4,3,10,9,11,10,30,7.5,7.5,1.0,M2018-05-02D,Race(5),,
6,0,4,9,13,0,4,1,5,0,3,4,7,0,11,14,25,5.5,5.5,0.0,M2018-05-02D,Race(5),,
7,0,0,0,0,0,0,0,0,0,0,0,0,0,0,0,0,81,81,0.0,M2018-05-02D,Race(5),,
8,2,2,2,6,15,4,3,22,7,6,4,17,24,12,9,45,12,12,0.0,M2018-05-02D,Race(5),,
9,0,0,0,0,0,0,0,0,0,0,0,0,0,0,0,0,17,17,0.0,M2018-05-02D,Race(5),,
10,0,0,0,0,0,0,1,1,0,0,1,1,0,0,2,2,26,26,0.0,M2018-05-02D,Race(5),,
11,0,3,2,5,0,1,1,2,0,2,1,3,0,6,4,10,8.5,8.5,0.0,M2018-05-02D,Race(5),,
12,2,0,0,2,0,0,0,0,1,1,0,2,3,1,0,4,21,21,0.0,M2018-05-02D,Race(5),,
1,6,5,8,19,2,5,15,22,2,4,6,12,10,14,29,53,7.5,7.5,0.0,M2018-05-02D,Race(6),,
2,0,0,0,0,0,0,0,0,0,0,0,0,0,0,0,0,71,67,0.0,M2018-05-02D,Race(6),,
3,17,3,8,28,22,4,2,28,18,4,3,25,57,11,13,81,3.3,3.3,1.0,M2018-05-02D,Race(6),,
4,0,0,0,0,0,0,1,1,0,0,1,1,0,0,2,2,15,15,0.0,M2018-05-02D,Race(6),,
5,0,0,0,0,0,0,1,1,0,0,1,1,0,0,2,2,18,18,0.0,M2018-05-02D,Race(6),,
6,5,3,9,17,3,14,6,23,4,7,7,18,12,24,22,58,4.8,4.8,3.0,M2018-05-02D,Race(6),,
7,2,0,0,2,0,3,3,6,0,5,6,11,2,8,9,19,21,21,0.0,M2018-05-02D,Race(6),,
8,0,2,0,2,1,0,0,1,2,0,0,2,3,2,0,5,21,21,0.0,M2018-05-02D,Race(6),,
9,0,12,5,17,1,3,0,4,0,5,1,6,1,20,6,27,4.4,4.4,2.0,M2018-05-02D,Race(6),,
10,0,0,0,0,1,1,1,3,0,1,0,1,1,2,1,4,34,34,0.0,M2018-05-02D,Race(6),,
11,0,0,0,0,0,0,0,0,0,0,0,0,0,0,0,0,13,13,0.0,M2018-05-02D,Race(6),,
12,0,3,0,3,0,0,1,1,0,0,0,0,0,3,1,4,26,26,0.0,M2018-05-02D,Race(6),,
13,0,0,0,0,0,0,0,0,0,0,1,1,0,0,1,1,34,34,0.0,M2018-05-02D,Race(6),,
14,0,2,0,2,0,0,0,0,0,0,0,0,0,2,0,2,51,51,0.0,M2018-05-02D,Race(6),,
1,0,2,0,2,2,1,1,4,3,3,2,8,5,6,3,14,26,26,0.0,M2018-05-02D,Race(7),,
2,4,7,0,11,13,2,4,19,5,0,5,10,22,9,9,40,4.4,4.5,1.0,M2018-05-02D,Race(7),,
3,0,0,0,0,0,0,0,0,0,0,1,1,0,0,1,1,41,41,0.0,M2018-05-02D,Race(7),,
4,0,0,2,2,0,0,1,1,0,0,2,2,0,0,5,5,41,41,0.0,M2018-05-02D,Race(7),,
5,0,0,0,0,0,1,2,3,0,1,1,2,0,2,3,5,14,14,0.0,M2018-05-02D,Race(7),,
6,0,0,0,0,0,0,0,0,0,0,1,1,0,0,1,1,26,26,3.0,M2018-05-02D,Race(7),,
7,0,0,8,8,1,2,1,4,1,1,1,3,2,3,10,15,17,17,0.0,M2018-05-02D,Race(7),,
8,0,0,2,2,1,0,1,2,1,1,0,2,2,1,3,6,15,15,2.0,M2018-05-02D,Race(7),,
9,2,0,2,4,2,1,1,4,2,5,1,8,6,6,4,16,14,14,0.0,M2018-05-02D,Race(7),,
10,0,0,0,0,0,0,0,0,0,0,0,0,0,0,0,0,71,67,0.0,M2018-05-02D,Race(7),,
11,0,0,0,0,0,2,1,3,1,2,1,4,1,4,2,7,21,21,0.0,M2018-05-02D,Race(7),,
12,7,7,6,20,4,3,5,12,4,3,5,12,15,13,16,44,7,7,0.0,M2018-05-02D,Race(7),,
13,8,8,3,19,5,14,2,21,5,5,3,13,18,27,8,53,3.5,3.5,0.0,M2018-05-02D,Race(7),,
14,9,6,7,22,2,4,11,17,4,5,3,12,15,15,21,51,5,5,0.0,M2018-05-02D,Race(7),,
1,0,0,0,0,0,0,0,0,0,0,0,0,0,0,0,0,21,21,0.0,M2018-05-02D,Race(8),,
2,0,0,2,2,0,1,0,1,0,1,0,1,0,2,2,4,9,9,0.0,M2018-05-02D,Race(8),,
3,0,0,5,5,0,3,1,4,0,3,3,6,0,6,9,15,21,21,0.0,M2018-05-02D,Race(8),,
4,21,7,2,30,15,2,3,20,21,3,1,25,57,12,6,75,2,2,0.0,M2018-05-02D,Race(8),,
5,0,5,3,8,0,2,1,3,3,0,4,7,3,7,8,18,11,11,0.0,M2018-05-02D,Race(8),,
6,0,0,0,0,0,0,1,1,0,0,0,0,0,0,1,1,61,61,1.0,M2018-05-02D,Race(8),,
7,0,5,3,8,0,3,4,7,0,3,5,8,0,11,12,23,7,7,0.0,M2018-05-02D,Race(8),,
8,4,2,3,9,2,2,14,18,1,4,4,9,7,8,21,36,34,34,3.0,M2018-05-02D,Race(8),,
9,0,2,3,5,0,1,1,2,0,1,3,4,0,4,7,11,51,51,0.0,M2018-05-02D,Race(8),,
10,0,0,0,0,0,0,0,0,0,0,0,0,0,0,0,0,11,11,0.0,M2018-05-02D,Race(8),,
11,3,6,4,13,1,15,2,18,1,10,4,15,5,31,10,46,10,10,2.0,M2018-05-02D,Race(8),,
12,2,3,5,10,2,0,2,4,0,1,2,3,4,4,9,17,8,8,0.0,M2018-05-02D,Race(8),,
1,0,0,0,0,0,0,0,0,0,0,1,1,0,0,1,1,81,81,0.0,M2018-05-06D,Race(1),,
2,0,0,0,0,0,0,9,9,0,2,4,6,0,2,13,15,51,51,0.0,M2018-05-06D,Race(1),,
3,0,4,10,14,0,3,11,14,0,6,13,19,0,13,34,47,9.5,9.5,0.0,M2018-05-06D,Race(1),,
4,30,0,0,30,19,4,0,23,21,3,0,24,70,7,0,77,1.3,1.3,1.0,M2018-05-06D,Race(1),,
5,0,18,12,30,11,14,5,30,5,14,5,24,16,46,22,84,4.8,4.8,2.0,M2018-05-06D,Race(1),,
6,0,8,8,16,0,9,5,14,0,1,3,4,0,18,16,34,8.5,8.5,0.0,M2018-05-06D,Race(1),,
1,0,0,0,0,0,0,0,0,0,0,1,1,0,0,1,1,41,41,0.0,M2018-05-06D,Race(10),,
2,0,3,2,5,0,0,8,8,0,0,1,1,0,3,11,14,81,81,0.0,M2018-05-06D,Race(10),,
3,7,11,5,23,14,7,0,21,17,6,1,24,38,24,6,68,2.9,2.9,0.0,M2018-05-06D,Race(10),,
4,0,0,0,0,8,0,0,8,0,0,0,0,8,0,0,8,13,13,0.0,M2018-05-06D,Race(10),,
5,7,2,7,16,2,2,6,10,2,3,3,8,11,7,16,34,8.5,8.5,0.0,M2018-05-06D,Race(10),,
6,0,0,0,0,0,0,0,0,0,1,0,1,0,1,0,1,41,41,0.0,M2018-05-06D,Race(10),,
7,2,0,0,2,0,8,2,10,0,0,3,3,2,8,5,15,8,8,0.0,M2018-05-06D,Race(10),,
8,2,3,0,5,0,0,0,0,0,2,2,4,2,5,2,9,17,17,2.0,M2018-05-06D,Race(10),,
9,0,2,0,2,1,2,2,5,0,2,1,3,1,6,3,10,21,21,3.0,M2018-05-06D,Race(10),,
10,0,0,0,0,0,0,0,0,0,0,0,0,0,0,0,0,51,51,0.0,M2018-05-06D,Race(10),,
11,3,0,8,11,0,3,5,8,0,2,4,6,3,5,17,25,7.5,7.5,0.0,M2018-05-06D,Race(10),,
12,0,0,0,0,0,0,0,0,0,0,0,0,0,0,0,0,51,51,0.0,M2018-05-06D,Race(10),,
13,9,9,8,26,5,8,7,20,7,10,5,22,21,27,20,68,3.6,3.6,1.0,M2018-05-06D,Race(10),,
14,0,0,0,0,0,0,0,0,0,0,0,0,0,0,0,0,71,67,0.0,M2018-05-06D,Race(10),,
1,0,0,0,0,0,1,0,1,1,0,0,1,1,1,0,2,34,35,0.0,M2018-05-06D,Race(11),,
2,0,3,3,6,0,1,9,10,0,1,2,3,0,5,14,19,26,26,0.0,M2018-05-06D,Race(11),,
3,21,9,0,30,11,9,2,22,13,11,1,25,45,29,3,77,2.6,2.6,2.0,M2018-05-06D,Race(11),,
4,0,0,0,0,0,0,0,0,0,0,0,0,0,0,0,0,34,35,0.0,M2018-05-06D,Race(11),,
5,0,0,0,0,0,0,0,0,0,0,0,0,0,0,0,0,101,101,0.0,M2018-05-06D,Race(11),,
6,9,16,2,27,11,10,0,21,11,9,2,22,31,35,4,70,2.6,2.6,1.0,M2018-05-06D,Race(11),,
7,0,0,5,5,0,8,1,9,1,3,3,7,1,11,9,21,15,15,3.0,M2018-05-06D,Race(11),,
8,0,0,0,0,0,0,0,0,0,0,0,0,0,0,0,0,12,12,0.0,M2018-05-06D,Race(11),,
9,0,0,0,0,0,0,0,0,0,0,0,0,0,0,0,0,101,101,0.0,M2018-05-06D,Race(11),,
10,0,0,11,11,8,1,13,22,0,2,12,14,8,3,36,47,10,10,0.0,M2018-05-06D,Race(11),,
11,0,0,9,9,0,0,5,5,0,0,6,6,0,0,20,20,34,35,0.0,M2018-05-06D,Race(11),,
12,0,0,0,0,0,0,0,0,0,0,0,0,0,0,0,0,101,101,0.0,M2018-05-06D,Race(11),,
13,0,0,0,0,0,0,0,0,0,0,0,0,0,0,0,0,41,41,0.0,M2018-05-06D,Race(11),,
14,0,2,0,2,0,0,0,0,0,0,0,0,0,2,0,2,10,10,0.0,M2018-05-06D,Race(11),,
1,3,5,9,17,3,1,6,10,4,0,10,14,10,6,25,41,0,0,0.0,M2018-05-06D,Race(2),,
2,13,8,2,23,4,9,4,17,8,6,4,18,25,23,10,58,3.8,3.8,1.0,M2018-05-06D,Race(2),,
3,14,10,3,27,14,7,0,21,12,8,1,21,40,25,4,69,2.5,2.5,3.0,M2018-05-06D,Race(2),,
4,0,0,0,0,0,0,0,0,0,1,0,1,0,1,0,1,81,81,0.0,M2018-05-06D,Race(2),,
5,0,2,0,2,8,2,2,12,1,1,3,5,9,5,5,19,8.5,8.5,0.0,M2018-05-06D,Race(2),,
6,0,0,3,3,0,0,0,0,0,0,0,0,0,0,3,3,26,26,0.0,M2018-05-06D,Race(2),,
7,0,0,4,4,1,2,6,9,1,3,3,7,2,5,13,20,11,11,0.0,M2018-05-06D,Race(2),,
8,0,3,0,3,0,0,1,1,0,0,1,1,0,3,2,5,19,19,0.0,M2018-05-06D,Race(2),,
9,0,2,3,5,0,1,2,3,0,2,3,5,0,5,8,13,13,13,0.0,M2018-05-06D,Race(2),,
10,0,0,0,0,0,0,0,0,0,0,0,0,0,0,0,0,126,126,0.0,M2018-05-06D,Race(2),,
11,0,0,0,0,0,0,0,0,0,0,0,0,0,0,0,0,51,51,0.0,M2018-05-06D,Race(2),,
12,0,0,6,6,0,8,1,9,0,5,1,6,0,13,8,21,8,8,0.0,M2018-05-06D,Race(2),,
13,0,0,0,0,0,0,8,8,0,0,0,0,0,0,8,8,21,21,2.0,M2018-05-06D,Race(2),,
14,0,0,0,0,0,0,0,0,0,0,0,0,0,0,0,0,26,26,0.0,M2018-05-06D,Race(2),,
1,11,8,2,21,13,5,3,21,16,5,0,21,40,18,5,63,4,4,0.0,M2018-05-06D,Race(3),,
2,0,3,2,5,1,1,0,2,2,2,0,4,3,6,2,11,8.5,8.5,0.0,M2018-05-06D,Race(3),,
3,9,7,7,23,4,10,5,19,3,8,8,19,16,25,20,61,4.2,4.2,0.0,M2018-05-06D,Race(3),,
4,0,0,0,0,0,0,0,0,0,0,0,0,0,0,0,0,81,81,0.0,M2018-05-06D,Race(3),,
5,0,9,9,18,2,2,6,10,0,3,2,5,2,14,17,33,8.5,8.5,1.0,M2018-05-06D,Race(3),,
6,0,0,2,2,1,2,3,6,1,1,5,7,2,3,10,15,10,10,0.0,M2018-05-06D,Race(3),,
7,0,0,3,3,0,0,8,8,0,0,4,4,0,0,15,15,15,15,0.0,M2018-05-06D,Race(3),,
8,0,0,0,0,0,8,0,8,1,2,0,3,1,10,0,11,21,21,0.0,M2018-05-06D,Race(3),,
9,2,0,0,2,0,0,1,1,0,0,1,1,2,0,2,4,17,17,0.0,M2018-05-06D,Race(3),,
10,2,0,0,2,1,0,1,2,0,2,0,2,3,2,1,6,21,21,0.0,M2018-05-06D,Race(3),,
11,0,0,0,0,0,0,0,0,0,0,2,2,0,0,2,2,19,19,3.0,M2018-05-06D,Race(3),,
12,0,0,0,0,0,2,2,4,0,2,3,5,0,4,5,9,19,19,0.0,M2018-05-06D,Race(3),,
13,2,3,0,5,8,0,1,9,3,1,1,5,13,4,2,19,15,15,2.0,M2018-05-06D,Race(3),,
14,4,0,5,9,0,0,0,0,0,0,0,0,4,0,5,9,14,14,0.0,M2018-05-06D,Race(3),,
1,3,18,4,25,5,12,4,21,7,8,7,22,15,38,15,68,2.8,2.8,0.0,M2018-05-06D,Race(4),,
2,21,5,4,30,15,6,2,23,16,7,2,25,52,18,8,78,2.3,2.3,1.0,M2018-05-06D,Race(4),,
3,4,0,12,16,10,4,12,26,3,8,9,20,17,12,33,62,4.4,4.4,2.0,M2018-05-06D,Race(4),,
4,0,4,5,9,0,0,9,9,0,0,3,3,0,4,17,21,10,10,3.0,M2018-05-06D,Race(4),,
5,0,0,0,0,0,0,0,0,0,0,1,1,0,0,1,1,51,51,0.0,M2018-05-06D,Race(4),,
6,2,3,2,7,0,8,3,11,0,3,4,7,2,14,9,25,10,10,0.0,M2018-05-06D,Race(4),,
7,0,0,3,3,0,0,0,0,0,0,0,0,0,0,3,3,41,41,0.0,M2018-05-06D,Race(4),,
8,0,0,0,0,0,0,0,0,0,0,0,0,0,0,0,0,34,35,0.0,M2018-05-06D,Race(4),,
1,3,0,4,7,1,9,2,12,2,2,1,5,6,11,7,24,19,19,3.0,M2018-05-06D,Race(5),,
2,5,12,7,24,4,10,7,21,5,10,7,22,14,32,21,67,4,4,0.0,M2018-05-06D,Race(5),,
3,0,3,0,3,0,0,2,2,0,0,3,3,0,3,5,8,21,21,0.0,M2018-05-06D,Race(5),,
4,13,5,0,18,13,6,4,23,11,7,8,26,37,18,12,67,2.6,2.6,0.0,M2018-05-06D,Race(5),,
5,0,0,0,0,8,0,0,8,0,1,0,1,8,1,0,9,21,21,0.0,M2018-05-06D,Race(5),,
6,0,0,0,0,0,0,0,0,0,0,0,0,0,0,0,0,71,67,0.0,M2018-05-06D,Race(5),,
7,0,0,0,0,0,0,0,0,0,0,1,1,0,0,1,1,19,19,0.0,M2018-05-06D,Race(5),,
8,0,6,11,17,0,0,2,2,1,0,2,3,1,6,15,22,6,6,1.0,M2018-05-06D,Race(5),,
9,0,0,0,0,0,0,0,0,0,0,0,0,0,0,0,0,41,41,0.0,M2018-05-06D,Race(5),,
10,9,0,5,14,4,5,5,14,6,5,3,14,19,10,13,42,5.5,5.5,2.0,M2018-05-06D,Race(5),,
11,0,0,0,0,0,0,0,0,0,0,0,0,0,0,0,0,151,151,0.0,M2018-05-06D,Race(5),,
12,0,0,0,0,0,0,0,0,0,0,0,0,0,0,0,0,151,151,0.0,M2018-05-06D,Race(5),,
13,0,4,3,7,0,0,8,8,1,1,1,3,1,5,12,18,19,19,0.0,M2018-05-06D,Race(5),,
14,0,0,0,0,0,0,0,0,0,0,0,0,0,0,0,0,101,101,0.0,M2018-05-06D,Race(5),,
1,14,14,2,30,10,9,2,21,11,6,5,22,35,29,9,73,4.4,4.5,0.0,M2018-05-06D,Race(6),,
2,5,10,2,17,6,2,5,13,7,3,4,14,18,15,11,44,5,5,0.0,M2018-05-06D,Race(6),,
3,3,0,3,6,0,8,2,10,0,0,3,3,3,8,8,19,13,13,1.0,M2018-05-06D,Race(6),,
4,0,0,0,0,0,0,8,8,0,0,2,2,0,0,10,10,21,21,0.0,M2018-05-06D,Race(6),,
5,2,3,9,14,4,10,6,20,5,12,2,19,11,25,17,53,3.5,3.5,0.0,M2018-05-06D,Race(6),,
6,0,0,0,0,0,0,0,0,0,0,0,0,0,0,0,0,31,31,0.0,M2018-05-06D,Race(6),,
7,0,0,0,0,0,0,0,0,0,1,0,1,0,1,0,1,41,41,0.0,M2018-05-06D,Race(6),,
8,4,0,6,10,8,1,3,12,0,2,5,7,12,3,14,29,11,11,0.0,M2018-05-06D,Race(6),,
9,0,0,0,0,0,0,0,0,0,0,0,0,0,0,0,0,71,67,0.0,M2018-05-06D,Race(6),,
10,0,0,0,0,0,0,0,0,0,0,0,0,0,0,0,0,101,101,0.0,M2018-05-06D,Race(6),,
11,2,3,8,13,2,0,2,4,2,1,2,5,6,4,12,22,7,7,3.0,M2018-05-06D,Race(6),,
12,0,0,0,0,0,0,2,2,1,1,3,5,1,1,5,7,14,14,2.0,M2018-05-06D,Race(6),,
13,0,0,0,0,0,0,0,0,0,0,0,0,0,0,0,0,21,21,0.0,M2018-05-06D,Race(6),,
14,0,0,0,0,0,0,0,0,0,0,0,0,0,0,0,0,34,34,0.0,M2018-05-06D,Race(6),,
1,0,0,2,2,0,0,1,1,0,0,0,0,0,0,3,3,26,26,0.0,M2018-05-06D,Race(7),,
2,0,0,0,0,0,0,0,0,0,0,1,1,0,0,1,1,51,51,0.0,M2018-05-06D,Race(7),,
3,0,0,0,0,1,0,2,3,2,0,1,3,3,0,3,6,17,17,0.0,M2018-05-06D,Race(7),,
4,7,13,2,22,8,6,7,21,13,6,6,25,28,25,15,68,3.6,3.6,2.0,M2018-05-06D,Race(7),,
5,9,4,6,19,4,5,5,14,2,3,8,13,15,12,19,46,4,4,1.0,M2018-05-06D,Race(7),,
6,0,0,0,0,0,0,0,0,0,0,0,0,0,0,0,0,34,34,0.0,M2018-05-06D,Race(7),,
7,0,0,0,0,0,0,0,0,0,0,0,0,0,0,0,0,51,51,0.0,M2018-05-06D,Race(7),,
8,0,0,0,0,0,0,0,0,0,0,0,0,0,0,0,0,101,101,0.0,M2018-05-06D,Race(7),,
9,14,3,4,21,6,5,3,14,8,6,3,17,28,14,10,52,4.6,4.6,0.0,M2018-05-06D,Race(7),,
10,0,0,0,0,1,0,0,1,0,0,0,0,1,0,0,1,19,19,0.0,M2018-05-06D,Race(7),,
11,0,0,0,0,0,0,8,8,0,0,0,0,0,0,8,8,21,21,0.0,M2018-05-06D,Race(7),,
12,0,2,5,7,0,8,0,8,0,1,1,2,0,11,6,17,16,16,0.0,M2018-05-06D,Race(7),,
13,0,8,2,10,2,4,3,9,1,6,5,12,3,18,10,31,11,11,3.0,M2018-05-06D,Race(7),,
14,0,0,9,9,8,2,1,11,0,4,1,5,8,6,11,25,8,8,0.0,M2018-05-06D,Race(7),,
1,0,2,0,2,1,0,3,4,2,0,4,6,3,2,7,12,19,19,0.0,M2018-05-06D,Race(8),,
2,0,0,0,0,0,0,0,0,0,0,0,0,0,0,0,0,101,101,0.0,M2018-05-06D,Race(8),,
3,3,8,3,14,8,0,1,9,2,0,0,2,13,8,4,25,5,5,0.0,M2018-05-06D,Race(8),,
4,0,0,0,0,0,8,0,8,0,0,0,0,0,8,0,8,41,41,0.0,M2018-05-06D,Race(8),,
5,24,3,0,27,14,5,2,21,17,5,2,24,55,13,4,72,2.8,2.8,1.0,M2018-05-06D,Race(8),,
6,0,0,0,0,0,0,0,0,0,0,0,0,0,0,0,0,101,101,0.0,M2018-05-06D,Race(8),,
7,0,0,0,0,0,0,8,8,1,0,1,2,1,0,9,10,34,35,2.0,M2018-05-06D,Race(8),,
8,0,2,6,8,1,0,6,7,2,4,6,12,3,6,18,27,10,10,0.0,M2018-05-06D,Race(8),,
9,3,0,0,3,0,0,0,0,0,0,0,0,3,0,0,3,101,101,0.0,M2018-05-06D,Race(8),,
10,0,0,0,0,0,0,0,0,0,0,0,0,0,0,0,0,34,35,0.0,M2018-05-06D,Race(8),,
11,0,4,5,9,0,4,7,11,0,2,10,12,0,10,22,32,5.5,5.5,0.0,M2018-05-06D,Race(8),,
12,0,0,3,3,0,0,0,0,0,0,1,1,0,0,4,4,71,71,0.0,M2018-05-06D,Race(8),,
13,0,11,13,24,6,13,3,22,2,15,2,19,8,39,18,65,3.8,3.8,3.0,M2018-05-06D,Race(8),,
14,0,0,0,0,0,0,0,0,0,0,0,0,0,0,0,0,81,81,0.0,M2018-05-06D,Race(8),,
1,0,4,3,7,6,3,2,11,5,1,0,6,11,8,5,24,13,13,0.0,M2018-05-06D,Race(9),,
2,14,2,3,19,10,7,3,20,9,6,3,18,33,15,9,57,3,3,0.0,M2018-05-06D,Race(9),,
3,3,0,5,8,2,2,0,4,1,6,3,10,6,8,8,22,9,9,0.0,M2018-05-06D,Race(9),,
4,5,7,0,12,4,5,5,14,6,2,1,9,15,14,6,35,6,6,0.0,M2018-05-06D,Race(9),,
5,0,3,3,6,0,1,1,2,0,4,4,8,0,8,8,16,10,10,0.0,M2018-05-06D,Race(9),,
6,3,6,4,13,8,4,7,19,3,4,8,15,14,14,19,47,4.2,4.2,0.0,M2018-05-06D,Race(9),,
7,2,0,2,4,0,8,1,9,0,2,0,2,2,10,3,15,19,19,3.0,M2018-05-06D,Race(9),,
8,0,0,0,0,0,0,0,0,0,0,0,0,0,0,0,0,31,31,1.0,M2018-05-06D,Race(9),,
9,0,0,0,0,0,0,0,0,0,0,0,0,0,0,0,0,81,81,0.0,M2018-05-06D,Race(9),,
10,0,0,0,0,0,0,0,0,0,0,0,0,0,0,0,0,81,81,0.0,M2018-05-06D,Race(9),,
11,3,2,5,10,0,0,9,9,0,0,5,5,3,2,19,24,19,19,2.0,M2018-05-06D,Race(9),,
12,0,6,5,11,0,0,2,2,2,1,2,5,2,7,9,18,9,9,0.0,M2018-05-06D,Race(9),,
1,13,9,5,27,21,6,1,28,7,6,4,17,41,21,10,72,0,0,1.0,M2018-05-09D,Race(1),,
2,0,5,2,7,4,14,3,21,3,2,1,6,7,21,6,34,0,0,0.0,M2018-05-09D,Race(1),,
3,0,3,4,7,1,2,5,8,2,7,6,15,3,12,15,30,0,0,0.0,M2018-05-09D,Race(1),,
4,2,0,6,8,1,0,3,4,1,0,3,4,4,0,12,16,0,0,0.0,M2018-05-09D,Race(1),,
5,0,0,0,0,0,0,0,0,0,1,0,1,0,1,0,1,0,0,0.0,M2018-05-09D,Race(1),,
6,5,0,4,9,0,1,5,6,5,3,0,8,10,4,9,23,0,0,0.0,M2018-05-09D,Race(1),,
7,0,2,0,2,0,0,2,2,1,0,1,2,1,2,3,6,0,0,0.0,M2018-05-09D,Race(1),,
8,10,6,0,16,3,7,10,20,7,5,4,16,20,18,14,52,0,0,0.0,M2018-05-09D,Race(1),,
9,0,0,3,3,0,0,0,0,0,0,0,0,0,0,3,3,0,0,0.0,M2018-05-09D,Race(1),,
10,0,0,0,0,0,0,0,0,0,0,0,0,0,0,0,0,0,0,0.0,M2018-05-09D,Race(1),,
11,0,0,0,0,0,0,0,0,0,1,5,6,0,1,5,6,0,0,3.0,M2018-05-09D,Race(1),,
12,0,5,6,11,0,0,1,1,0,1,2,3,0,6,9,15,0,0,2.0,M2018-05-09D,Race(1),,
1,3,2,6,11,4,14,2,20,4,8,1,13,11,24,9,44,0,0,1.0,M2018-05-09D,Race(2),,
2,0,0,0,0,1,0,0,1,0,1,2,3,1,1,2,4,0,0,0.0,M2018-05-09D,Race(2),,
3,0,0,0,0,1,0,4,5,2,0,2,4,3,0,6,9,0,0,0.0,M2018-05-09D,Race(2),,
4,0,2,0,2,0,1,0,1,0,0,0,0,0,3,0,3,0,0,0.0,M2018-05-09D,Race(2),,
5,4,5,5,14,2,1,2,5,2,0,2,4,8,6,9,23,0,0,0.0,M2018-05-09D,Race(2),,
6,6,3,6,15,2,5,3,10,0,7,7,14,8,15,16,39,0,0,0.0,M2018-05-09D,Race(2),,
7,9,11,5,25,16,6,4,26,13,5,3,21,38,22,12,72,0,0,3.0,M2018-05-09D,Race(2),,
8,8,4,5,17,3,3,15,21,4,1,6,11,15,8,26,49,0,0,0.0,M2018-05-09D,Race(2),,
9,0,3,0,3,1,0,0,1,1,3,3,7,2,6,3,11,0,0,2.0,M2018-05-09D,Race(2),,
10,0,0,0,0,0,0,0,0,0,1,0,1,0,1,0,1,0,0,0.0,M2018-05-09D,Race(2),,
11,0,0,0,0,0,0,0,0,0,0,0,0,0,0,0,0,0,0,0.0,M2018-05-09D,Race(2),,
12,0,0,3,3,0,0,0,0,0,0,0,0,0,0,3,3,0,0,0.0,M2018-05-09D,Race(2),,
1,3,2,6,11,2,3,2,7,3,3,5,11,8,8,13,29,0,0,0.0,M2018-05-09D,Race(3),,
2,0,0,2,2,0,0,0,0,0,0,0,0,0,0,2,2,0,0,0.0,M2018-05-09D,Race(3),,
3,0,0,0,0,0,1,0,1,0,0,0,0,0,1,0,1,0,0,0.0,M2018-05-09D,Race(3),,
4,0,9,8,17,3,1,3,7,4,2,2,8,7,12,13,32,0,0,0.0,M2018-05-09D,Race(3),,
5,0,0,2,2,2,2,1,5,2,1,0,3,4,3,3,10,0,0,0.0,M2018-05-09D,Race(3),,
6,5,5,0,10,0,0,0,0,0,5,1,6,5,10,1,16,0,0,0.0,M2018-05-09D,Race(3),,
7,8,2,5,15,4,5,14,23,4,5,7,16,16,12,26,54,0,0,1.0,M2018-05-09D,Race(3),,
8,0,0,0,0,0,0,0,0,0,0,0,0,0,0,0,0,0,0,3.0,M2018-05-09D,Race(3),,
9,0,6,0,6,0,13,6,19,2,7,3,12,2,26,9,37,0,0,0.0,M2018-05-09D,Race(3),,
10,2,6,2,10,0,1,2,3,0,0,5,5,2,7,9,18,0,0,0.0,M2018-05-09D,Race(3),,
11,12,0,5,17,19,4,2,25,10,3,3,16,41,7,10,58,0,0,2.0,M2018-05-09D,Race(3),,
12,0,0,0,0,0,0,0,0,1,0,0,1,1,0,0,1,0,0,0.0,M2018-05-09D,Race(3),,
1,2,5,9,16,17,2,6,25,9,3,4,16,28,10,19,57,0,0,2.0,M2018-05-09D,Race(4),,
2,6,10,7,23,5,5,11,21,5,4,8,17,16,19,26,61,0,0,3.0,M2018-05-09D,Race(4),,
3,3,6,2,11,1,14,2,17,2,7,3,12,6,27,7,40,0,0,1.0,M2018-05-09D,Race(4),,
4,9,3,6,18,2,5,1,8,5,6,3,14,16,14,10,40,0,0,0.0,M2018-05-09D,Race(4),,
5,0,0,0,0,0,1,1,2,0,0,0,0,0,1,1,2,0,0,0.0,M2018-05-09D,Race(4),,
6,0,0,2,2,2,1,2,5,3,1,2,6,5,2,6,13,0,0,0.0,M2018-05-09D,Race(4),,
7,0,0,0,0,0,0,1,1,0,0,0,0,0,0,1,1,0,0,0.0,M2018-05-09D,Race(4),,
8,0,0,0,0,0,0,3,3,1,1,3,5,1,1,6,8,0,0,0.0,M2018-05-09D,Race(4),,
9,2,0,0,2,1,0,1,2,0,0,1,1,3,0,2,5,0,0,0.0,M2018-05-09D,Race(4),,
10,3,4,2,9,0,1,1,2,0,1,1,2,3,6,4,13,0,0,0.0,M2018-05-09D,Race(4),,
11,0,0,0,0,0,0,0,0,0,0,0,0,0,0,0,0,0,0,0.0,M2018-05-09D,Race(4),,
12,5,2,2,9,2,1,1,4,1,3,1,5,8,6,4,18,0,0,0.0,M2018-05-09D,Race(4),,
1,9,5,8,22,5,14,6,25,3,6,3,12,17,25,17,59,0,0,0.0,M2018-05-09D,Race(5),,
2,2,0,3,5,1,3,2,6,1,3,4,8,4,6,9,19,0,0,1.0,M2018-05-09D,Race(5),,
3,0,3,0,3,0,0,0,0,0,0,2,2,0,3,2,5,0,0,0.0,M2018-05-09D,Race(5),,
4,17,4,6,27,20,4,3,27,14,1,5,20,51,9,14,74,0,0,3.0,M2018-05-09D,Race(5),,
5,2,16,3,21,1,4,5,10,1,7,1,9,4,27,9,40,0,0,2.0,M2018-05-09D,Race(5),,
6,0,2,2,4,0,0,3,3,1,0,3,4,1,2,8,11,0,0,0.0,M2018-05-09D,Race(5),,
7,0,0,0,0,0,0,0,0,0,0,2,2,0,0,2,2,0,0,0.0,M2018-05-09D,Race(5),,
8,0,0,0,0,2,0,0,2,1,1,1,3,3,1,1,5,0,0,0.0,M2018-05-09D,Race(5),,
9,0,0,0,0,0,1,0,1,0,2,1,3,0,3,1,4,0,0,0.0,M2018-05-09D,Race(5),,
10,0,0,3,3,0,0,0,0,1,0,0,1,1,0,3,4,0,0,0.0,M2018-05-09D,Race(5),,
11,0,0,0,0,0,0,0,0,0,0,0,0,0,0,0,0,0,0,0.0,M2018-05-09D,Race(5),,
12,0,0,5,5,0,0,0,0,0,0,1,1,0,0,6,6,0,0,0.0,M2018-05-09D,Race(5),,
1,3,0,0,3,0,0,0,0,1,1,2,4,4,1,2,7,0,0,0.0,M2018-05-09D,Race(6),,
2,14,5,6,25,7,17,4,28,5,9,7,21,26,31,17,74,0,0,3.0,M2018-05-09D,Race(6),,
3,0,9,9,18,1,5,21,27,1,5,9,15,2,19,39,60,0,0,0.0,M2018-05-09D,Race(6),,
4,0,0,0,0,0,2,0,2,0,2,1,3,0,4,1,5,0,0,0.0,M2018-05-09D,Race(6),,
5,0,0,0,0,0,0,0,0,1,0,0,1,1,0,0,1,0,0,0.0,M2018-05-09D,Race(6),,
6,6,13,6,25,22,5,3,30,15,6,3,24,43,24,12,79,0,0,2.0,M2018-05-09D,Race(6),,
7,0,0,0,0,0,0,0,0,0,0,1,1,0,0,1,1,0,0,0.0,M2018-05-09D,Race(6),,
8,2,0,2,4,0,0,1,1,0,0,1,1,2,0,4,6,0,0,0.0,M2018-05-09D,Race(6),,
9,0,3,0,3,0,0,0,0,0,1,0,1,0,4,0,4,0,0,0.0,M2018-05-09D,Race(6),,
10,5,0,7,12,0,1,1,2,1,0,1,2,6,1,9,16,0,0,0.0,M2018-05-09D,Race(6),,
11,0,0,0,0,0,0,0,0,2,1,0,3,2,1,0,3,0,0,0.0,M2018-05-09D,Race(6),,
12,0,0,0,0,0,0,0,0,0,1,1,2,0,1,1,2,0,0,1.0,M2018-05-09D,Race(6),,
1,7,0,0,7,0,2,1,3,1,2,2,5,8,4,3,15,0,0,0.0,M2018-05-09D,Race(7),,
2,0,0,0,0,0,0,0,0,1,1,0,2,1,1,0,2,0,0,0.0,M2018-05-09D,Race(7),,
3,0,5,0,5,0,0,1,1,0,0,1,1,0,5,2,7,0,0,0.0,M2018-05-09D,Race(7),,
4,0,2,0,2,0,2,5,7,0,2,4,6,0,6,9,15,0,0,0.0,M2018-05-09D,Race(7),,
5,0,0,3,3,1,2,2,5,1,1,1,3,2,3,6,11,0,0,0.0,M2018-05-09D,Race(7),,
6,0,0,3,3,0,0,1,1,0,0,2,2,0,0,6,6,0,0,0.0,M2018-05-09D,Race(7),,
7,0,0,0,0,0,0,0,0,0,0,0,0,0,0,0,0,0,0,0.0,M2018-05-09D,Race(7),,
8,6,9,10,25,21,4,3,28,14,6,3,23,41,19,16,76,0,0,3.0,M2018-05-09D,Race(7),,
9,15,8,0,23,6,17,3,26,8,9,3,20,29,34,6,69,0,0,2.0,M2018-05-09D,Race(7),,
10,0,0,0,0,0,0,0,0,0,0,0,0,0,0,0,0,0,0,0.0,M2018-05-09D,Race(7),,
11,0,3,2,5,1,1,0,2,0,1,1,2,1,5,3,9,0,0,0.0,M2018-05-09D,Race(7),,
12,2,3,12,17,1,2,14,17,1,4,9,14,4,9,35,48,0,0,1.0,M2018-05-09D,Race(7),,
1,20,8,0,28,24,2,4,30,16,1,5,22,60,11,9,80,0,0,1.0,M2018-05-09D,Race(8),,
2,6,8,8,22,2,22,1,25,3,10,5,18,11,40,14,65,0,0,0.0,M2018-05-09D,Race(8),,
3,0,5,2,7,1,2,3,6,1,2,1,4,2,9,6,17,0,0,0.0,M2018-05-09D,Race(8),,
4,0,0,7,7,1,3,15,19,3,4,5,12,4,7,27,38,0,0,2.0,M2018-05-09D,Race(8),,
5,0,0,0,0,0,0,2,2,1,2,1,4,1,2,3,6,0,0,0.0,M2018-05-09D,Race(8),,
6,0,0,0,0,0,0,0,0,1,0,0,1,1,0,0,1,0,0,0.0,M2018-05-09D,Race(8),,
7,2,2,6,10,1,1,2,4,1,3,5,9,4,6,13,23,0,0,0.0,M2018-05-09D,Race(8),,
8,0,3,5,8,0,0,0,0,0,0,0,0,0,3,5,8,0,0,0.0,M2018-05-09D,Race(8),,
9,2,2,0,4,0,0,2,2,0,2,3,5,2,4,5,11,0,0,0.0,M2018-05-09D,Race(8),,
10,0,0,0,0,0,0,0,0,0,0,0,0,0,0,0,0,0,0,3.0,M2018-05-09D,Race(8),,
11,0,2,2,4,1,0,1,2,0,1,1,2,1,3,4,8,0,0,0.0,M2018-05-09D,Race(8),,
12,0,0,0,0,0,0,0,0,0,1,0,1,0,1,0,1,0,0,0.0,M2018-05-09D,Race(8),,
1,0,0,2,2,0,0,1,1,0,0,2,2,0,0,5,5,31,31,0.0,M2018-05-12D,Race(1),,
2,0,0,0,0,0,0,0,0,1,0,0,1,1,0,0,1,101,101,0.0,M2018-05-12D,Race(1),,
3,0,0,3,3,0,2,2,4,0,2,4,6,0,4,9,13,41,41,0.0,M2018-05-12D,Race(1),,
4,0,0,0,0,0,0,0,0,0,0,0,0,0,0,0,0,41,41,0.0,M2018-05-12D,Race(1),,
5,0,0,0,0,0,0,0,0,0,0,0,0,0,0,0,0,101,101,0.0,M2018-05-12D,Race(1),,
6,0,2,3,5,2,0,1,3,5,1,3,9,7,3,7,17,13,13,3.0,M2018-05-12D,Race(1),,
7,0,3,0,3,2,1,2,5,3,2,2,7,5,6,4,15,6.5,6.5,0.0,M2018-05-12D,Race(1),,
8,7,10,5,22,3,19,2,24,3,11,3,17,13,40,10,63,3,3,0.0,M2018-05-12D,Race(1),,
9,5,11,9,25,3,3,15,21,3,6,6,15,11,20,30,61,5,5,1.0,M2018-05-12D,Race(1),,
10,13,4,6,23,19,4,3,26,11,2,4,17,43,10,13,66,4.2,4.2,0.0,M2018-05-12D,Race(1),,
11,2,0,0,2,0,1,1,2,0,1,0,1,2,2,1,5,21,21,0.0,M2018-05-12D,Race(1),,
12,3,0,2,5,1,0,3,4,0,1,2,3,4,1,7,12,9,9,2.0,M2018-05-12D,Race(1),,
13,0,0,0,0,0,0,0,0,0,0,0,0,0,0,0,0,34,34,0.0,M2018-05-12D,Race(1),,
14,0,0,0,0,0,0,0,0,0,0,0,0,0,0,0,0,201,201,0.0,M2018-05-12D,Race(1),,
1,2,10,2,14,17,4,2,23,7,3,4,14,26,17,8,51,7,7,0.0,M2018-05-12D,Race(10),,
2,0,0,0,0,0,1,0,1,1,0,0,1,1,1,0,2,41,41,2.0,M2018-05-12D,Race(10),,
3,3,0,5,8,1,2,4,7,0,2,6,8,4,4,15,23,9,9,0.0,M2018-05-12D,Race(10),,
4,0,0,0,0,0,0,0,0,0,0,0,0,0,0,0,0,34,34,0.0,M2018-05-12D,Race(10),,
5,0,3,7,10,0,2,1,3,1,2,4,7,1,7,12,20,8,8,0.0,M2018-05-12D,Race(10),,
6,3,0,3,6,1,0,1,2,0,1,0,1,4,1,4,9,21,21,0.0,M2018-05-12D,Race(10),,
7,5,5,11,21,0,14,6,20,2,5,7,14,7,24,24,55,3.8,3.8,0.0,M2018-05-12D,Race(10),,
8,3,0,2,5,0,1,1,2,0,1,0,1,3,2,3,8,26,26,0.0,M2018-05-12D,Race(10),,
9,0,0,0,0,1,0,0,1,1,0,0,1,2,0,0,2,14,14,1.0,M2018-05-12D,Race(10),,
10,0,4,0,4,0,1,0,1,0,2,1,3,0,7,1,8,10,10,3.0,M2018-05-12D,Race(10),,
11,0,3,0,3,1,2,0,3,0,3,1,4,1,8,1,10,26,26,0.0,M2018-05-12D,Race(10),,
12,14,3,0,17,9,3,14,26,13,4,1,18,36,10,15,61,4.6,4.6,0.0,M2018-05-12D,Race(10),,
13,0,2,0,2,0,0,1,1,1,3,2,6,1,5,3,9,13,13,0.0,M2018-05-12D,Race(10),,
14,0,0,0,0,0,0,0,0,0,0,0,0,0,0,0,0,81,81,0.0,M2018-05-12D,Race(10),,
1,9,14,5,28,18,4,5,27,11,8,2,21,38,26,12,76,5.5,5.5,3.0,M2018-05-12D,Race(2),,
2,5,3,5,13,2,19,1,22,1,6,2,9,8,28,8,44,6,6,1.0,M2018-05-12D,Race(2),,
3,7,6,2,15,2,2,12,16,3,2,11,16,12,10,25,47,13,13,0.0,M2018-05-12D,Race(2),,
4,0,0,3,3,1,2,2,5,2,1,2,5,3,3,7,13,6.5,6.5,0.0,M2018-05-12D,Race(2),,
5,0,2,3,5,1,0,2,3,2,2,2,6,3,4,7,14,12,12,0.0,M2018-05-12D,Race(2),,
6,0,0,0,0,0,0,0,0,0,0,0,0,0,0,0,0,41,41,0.0,M2018-05-12D,Race(2),,
7,0,0,2,2,0,0,0,0,0,1,1,2,0,1,3,4,34,34,0.0,M2018-05-12D,Race(2),,
8,3,3,2,8,1,0,1,2,0,1,1,2,4,4,4,12,16,16,0.0,M2018-05-12D,Race(2),,
9,0,0,0,0,0,0,1,1,0,1,2,3,0,1,3,4,17,17,0.0,M2018-05-12D,Race(2),,
10,0,0,0,0,2,1,1,4,4,2,0,6,6,3,1,10,7.5,7.5,0.0,M2018-05-12D,Race(2),,
11,4,0,2,6,2,2,4,8,3,2,2,7,9,4,8,21,10,10,0.0,M2018-05-12D,Race(2),,
12,0,0,0,0,0,0,0,0,0,0,0,0,0,0,0,0,16,16,0.0,M2018-05-12D,Race(2),,
13,2,2,6,10,1,0,0,1,0,0,0,0,3,2,6,11,7.5,7.5,2.0,M2018-05-12D,Race(2),,
14,0,0,0,0,0,0,1,1,0,0,1,1,0,0,2,2,34,34,0.0,M2018-05-12D,Race(2),,
1,21,7,2,30,22,5,2,29,18,4,0,22,61,16,4,81,2.2,2.2,2.0,M2018-05-12D,Race(3),,
2,0,3,0,3,0,0,0,0,0,0,1,1,0,3,1,4,31,31,0.0,M2018-05-12D,Race(3),,
3,0,0,0,0,0,0,0,0,0,1,0,1,0,1,0,1,81,81,0.0,M2018-05-12D,Race(3),,
4,0,0,0,0,0,1,0,1,1,0,0,1,1,1,0,2,26,26,0.0,M2018-05-12D,Race(3),,
5,0,0,0,0,0,2,1,3,0,4,1,5,0,6,2,8,34,34,0.0,M2018-05-12D,Race(3),,
6,2,0,0,2,2,0,1,3,1,2,2,5,5,2,3,10,11,11,0.0,M2018-05-12D,Race(3),,
7,2,9,5,16,1,3,19,23,2,2,11,15,5,14,35,54,8,8,0.0,M2018-05-12D,Race(3),,
8,0,0,0,0,0,0,0,0,0,0,0,0,0,0,0,0,101,101,0.0,M2018-05-12D,Race(3),,
9,0,0,2,2,0,0,1,1,1,0,2,3,1,0,5,6,26,26,0.0,M2018-05-12D,Race(3),,
10,5,6,12,23,5,16,5,26,3,9,4,16,13,31,21,65,3.7,3.7,3.0,M2018-05-12D,Race(3),,
11,0,2,6,8,0,1,1,2,0,2,4,6,0,5,11,16,14,14,0.0,M2018-05-12D,Race(3),,
12,0,3,3,6,0,2,0,2,0,2,1,3,0,7,4,11,8,8,1.0,M2018-05-12D,Race(3),,
1,0,3,0,3,0,0,0,0,0,0,0,0,0,3,0,3,10,10,0.0,M2018-05-12D,Race(4),,
2,13,7,5,25,8,17,4,29,11,8,6,25,32,32,15,79,3.3,3.3,0.0,M2018-05-12D,Race(4),,
3,4,4,6,14,5,4,16,25,7,8,7,22,16,16,29,61,12,12,2.0,M2018-05-12D,Race(4),,
4,5,5,4,14,0,1,2,3,0,0,1,1,5,6,7,18,6,6,1.0,M2018-05-12D,Race(4),,
5,0,0,0,0,0,0,0,0,0,0,0,0,0,0,0,0,126,126,0.0,M2018-05-12D,Race(4),,
6,0,0,5,5,1,1,1,3,1,1,1,3,2,2,7,11,19,19,0.0,M2018-05-12D,Race(4),,
7,8,6,10,24,16,6,5,27,7,8,6,21,31,20,21,72,3.4,3.4,0.0,M2018-05-12D,Race(4),,
8,0,0,0,0,0,0,0,0,0,1,0,1,0,1,0,1,17,17,0.0,M2018-05-12D,Race(4),,
9,0,0,0,0,0,1,2,3,0,0,2,2,0,1,4,5,13,13,0.0,M2018-05-12D,Race(4),,
10,0,0,0,0,0,0,0,0,0,0,0,0,0,0,0,0,51,51,0.0,M2018-05-12D,Race(4),,
11,0,0,0,0,0,0,0,0,0,0,2,2,0,0,2,2,151,151,0.0,M2018-05-12D,Race(4),,
12,0,3,0,3,0,0,0,0,0,0,0,0,0,3,0,3,21,21,0.0,M2018-05-12D,Race(4),,
13,0,2,0,2,0,0,0,0,0,0,1,1,0,2,1,3,15,15,3.0,M2018-05-12D,Race(4),,
14,0,0,0,0,0,0,0,0,0,0,0,0,0,0,0,0,81,81,0.0,M2018-05-12D,Race(4),,
1,2,3,2,7,3,2,12,17,2,1,3,6,7,6,17,30,9,9,0.0,M2018-05-12D,Race(5),,
2,2,0,0,2,1,5,2,8,1,5,4,10,4,10,6,20,16,16,0.0,M2018-05-12D,Race(5),,
3,0,4,0,4,0,1,1,2,0,2,2,4,0,7,3,10,15,15,0.0,M2018-05-12D,Race(5),,
4,0,0,0,0,0,0,0,0,0,1,0,1,0,1,0,1,41,41,0.0,M2018-05-12D,Race(5),,
5,5,9,9,23,1,2,5,8,4,1,3,8,10,12,17,39,8,8,1.0,M2018-05-12D,Race(5),,
6,0,0,0,0,0,0,0,0,0,0,0,0,0,0,0,0,31,31,0.0,M2018-05-12D,Race(5),,
7,15,5,3,23,23,4,2,29,16,5,2,23,54,14,7,75,2.7,2.7,0.0,M2018-05-12D,Race(5),,
8,6,4,10,20,2,14,5,21,3,6,6,15,11,24,21,56,4.4,4.4,0.0,M2018-05-12D,Race(5),,
9,0,0,0,0,0,0,1,1,0,0,2,2,0,0,3,3,61,61,0.0,M2018-05-12D,Race(5),,
10,0,0,0,0,0,0,0,0,0,0,0,0,0,0,0,0,81,81,0.0,M2018-05-12D,Race(5),,
11,0,0,6,6,0,0,1,1,0,2,1,3,0,2,8,10,13,13,0.0,M2018-05-12D,Race(5),,
12,0,5,0,5,0,2,1,3,0,3,3,6,0,10,4,14,17,17,0.0,M2018-05-12D,Race(5),,
13,0,0,0,0,0,0,0,0,0,0,0,0,0,0,0,0,41,41,3.0,M2018-05-12D,Race(5),,
14,0,0,0,0,0,0,0,0,0,0,0,0,0,0,0,0,11,11,2.0,M2018-05-12D,Race(5),,
1,3,6,2,11,1,2,4,7,1,2,0,3,5,10,6,21,8.5,8.5,0.0,M2018-05-12D,Race(6),,
2,0,2,3,5,1,0,1,2,2,0,1,3,3,2,5,10,15,15,3.0,M2018-05-12D,Race(6),,
3,5,5,10,20,4,15,5,24,2,4,5,11,11,24,20,55,4.2,4.2,1.0,M2018-05-12D,Race(6),,
4,7,3,5,15,1,6,11,18,0,10,6,16,8,19,22,49,6,6,0.0,M2018-05-12D,Race(6),,
5,0,6,0,6,0,0,2,2,1,0,5,6,1,6,7,14,11,11,0.0,M2018-05-12D,Race(6),,
6,3,0,0,3,1,2,3,6,2,2,5,9,6,4,8,18,14,14,0.0,M2018-05-12D,Race(6),,
7,0,0,3,3,0,0,0,0,0,0,0,0,0,0,3,3,26,26,0.0,M2018-05-12D,Race(6),,
8,0,0,2,2,0,0,0,0,0,0,0,0,0,0,2,2,101,101,0.0,M2018-05-12D,Race(6),,
9,10,8,3,21,22,2,4,28,16,3,4,23,48,13,11,72,2.9,2.9,0.0,M2018-05-12D,Race(6),,
10,0,0,0,0,0,1,0,1,2,1,0,3,2,2,0,4,21,21,2.0,M2018-05-12D,Race(6),,
11,2,0,2,4,0,1,0,1,0,3,0,3,2,4,2,8,34,34,0.0,M2018-05-12D,Race(6),,
12,0,0,0,0,0,1,0,1,0,1,0,1,0,2,0,2,13,13,0.0,M2018-05-12D,Race(6),,
1,0,2,0,2,0,0,0,0,0,0,0,0,0,2,0,2,81,81,0.0,M2018-05-12D,Race(7),,
2,2,0,2,4,0,0,2,2,0,0,1,1,2,0,5,7,9,9,0.0,M2018-05-12D,Race(7),,
3,0,2,8,10,0,5,4,9,1,3,9,13,1,10,21,32,12,12,0.0,M2018-05-12D,Race(7),,
4,17,3,5,25,22,5,2,29,19,6,1,26,58,14,8,80,1.95,1.95,3.0,M2018-05-12D,Race(7),,
5,3,9,6,18,4,17,4,25,3,10,6,19,10,36,16,62,4.6,4.6,1.0,M2018-05-12D,Race(7),,
6,5,0,3,8,1,0,0,1,1,0,0,1,7,0,3,10,26,26,0.0,M2018-05-12D,Race(7),,
7,0,0,0,0,0,0,0,0,0,0,0,0,0,0,0,0,101,101,0.0,M2018-05-12D,Race(7),,
8,3,2,0,5,0,0,0,0,0,1,0,1,3,3,0,6,12,12,2.0,M2018-05-12D,Race(7),,
9,0,12,6,18,3,3,15,21,2,6,8,16,5,21,29,55,5.5,5.5,0.0,M2018-05-12D,Race(7),,
10,0,0,0,0,0,0,0,0,0,0,0,0,0,0,0,0,71,71,0.0,M2018-05-12D,Race(7),,
11,0,0,0,0,0,0,0,0,0,0,1,1,0,0,1,1,31,31,0.0,M2018-05-12D,Race(7),,
1,5,2,11,18,0,11,2,13,1,5,3,9,6,18,16,40,5,5,0.0,M2018-05-12D,Race(8),,
2,5,7,0,12,0,6,16,22,3,6,9,18,8,19,25,52,7,7,0.0,M2018-05-12D,Race(8),,
3,8,6,2,16,14,7,5,26,2,6,6,14,24,19,13,56,6,6,3.0,M2018-05-12D,Race(8),,
4,0,0,0,0,2,2,1,5,0,0,0,0,2,2,1,5,0,0,0.0,M2018-05-12D,Race(8),,
5,0,0,2,2,0,1,1,2,0,0,1,1,0,1,4,5,7.5,7.5,2.0,M2018-05-12D,Race(8),,
6,0,0,3,3,1,0,4,5,0,0,2,2,1,0,9,10,6.5,6.5,0.0,M2018-05-12D,Race(8),,
7,0,4,0,4,0,0,0,0,1,0,0,1,1,4,0,5,17,17,1.0,M2018-05-12D,Race(8),,
8,0,2,4,6,0,0,0,0,0,0,1,1,0,2,5,7,7.5,7.5,0.0,M2018-05-12D,Race(8),,
9,0,3,3,6,0,0,0,0,0,1,0,1,0,4,3,7,15,15,0.0,M2018-05-12D,Race(8),,
10,0,0,0,0,0,0,0,0,0,0,0,0,0,0,0,0,51,51,0.0,M2018-05-12D,Race(8),,
11,2,0,0,2,0,0,0,0,0,0,0,0,2,0,0,2,26,26,0.0,M2018-05-12D,Race(8),,
12,10,6,5,21,0,3,1,4,2,2,1,5,12,11,7,30,6,6,0.0,M2018-05-12D,Race(8),,
13,0,0,0,0,0,0,0,0,0,0,0,0,0,0,0,0,51,51,0.0,M2018-05-12D,Race(8),,
1,0,0,5,5,1,1,0,2,0,0,0,0,1,1,5,7,10,10,2.0,M2018-05-12D,Race(9),,
2,7,3,3,13,16,7,5,28,7,7,8,22,30,17,16,63,4.8,4.8,0.0,M2018-05-12D,Race(9),,
3,0,0,0,0,0,0,0,0,1,1,0,2,1,1,0,2,34,34,0.0,M2018-05-12D,Race(9),,
4,0,0,0,0,0,0,1,1,0,0,1,1,0,0,2,2,41,41,0.0,M2018-05-12D,Race(9),,
5,0,0,0,0,0,0,0,0,0,0,0,0,0,0,0,0,61,61,0.0,M2018-05-12D,Race(9),,
6,10,7,8,25,8,16,5,29,11,12,2,25,29,35,15,79,3.2,3.2,3.0,M2018-05-12D,Race(9),,
7,11,10,2,23,4,5,13,22,7,5,5,17,22,20,20,62,4,4,0.0,M2018-05-12D,Race(9),,
8,0,0,0,0,0,0,0,0,0,0,0,0,0,0,0,0,26,26,0.0,M2018-05-12D,Race(9),,
9,0,3,2,5,1,0,0,1,0,1,0,1,1,4,2,7,26,26,0.0,M2018-05-12D,Race(9),,
10,0,0,5,5,0,0,3,3,0,0,7,7,0,0,15,15,10,10,0.0,M2018-05-12D,Race(9),,
11,2,7,5,14,0,0,3,3,0,0,3,3,2,7,11,20,9,9,0.0,M2018-05-12D,Race(9),,
12,0,0,0,0,0,0,0,0,0,0,0,0,0,0,0,0,81,81,0.0,M2018-05-12D,Race(9),,
13,0,0,0,0,0,0,0,0,0,0,0,0,0,0,0,0,101,101,0.0,M2018-05-12D,Race(9),,
14,0,0,0,0,0,1,0,1,0,0,0,0,0,1,0,1,21,21,1.0,M2018-05-12D,Race(9),,
1,8,9,6,23,13,5,0,18,11,3,2,16,32,17,8,57,2.9,2.9,0.0,M2018-05-16D,Race(1),,
2,5,0,3,8,1,1,2,4,0,2,2,4,6,3,7,16,13,13,0.0,M2018-05-16D,Race(1),,
3,3,0,0,3,1,8,0,9,1,0,1,2,5,8,1,14,15,15,0.0,M2018-05-16D,Race(1),,
4,2,3,0,5,0,1,8,9,0,1,0,1,2,5,8,15,26,26,3.0,M2018-05-16D,Race(1),,
5,0,4,5,9,1,2,2,5,3,4,2,9,4,10,9,23,11,11,1.0,M2018-05-16D,Race(1),,
6,0,7,2,9,0,0,3,3,0,1,2,3,0,8,7,15,8.5,8.5,0.0,M2018-05-16D,Race(1),,
7,0,0,0,0,0,0,0,0,2,1,0,3,2,1,0,3,41,41,0.0,M2018-05-16D,Race(1),,
8,0,4,3,7,0,3,1,4,0,3,2,5,0,10,6,16,17,17,0.0,M2018-05-16D,Race(1),,
9,0,0,0,0,8,2,1,11,3,3,2,8,11,5,3,19,21,21,0.0,M2018-05-16D,Race(1),,
10,5,0,3,8,3,8,4,15,3,6,3,12,11,14,10,35,4.2,4.2,0.0,M2018-05-16D,Race(1),,
11,5,3,3,11,0,0,3,3,0,0,6,6,5,3,12,20,9,9,2.0,M2018-05-16D,Race(1),,
12,2,0,5,7,3,0,6,9,3,2,4,9,8,2,15,25,13,13,0.0,M2018-05-16D,Race(1),,
1,9,6,10,25,8,6,8,22,5,4,5,14,22,16,23,61,4.4,4.4,0.0,M2018-05-16D,Race(2),,
2,0,3,7,10,6,5,2,13,7,4,2,13,13,12,11,36,15,15,2.0,M2018-05-16D,Race(2),,
3,3,3,2,8,0,2,2,4,3,1,6,10,6,6,10,22,10,10,1.0,M2018-05-16D,Race(2),,
4,0,3,0,3,0,0,8,8,0,0,2,2,0,3,10,13,41,41,0.0,M2018-05-16D,Race(2),,
5,11,6,5,22,9,4,0,13,7,9,1,17,27,19,6,52,2.8,2.8,0.0,M2018-05-16D,Race(2),,
6,0,0,0,0,0,0,0,0,0,0,0,0,0,0,0,0,101,101,0.0,M2018-05-16D,Race(2),,
7,3,2,3,8,7,2,6,15,4,6,4,14,14,10,13,37,8,8,0.0,M2018-05-16D,Race(2),,
8,0,0,0,0,0,0,2,2,0,2,1,3,0,2,3,5,21,21,0.0,M2018-05-16D,Race(2),,
9,4,5,3,12,0,3,2,5,0,0,5,5,4,8,10,22,5,5,0.0,M2018-05-16D,Race(2),,
10,0,0,0,0,0,0,0,0,0,0,0,0,0,0,0,0,34,34,3.0,M2018-05-16D,Race(2),,
11,0,0,0,0,0,0,0,0,0,0,0,0,0,0,0,0,21,21,0.0,M2018-05-16D,Race(2),,
12,0,2,0,2,0,8,0,8,0,0,0,0,0,10,0,10,16,16,0.0,M2018-05-16D,Race(2),,
1,8,10,0,18,2,9,6,17,3,7,6,16,13,26,12,51,3.3,3.3,0.0,M2018-05-16D,Race(3),,
2,0,2,11,13,5,5,9,19,3,3,2,8,8,10,22,40,9,9,0.0,M2018-05-16D,Race(3),,
3,0,0,0,0,0,0,0,0,0,0,0,0,0,0,0,0,41,41,0.0,M2018-05-16D,Race(3),,
4,2,0,0,2,0,0,0,0,0,0,1,1,2,0,1,3,26,26,0.0,M2018-05-16D,Race(3),,
5,0,0,0,0,8,1,3,12,2,3,2,7,10,4,5,19,18,18,3.0,M2018-05-16D,Race(3),,
6,0,0,2,2,0,0,0,0,1,1,0,2,1,1,2,4,34,34,0.0,M2018-05-16D,Race(3),,
7,0,2,3,5,0,8,2,10,1,1,3,5,1,11,8,20,10,10,2.0,M2018-05-16D,Race(3),,
8,8,13,0,21,12,4,2,18,13,7,2,22,33,24,4,61,3.3,3.3,0.0,M2018-05-16D,Race(3),,
9,8,3,4,15,2,1,5,8,3,3,6,12,13,7,15,35,4.4,4.4,1.0,M2018-05-16D,Race(3),,
10,4,0,10,14,1,2,3,6,0,1,4,5,5,3,17,25,11,11,0.0,M2018-05-16D,Race(3),,
11,0,0,0,0,0,0,0,0,0,0,0,0,0,0,0,0,81,81,0.0,M2018-05-16D,Race(3),,
12,0,0,0,0,0,0,0,0,0,0,0,0,0,0,0,0,0,0,0.0,M2018-05-16D,Race(3),,
1,0,6,0,6,4,5,4,13,5,2,4,11,9,13,8,30,10,10,0.0,M2018-05-16D,Race(4),,
2,8,2,5,15,1,6,10,17,3,5,4,12,12,13,19,44,7,7,0.0,M2018-05-16D,Race(4),,
3,7,5,3,15,10,4,7,21,12,5,2,19,29,14,12,55,4.6,4.6,0.0,M2018-05-16D,Race(4),,
4,5,6,3,14,2,1,5,8,2,6,5,13,9,13,13,35,16,16,3.0,M2018-05-16D,Race(4),,
5,0,0,3,3,8,0,0,8,1,0,1,2,9,0,4,13,15,15,1.0,M2018-05-16D,Race(4),,
6,0,0,4,4,1,0,0,1,0,0,0,0,1,0,4,5,10,10,0.0,M2018-05-16D,Race(4),,
7,0,3,0,3,0,8,0,8,0,0,1,1,0,11,1,12,15,15,0.0,M2018-05-16D,Race(4),,
8,0,0,0,0,0,0,0,0,0,0,0,0,0,0,0,0,9,9,0.0,M2018-05-16D,Race(4),,
9,0,0,0,0,0,0,0,0,0,0,1,1,0,0,1,1,18,18,0.0,M2018-05-16D,Race(4),,
10,5,8,10,23,4,6,4,14,3,7,8,18,12,21,22,55,4.2,4.2,0.0,M2018-05-16D,Race(4),,
11,0,0,0,0,0,0,0,0,0,1,0,1,0,1,0,1,41,41,2.0,M2018-05-16D,Race(4),,
12,5,0,2,7,0,0,0,0,0,0,0,0,5,0,2,7,9,9,0.0,M2018-05-16D,Race(4),,
1,10,8,0,18,6,10,5,21,10,9,3,22,26,27,8,61,4,4,0.0,M2018-05-16D,Race(5),,
2,8,7,2,17,9,7,1,17,4,6,3,13,21,20,6,47,6,6,1.0,M2018-05-16D,Race(5),,
3,0,0,0,0,0,0,2,2,1,2,3,6,1,2,5,8,13,13,2.0,M2018-05-16D,Race(5),,
4,0,0,0,0,0,0,4,4,0,0,4,4,0,0,8,8,51,51,0.0,M2018-05-16D,Race(5),,
5,7,10,3,20,5,1,4,10,6,3,3,12,18,14,10,42,4.4,4.5,0.0,M2018-05-16D,Race(5),,
6,0,3,7,10,8,0,0,8,2,1,0,3,10,4,7,21,17,17,0.0,M2018-05-16D,Race(5),,
7,0,0,0,0,0,0,0,0,0,0,0,0,0,0,0,0,101,101,0.0,M2018-05-16D,Race(5),,
8,0,2,8,10,0,1,8,9,1,1,1,3,1,4,17,22,19,19,0.0,M2018-05-16D,Race(5),,
9,0,0,0,0,0,0,0,0,0,0,1,1,0,0,1,1,101,101,0.0,M2018-05-16D,Race(5),,
10,0,0,6,6,1,8,2,11,1,2,4,7,2,10,12,24,4,4,0.0,M2018-05-16D,Race(5),,
11,3,0,4,7,1,3,4,8,1,2,3,6,5,5,11,21,12,12,0.0,M2018-05-16D,Race(5),,
12,2,0,0,2,0,0,0,0,0,0,1,1,2,0,1,3,10,10,3.0,M2018-05-16D,Race(5),,
1,2,0,3,5,1,2,6,9,3,4,3,10,6,6,12,24,12,12,0.0,M2018-05-16D,Race(6),,
2,0,0,0,0,1,2,5,8,2,2,4,8,3,4,9,16,13,13,2.0,M2018-05-16D,Race(6),,
3,3,3,0,6,0,0,0,0,0,0,0,0,3,3,0,6,26,26,0.0,M2018-05-16D,Race(6),,
4,8,2,8,18,8,3,3,14,7,4,3,14,23,9,14,46,11,11,0.0,M2018-05-16D,Race(6),,
5,0,2,8,10,8,2,0,10,1,0,2,3,9,4,10,23,12,12,3.0,M2018-05-16D,Race(6),,
6,14,2,3,19,8,8,4,20,5,7,4,16,27,17,11,55,2.4,2.4,1.0,M2018-05-16D,Race(6),,
7,0,11,0,11,2,1,0,3,2,4,3,9,4,16,3,23,7,7,0.0,M2018-05-16D,Race(6),,
8,0,0,6,6,1,2,10,13,1,4,4,9,2,6,20,28,34,34,0.0,M2018-05-16D,Race(6),,
9,0,0,0,0,0,0,0,0,0,0,0,0,0,0,0,0,26,26,0.0,M2018-05-16D,Race(6),,
10,0,5,0,5,0,2,0,2,1,0,2,3,1,7,2,10,8.5,8.5,0.0,M2018-05-16D,Race(6),,
11,3,5,2,10,1,8,2,11,4,1,1,6,8,14,5,27,6.5,6.5,0.0,M2018-05-16D,Race(6),,
12,0,0,0,0,0,0,0,0,0,0,0,0,0,0,0,0,51,51,0.0,M2018-05-16D,Race(6),,
1,4,16,8,28,16,5,1,22,17,3,4,24,37,24,13,74,3.2,3.2,1.0,M2018-05-16D,Race(7),,
2,20,4,0,24,3,14,3,20,6,9,3,18,29,27,6,62,3.7,3.7,0.0,M2018-05-16D,Race(7),,
3,0,0,2,2,0,0,0,0,0,1,0,1,0,1,2,3,21,21,0.0,M2018-05-16D,Race(7),,
4,0,2,5,7,1,2,8,11,1,4,7,12,2,8,20,30,11,11,0.0,M2018-05-16D,Race(7),,
5,0,0,0,0,0,0,0,0,0,0,0,0,0,0,0,0,61,61,0.0,M2018-05-16D,Race(7),,
6,0,0,5,5,8,0,1,9,0,0,2,2,8,0,8,16,11,11,3.0,M2018-05-16D,Race(7),,
7,3,0,0,3,2,1,1,4,1,1,1,3,6,2,2,10,21,21,0.0,M2018-05-16D,Race(7),,
8,0,3,8,11,0,8,6,14,1,5,4,10,1,16,18,35,5,5,2.0,M2018-05-16D,Race(7),,
9,0,0,2,2,0,0,8,8,0,0,1,1,0,0,11,11,16,16,0.0,M2018-05-16D,Race(7),,
10,3,0,0,3,0,0,2,2,0,2,4,6,3,2,6,11,19,19,0.0,M2018-05-16D,Race(7),,
11,0,5,0,5,0,0,0,0,0,1,0,1,0,6,0,6,13,13,0.0,M2018-05-16D,Race(7),,
12,0,0,0,0,0,0,0,0,0,0,0,0,0,0,0,0,34,34,0.0,M2018-05-16D,Race(7),,
1,7,5,4,16,3,3,12,18,1,4,7,12,11,12,23,46,7,7,0.0,M2018-05-16D,Race(8),,
2,2,0,0,2,3,1,0,4,2,0,0,2,7,1,0,8,10,10,0.0,M2018-05-16D,Race(8),,
3,0,2,2,4,1,3,0,4,0,2,2,4,1,7,4,12,12,12,0.0,M2018-05-16D,Race(8),,
4,0,0,0,0,0,0,0,0,0,0,0,0,0,0,0,0,26,26,0.0,M2018-05-16D,Race(8),,
5,0,3,10,13,3,3,4,10,2,5,1,8,5,11,15,31,5,5,0.0,M2018-05-16D,Race(8),,
6,15,11,2,28,19,5,4,28,17,4,2,23,51,20,8,79,2.6,2.6,0.0,M2018-05-16D,Race(8),,
7,0,0,0,0,0,0,0,0,0,0,0,0,0,0,0,0,61,61,0.0,M2018-05-16D,Race(8),,
8,3,0,6,9,1,13,7,21,3,9,8,20,7,22,21,50,13,13,0.0,M2018-05-16D,Race(8),,
9,0,4,0,4,0,0,0,0,0,0,0,0,0,4,0,4,21,21,3.0,M2018-05-16D,Race(8),,
10,0,3,3,6,0,2,2,4,0,2,5,7,0,7,10,17,9,9,1.0,M2018-05-16D,Race(8),,
11,3,2,3,8,0,0,1,1,1,0,1,2,4,2,5,11,15,15,2.0,M2018-05-16D,Race(8),,
12,0,0,0,0,0,0,0,0,0,0,0,0,0,0,0,0,34,34,0.0,M2018-05-16D,Race(8),,
1,14,12,2,28,11,5,4,20,10,3,8,21,35,20,14,69,2.75,2.8,2.0,M2018-05-20D,Race(1),,
2,8,5,8,21,8,1,2,11,2,4,4,10,18,10,14,42,6,6,0.0,M2018-05-20D,Race(1),,
3,0,3,0,3,0,0,0,0,0,0,0,0,0,3,0,3,26,31,0.0,M2018-05-20D,Race(1),,
4,0,0,0,0,0,0,0,0,0,0,0,0,0,0,0,0,17,17,0.0,M2018-05-20D,Race(1),,
5,0,2,0,2,0,0,8,8,2,0,4,6,2,2,12,16,13,12,0.0,M2018-05-20D,Race(1),,
6,2,0,6,8,2,4,5,11,2,4,3,9,6,8,14,28,6.5,6.5,3.0,M2018-05-20D,Race(1),,
7,6,6,5,17,5,9,3,17,8,3,2,13,19,18,10,47,5,5,1.0,M2018-05-20D,Race(1),,
8,0,0,6,6,4,6,5,15,2,7,5,14,6,13,16,35,8,8,0.0,M2018-05-20D,Race(1),,
9,0,2,3,5,0,5,3,8,0,5,0,5,0,12,6,18,9,9,0.0,M2018-05-20D,Race(1),,
1,0,6,4,10,0,8,0,8,1,2,0,3,1,16,4,21,15,0,3.0,M2018-05-20D,Race(10),,
2,0,0,10,10,0,4,3,7,2,2,3,7,2,6,16,24,9,0,0.0,M2018-05-20D,Race(10),,
3,4,9,5,18,13,3,2,18,9,6,3,18,26,18,10,54,5,0,0.0,M2018-05-20D,Race(10),,
4,21,6,0,27,9,8,6,23,13,5,7,25,43,19,13,75,2.65,0,1.0,M2018-05-20D,Race(10),,
5,0,0,0,0,0,0,0,0,0,0,0,0,0,0,0,0,26,0,0.0,M2018-05-20D,Race(10),,
6,0,0,0,0,0,0,0,0,0,0,0,0,0,0,0,0,0,0,0.0,M2018-05-20D,Race(10),,
7,0,0,0,0,0,0,0,0,0,0,0,0,0,0,0,0,31,0,0.0,M2018-05-20D,Race(10),,
8,0,4,9,13,0,4,7,11,0,6,7,13,0,14,23,37,6,0,2.0,M2018-05-20D,Race(10),,
9,5,5,0,10,8,2,3,13,1,5,4,10,14,12,7,33,6,0,0.0,M2018-05-20D,Race(10),,
10,0,0,0,0,0,0,0,0,0,0,0,0,0,0,0,0,61,0,0.0,M2018-05-20D,Race(10),,
11,0,0,2,2,0,1,9,10,0,0,2,2,0,1,13,14,11,0,0.0,M2018-05-20D,Race(10),,
12,0,0,0,0,0,0,0,0,0,0,0,0,0,0,0,0,41,0,0.0,M2018-05-20D,Race(10),,
1,5,2,5,12,3,6,4,13,4,4,5,13,12,12,14,38,8.5,8.5,0.0,M2018-05-20D,Race(2),,
2,0,0,0,0,1,8,1,10,3,0,2,5,4,8,3,15,21,21,0.0,M2018-05-20D,Race(2),,
3,0,0,2,2,8,0,0,8,2,2,0,4,10,2,2,14,26,26,0.0,M2018-05-20D,Race(2),,
4,3,2,6,11,2,3,3,8,4,4,4,12,9,9,13,31,8,8,0.0,M2018-05-20D,Race(2),,
5,2,11,2,15,1,7,4,12,1,4,1,6,4,22,7,33,7,7,1.0,M2018-05-20D,Race(2),,
6,11,5,8,24,12,4,3,19,8,7,2,17,31,16,13,60,7,7,0.0,M2018-05-20D,Race(2),,
7,0,0,0,0,0,0,8,8,0,0,0,0,0,0,8,8,18,18,0.0,M2018-05-20D,Race(2),,
8,0,3,0,3,0,0,0,0,0,1,0,1,0,4,0,4,26,26,2.0,M2018-05-20D,Race(2),,
9,0,0,0,0,0,0,2,2,0,0,3,3,0,0,5,5,7.5,7,3.0,M2018-05-20D,Race(2),,
10,2,0,0,2,3,0,2,5,2,1,2,5,7,1,4,12,8.5,8.5,0.0,M2018-05-20D,Race(2),,
11,0,0,0,0,0,0,0,0,0,0,0,0,0,0,0,0,12,12,0.0,M2018-05-20D,Race(2),,
12,0,0,2,2,0,1,1,2,0,1,3,4,0,2,6,8,13,13,0.0,M2018-05-20D,Race(2),,
13,7,4,2,13,0,0,2,2,2,1,4,7,9,5,8,22,7,7,0.0,M2018-05-20D,Race(2),,
14,0,3,3,6,0,1,0,1,0,1,0,1,0,5,3,8,31,31,0.0,M2018-05-20D,Race(2),,
1,0,0,3,3,0,0,1,1,0,0,1,1,0,0,5,5,31,31,0.0,M2018-05-20D,Race(3),,
2,20,8,2,30,17,3,2,22,18,5,2,25,55,16,6,77,1.6,1.6,1.0,M2018-05-20D,Race(3),,
3,0,10,12,22,8,10,6,24,3,11,6,20,11,31,24,66,6,6,0.0,M2018-05-20D,Race(3),,
4,5,10,7,22,3,6,3,12,3,6,2,11,11,22,12,45,7,7,3.0,M2018-05-20D,Race(3),,
5,0,0,0,0,0,0,0,0,0,0,0,0,0,0,0,0,151,151,0.0,M2018-05-20D,Race(3),,
6,2,0,4,6,0,8,3,11,1,2,3,6,3,10,10,23,8,8,0.0,M2018-05-20D,Race(3),,
7,3,0,0,3,0,0,8,8,0,0,1,1,3,0,9,12,31,34,2.0,M2018-05-20D,Race(3),,
8,0,2,2,4,2,3,7,12,1,2,11,14,3,7,20,30,8,7.5,0.0,M2018-05-20D,Race(3),,
9,0,0,0,0,0,0,0,0,0,0,0,0,0,0,0,0,71,71,0.0,M2018-05-20D,Race(3),,
10,0,0,0,0,0,0,0,0,0,0,0,0,0,0,0,0,61,61,0.0,M2018-05-20D,Race(3),,
1,9,10,5,24,12,4,5,21,13,6,3,22,34,20,13,67,3.9,4,0.0,M2018-05-20D,Race(4),,
2,0,0,3,3,0,0,8,8,0,1,0,1,0,1,11,12,12,10,0.0,M2018-05-20D,Race(4),,
3,6,4,3,13,3,5,4,12,1,9,4,14,10,18,11,39,5,5.6,0.0,M2018-05-20D,Race(4),,
4,0,2,0,2,0,8,2,10,0,0,4,4,0,10,6,16,10,10,1.0,M2018-05-20D,Race(4),,
5,0,0,0,0,0,0,0,0,0,0,0,0,0,0,0,0,71,71,3.0,M2018-05-20D,Race(4),,
6,0,0,0,0,1,3,4,8,1,2,4,7,2,5,8,15,12,10,0.0,M2018-05-20D,Race(4),,
7,0,0,0,0,0,0,0,0,0,0,0,0,0,0,0,0,31,38,0.0,M2018-05-20D,Race(4),,
8,12,6,7,25,6,7,2,15,10,7,2,19,28,20,11,59,7.5,7.2,2.0,M2018-05-20D,Race(4),,
9,0,0,0,0,0,0,3,3,0,0,3,3,0,0,6,6,16,18,0.0,M2018-05-20D,Race(4),,
10,0,0,0,0,0,0,0,0,0,0,1,1,0,0,1,1,61,61,0.0,M2018-05-20D,Race(4),,
11,0,0,2,2,0,2,0,2,0,1,0,1,0,3,2,5,31,32,0.0,M2018-05-20D,Race(4),,
12,0,0,0,0,0,0,0,0,0,0,0,0,0,0,0,0,34,40,0.0,M2018-05-20D,Race(4),,
13,3,8,10,21,8,1,2,11,0,0,5,5,11,9,17,37,7.5,9,0.0,M2018-05-20D,Race(4),,
14,0,0,0,0,0,0,0,0,1,0,0,1,1,0,0,1,10,9,0.0,M2018-05-20D,Race(4),,
1,6,8,13,27,0,10,4,14,0,2,3,5,6,20,20,46,6.5,6.5,3.0,M2018-05-20D,Race(5),,
2,0,0,0,0,5,7,5,17,0,0,0,0,5,7,5,17,0,0,0.0,M2018-05-20D,Race(5),,
3,24,4,0,28,13,3,5,21,12,7,5,24,49,14,10,73,1.9,2.8,1.0,M2018-05-20D,Race(5),,
4,0,0,0,0,0,0,0,0,0,0,0,0,0,0,0,0,71,62,0.0,M2018-05-20D,Race(5),,
5,0,0,0,0,0,0,0,0,0,0,0,0,0,0,0,0,34,33,0.0,M2018-05-20D,Race(5),,
6,0,0,0,0,0,0,0,0,0,0,0,0,0,0,0,0,18,23,0.0,M2018-05-20D,Race(5),,
7,0,0,0,0,0,0,0,0,0,0,1,1,0,0,1,1,31,35,0.0,M2018-05-20D,Race(5),,
8,0,18,2,20,12,10,5,27,5,8,7,20,17,36,14,67,4.4,5,2.0,M2018-05-20D,Race(5),,
9,0,0,0,0,0,0,0,0,0,0,0,0,0,0,0,0,41,34,0.0,M2018-05-20D,Race(5),,
10,0,0,2,2,0,0,0,0,0,0,0,0,0,0,2,2,15,34,0.0,M2018-05-20D,Race(5),,
11,0,0,13,13,0,0,11,11,0,1,5,6,0,1,29,30,10,8,0.0,M2018-05-20D,Race(5),,
1,0,0,0,0,0,0,8,8,0,0,0,0,0,0,8,8,16,17,0.0,M2018-05-20D,Race(6),,
2,3,3,5,11,3,1,4,8,3,1,4,8,9,5,13,27,10,10,3.0,M2018-05-20D,Race(6),,
3,2,13,3,18,8,15,3,26,3,12,5,20,13,40,11,64,11,11,1.0,M2018-05-20D,Race(6),,
4,16,3,8,27,15,3,4,22,18,5,2,25,49,11,14,74,4.4,4.6,0.0,M2018-05-20D,Race(6),,
5,5,7,6,18,0,0,1,1,0,0,1,1,5,7,8,20,4.6,4.6,0.0,M2018-05-20D,Race(6),,
6,0,0,3,3,0,8,1,9,0,0,2,2,0,8,6,14,10,9,0.0,M2018-05-20D,Race(6),,
7,0,2,3,5,0,0,0,0,0,1,0,1,0,3,3,6,17,15,0.0,M2018-05-20D,Race(6),,
8,0,0,2,2,0,1,5,6,1,2,8,11,1,3,15,19,9.5,9,2.0,M2018-05-20D,Race(6),,
9,0,0,0,0,0,0,0,0,0,0,0,0,0,0,0,0,41,34,0.0,M2018-05-20D,Race(6),,
10,0,0,0,0,0,0,0,0,0,0,0,0,0,0,0,0,101,101,0.0,M2018-05-20D,Race(6),,
11,0,0,0,0,0,0,0,0,0,0,0,0,0,0,0,0,81,101,0.0,M2018-05-20D,Race(6),,
12,2,0,0,2,0,0,0,0,0,0,0,0,2,0,0,2,21,21,0.0,M2018-05-20D,Race(6),,
13,0,0,0,0,0,0,0,0,0,0,0,0,0,0,0,0,26,26,0.0,M2018-05-20D,Race(6),,
14,2,2,0,4,4,2,4,10,1,5,4,10,7,9,8,24,5.5,6,0.0,M2018-05-20D,Race(6),,
1,0,0,14,14,8,2,0,10,3,3,1,7,11,5,15,31,12,12,0.0,M2018-05-20D,Race(7),,
2,13,15,2,30,12,7,4,23,19,4,2,25,44,26,8,78,3.2,3.2,3.0,M2018-05-20D,Race(7),,
3,0,0,0,0,0,2,11,13,0,1,2,3,0,3,13,16,10,10,0.0,M2018-05-20D,Race(7),,
4,9,8,0,17,6,9,4,19,2,15,4,21,17,32,8,57,4,4,2.0,M2018-05-20D,Race(7),,
5,0,0,0,0,0,0,0,0,0,0,0,0,0,0,0,0,126,126,0.0,M2018-05-20D,Race(7),,
6,0,0,2,2,0,0,0,0,0,0,0,0,0,0,2,2,26,26,1.0,M2018-05-20D,Race(7),,
7,3,2,5,10,2,1,7,10,2,3,10,15,7,6,22,35,9,9,0.0,M2018-05-20D,Race(7),,
8,0,0,0,0,0,0,0,0,0,0,0,0,0,0,0,0,31,31,0.0,M2018-05-20D,Race(7),,
9,0,0,0,0,0,0,0,0,0,0,0,0,0,0,0,0,26,26,0.0,M2018-05-20D,Race(7),,
10,5,0,5,10,2,1,4,7,0,0,3,3,7,1,12,20,13,13,0.0,M2018-05-20D,Race(7),,
11,0,5,0,5,0,0,0,0,0,0,2,2,0,5,2,7,16,16,0.0,M2018-05-20D,Race(7),,
12,0,0,2,2,0,8,0,8,0,0,2,2,0,8,4,12,5.5,5.5,0.0,M2018-05-20D,Race(7),,
1,3,2,3,8,2,3,5,10,1,1,7,9,6,6,15,27,12,12,0.0,M2018-05-20D,Race(8),,
2,4,9,3,16,3,2,9,14,5,2,4,11,12,13,16,41,5,5,3.0,M2018-05-20D,Race(8),,
3,8,2,2,12,4,4,3,11,5,3,2,10,17,9,7,33,4.2,4.2,0.0,M2018-05-20D,Race(8),,
4,0,0,0,0,0,0,0,0,0,0,0,0,0,0,0,0,51,51,0.0,M2018-05-20D,Race(8),,
5,8,0,12,20,8,4,4,16,3,5,3,11,19,9,19,47,8.5,8.5,1.0,M2018-05-20D,Race(8),,
6,0,0,0,0,0,0,0,0,1,1,0,2,1,1,0,2,20,19,0.0,M2018-05-20D,Race(8),,
7,3,6,2,11,4,4,3,11,4,4,2,10,11,14,7,32,7,7,0.0,M2018-05-20D,Race(8),,
8,4,0,0,4,0,0,0,0,0,0,0,0,4,0,0,4,26,26,0.0,M2018-05-20D,Race(8),,
9,0,6,6,12,4,8,1,13,1,2,2,5,5,16,9,30,6.5,6.5,0.0,M2018-05-20D,Race(8),,
10,0,5,2,7,5,3,5,13,6,5,4,15,11,13,11,35,6,6,2.0,M2018-05-20D,Race(8),,
11,0,0,0,0,0,2,0,2,0,3,2,5,0,5,2,7,11,11,0.0,M2018-05-20D,Race(8),,
1,0,0,2,2,0,0,0,0,0,0,1,1,0,0,3,3,31,0,3.0,M2018-05-20D,Race(9),,
2,21,5,4,30,17,3,1,21,24,2,0,26,62,10,5,77,1.8,0,0.0,M2018-05-20D,Race(9),,
3,3,0,0,3,8,0,2,10,0,0,2,2,11,0,4,15,20,0,0.0,M2018-05-20D,Race(9),,
4,4,15,5,24,3,16,4,23,1,21,3,25,8,52,12,72,3.9,0,1.0,M2018-05-20D,Race(9),,
5,2,8,11,21,2,2,11,15,1,3,13,17,5,13,35,53,6,0,0.0,M2018-05-20D,Race(9),,
6,0,2,0,2,0,0,1,1,0,0,1,1,0,2,2,4,41,0,2.0,M2018-05-20D,Race(9),,
7,0,0,0,0,0,0,0,0,0,0,1,1,0,0,1,1,81,0,0.0,M2018-05-20D,Race(9),,
8,0,0,3,3,0,9,0,9,0,0,1,1,0,9,4,13,10,0,0.0,M2018-05-20D,Race(9),,
9,0,0,0,0,0,0,8,8,0,0,0,0,0,0,8,8,26,0,0.0,M2018-05-20D,Race(9),,
10,0,0,0,0,0,0,0,0,0,0,0,0,0,0,0,0,61,0,0.0,M2018-05-20D,Race(9),,
11,0,0,5,5,0,0,3,3,0,0,4,4,0,0,12,12,26,0,0.0,M2018-05-20D,Race(9),,
1,14,8,4,26,10,11,4,25,15,5,3,23,39,24,11,74,3,3,2.0,M2018-05-23D,Race(1),,
2,0,0,2,2,0,0,1,1,0,0,1,1,0,0,4,4,41,41,0.0,M2018-05-23D,Race(1),,
3,0,0,0,0,1,0,0,1,1,1,0,2,2,1,0,3,12,12,0.0,M2018-05-23D,Race(1),,
4,2,2,2,6,0,4,3,7,0,5,5,10,2,11,10,23,14,14,0.0,M2018-05-23D,Race(1),,
5,0,0,0,0,0,0,1,1,0,0,1,1,0,0,2,2,10,10,3.0,M2018-05-23D,Race(1),,
6,2,0,10,12,0,8,10,18,1,7,2,10,3,15,22,40,9,9,0.0,M2018-05-23D,Race(1),,
7,0,2,3,5,1,0,2,3,1,0,4,5,2,2,9,13,13,13,0.0,M2018-05-23D,Race(1),,
8,0,3,3,6,1,1,6,8,2,5,4,11,3,9,13,25,21,21,0.0,M2018-05-23D,Race(1),,
9,0,0,3,3,0,0,0,0,0,1,0,1,0,1,3,4,31,31,0.0,M2018-05-23D,Race(1),,
10,12,12,0,24,17,4,3,24,6,1,6,13,35,17,9,61,4,4,1.0,M2018-05-23D,Race(1),,
11,0,0,0,0,0,0,0,0,0,0,0,0,0,0,0,0,31,31,0.0,M2018-05-23D,Race(1),,
12,0,3,3,6,0,2,0,2,0,1,0,1,0,6,3,9,7.5,7.5,0.0,M2018-05-23D,Race(1),,
1,0,2,8,10,1,1,3,5,1,0,4,5,2,3,15,20,10,10,0.0,M2018-05-23D,Race(2),,
2,8,10,7,25,2,4,2,8,5,6,2,13,15,20,11,46,4.6,4.6,3.0,M2018-05-23D,Race(2),,
3,8,3,4,15,2,4,12,18,1,4,2,7,11,11,18,40,4,4,0.0,M2018-05-23D,Race(2),,
4,0,3,0,3,0,0,0,0,0,2,0,2,0,5,0,5,16,16,0.0,M2018-05-23D,Race(2),,
5,8,2,3,13,20,2,4,26,16,3,4,23,44,7,11,62,4.6,4.6,0.0,M2018-05-23D,Race(2),,
6,0,0,0,0,3,1,2,6,1,1,3,5,4,2,5,11,19,19,0.0,M2018-05-23D,Race(2),,
7,0,0,0,0,0,0,0,0,0,0,0,0,0,0,0,0,21,21,0.0,M2018-05-23D,Race(2),,
8,0,2,3,5,1,17,1,19,1,7,2,10,2,26,6,34,17,17,1.0,M2018-05-23D,Race(2),,
9,4,8,5,17,1,1,5,7,1,2,8,11,6,11,18,35,9,9,0.0,M2018-05-23D,Race(2),,
10,0,0,0,0,0,0,0,0,0,0,0,0,0,0,0,0,12,12,2.0,M2018-05-23D,Race(2),,
11,2,0,0,2,0,0,1,1,0,1,1,2,2,1,2,5,15,15,0.0,M2018-05-23D,Race(2),,
12,0,0,0,0,0,0,0,0,0,0,0,0,0,0,0,0,31,31,0.0,M2018-05-23D,Race(2),,
1,2,10,6,18,8,11,5,24,9,4,2,15,19,25,13,57,7,7,0.0,M2018-05-23D,Race(3),,
2,0,0,0,0,0,0,1,1,0,0,0,0,0,0,1,1,13,13,2.0,M2018-05-23D,Race(3),,
3,6,9,8,23,16,8,5,29,8,7,6,21,30,24,19,73,5,5,0.0,M2018-05-23D,Race(3),,
4,5,5,5,15,0,4,11,15,1,5,3,9,6,14,19,39,15,15,0.0,M2018-05-23D,Race(3),,
5,2,0,0,2,2,2,2,6,2,2,2,6,6,4,4,14,9,9,1.0,M2018-05-23D,Race(3),,
6,4,3,0,7,1,2,2,5,1,5,5,11,6,10,7,23,9,9,0.0,M2018-05-23D,Race(3),,
7,0,0,2,2,0,0,0,0,0,0,2,2,0,0,4,4,26,26,0.0,M2018-05-23D,Race(3),,
8,0,0,0,0,0,0,0,0,0,0,0,0,0,0,0,0,15,15,0.0,M2018-05-23D,Race(3),,
9,0,0,0,0,0,0,0,0,0,0,0,0,0,0,0,0,101,101,0.0,M2018-05-23D,Race(3),,
10,8,0,5,13,1,2,2,5,3,2,6,11,12,4,13,29,4.8,4.8,3.0,M2018-05-23D,Race(3),,
11,3,0,2,5,0,1,2,3,0,0,0,0,3,1,4,8,9,9,0.0,M2018-05-23D,Race(3),,
12,0,3,2,5,2,0,0,2,2,1,0,3,4,4,2,10,6.5,6.5,0.0,M2018-05-23D,Race(3),,
1,0,0,0,0,0,0,0,0,0,0,0,0,0,0,0,0,26,26,2.0,M2018-05-23D,Race(4),,
2,3,7,8,18,5,5,2,12,5,5,5,15,13,17,15,45,4.6,4.6,0.0,M2018-05-23D,Race(4),,
3,0,0,0,0,0,0,2,2,0,0,2,2,0,0,4,4,34,35,3.0,M2018-05-23D,Race(4),,
4,0,3,4,7,1,14,4,19,2,9,3,14,3,26,11,40,9,9,0.0,M2018-05-23D,Race(4),,
5,0,2,0,2,2,0,0,2,2,0,0,2,4,2,0,6,17,17,0.0,M2018-05-23D,Race(4),,
6,3,5,8,16,1,3,13,17,1,4,8,13,5,12,29,46,4.6,4.6,0.0,M2018-05-23D,Race(4),,
7,3,8,0,11,1,2,2,5,1,2,2,5,5,12,4,21,15,15,0.0,M2018-05-23D,Race(4),,
8,15,3,4,22,18,2,4,24,10,1,1,12,43,6,9,58,3.3,3.3,0.0,M2018-05-23D,Race(4),,
9,0,0,0,0,0,0,1,1,1,0,0,1,1,0,1,2,41,41,0.0,M2018-05-23D,Race(4),,
10,0,0,0,0,0,0,0,0,0,0,0,0,0,0,0,0,41,41,0.0,M2018-05-23D,Race(4),,
11,4,2,6,12,1,2,1,4,2,4,4,10,7,8,11,26,6.5,6.5,1.0,M2018-05-23D,Race(4),,
12,2,0,0,2,0,0,0,0,0,0,0,0,2,0,0,2,21,21,0.0,M2018-05-23D,Race(4),,
1,5,5,2,12,21,3,1,25,12,4,2,18,38,12,5,55,4.6,4.6,1.0,M2018-05-23D,Race(5),,
2,0,5,0,5,0,3,2,5,0,5,2,7,0,13,4,17,8.5,8.5,0.0,M2018-05-23D,Race(5),,
3,2,7,2,11,0,13,4,17,0,5,3,8,2,25,9,36,9,9,0.0,M2018-05-23D,Race(5),,
4,3,2,0,5,0,0,3,3,1,0,3,4,4,2,6,12,9,9,3.0,M2018-05-23D,Race(5),,
5,0,2,0,2,0,0,1,1,0,0,1,1,0,2,2,4,13,13,0.0,M2018-05-23D,Race(5),,
6,0,3,12,15,0,6,3,9,1,5,7,13,1,14,22,37,12,12,0.0,M2018-05-23D,Race(5),,
7,12,6,3,21,5,0,8,13,6,4,1,11,23,10,12,45,5.5,5.5,0.0,M2018-05-23D,Race(5),,
8,8,0,7,15,2,3,5,10,4,2,3,9,14,5,15,34,4.4,4.4,0.0,M2018-05-23D,Race(5),,
9,0,0,4,4,2,2,3,7,2,1,4,7,4,3,11,18,6,6,2.0,M2018-05-23D,Race(5),,
1,2,7,13,22,6,14,6,26,7,6,5,18,15,27,24,66,7.5,7.5,0.0,M2018-05-23D,Race(6),,
2,0,0,3,3,0,1,0,1,0,1,0,1,0,2,3,5,41,41,0.0,M2018-05-23D,Race(6),,
3,2,6,0,8,1,1,3,5,6,3,4,13,9,10,7,26,4.6,4.6,2.0,M2018-05-23D,Race(6),,
4,0,0,0,0,0,0,0,0,0,0,0,0,0,0,0,0,51,51,0.0,M2018-05-23D,Race(6),,
5,2,5,4,11,0,2,2,4,1,0,3,4,3,7,9,19,10,10,1.0,M2018-05-23D,Race(6),,
6,17,4,2,23,18,6,2,26,10,11,3,24,45,21,7,73,3.2,3.2,0.0,M2018-05-23D,Race(6),,
7,0,0,0,0,1,0,1,2,1,0,1,2,2,0,2,4,17,17,0.0,M2018-05-23D,Race(6),,
8,5,5,6,16,4,6,15,25,1,4,10,15,10,15,31,56,4.2,4.2,3.0,M2018-05-23D,Race(6),,
9,2,3,2,7,0,0,1,1,0,0,0,0,2,3,3,8,12,12,0.0,M2018-05-23D,Race(6),,
10,0,0,0,0,0,0,0,0,0,0,0,0,0,0,0,0,31,31,0.0,M2018-05-23D,Race(6),,
11,0,0,0,0,0,0,0,0,0,0,0,0,0,0,0,0,41,41,0.0,M2018-05-23D,Race(6),,
12,0,0,0,0,0,0,0,0,0,1,0,1,0,1,0,1,19,19,0.0,M2018-05-23D,Race(6),,
1,2,0,2,4,2,5,13,20,3,6,5,14,7,11,20,38,13,13,0.0,M2018-05-23D,Race(7),,
2,0,2,3,5,1,0,0,1,1,0,0,1,2,2,3,7,10,10,0.0,M2018-05-23D,Race(7),,
3,0,0,2,2,0,2,2,4,4,1,4,9,4,3,8,15,15,15,3.0,M2018-05-23D,Race(7),,
4,10,11,3,24,18,9,2,29,10,8,4,22,38,28,9,75,2.6,2.6,2.0,M2018-05-23D,Race(7),,
5,6,7,8,21,2,0,2,4,3,1,3,7,11,8,13,32,12,12,0.0,M2018-05-23D,Race(7),,
6,0,2,0,2,0,0,0,0,0,0,0,0,0,2,0,2,34,34,0.0,M2018-05-23D,Race(7),,
7,0,0,0,0,0,2,1,3,0,0,3,3,0,2,4,6,10,10,0.0,M2018-05-23D,Race(7),,
8,2,0,0,2,3,1,1,5,1,2,1,4,6,3,2,11,31,31,0.0,M2018-05-23D,Race(7),,
9,0,0,0,0,0,0,0,0,0,0,0,0,0,0,0,0,71,67,0.0,M2018-05-23D,Race(7),,
10,0,3,2,5,0,1,1,2,0,0,3,3,0,4,6,10,26,26,0.0,M2018-05-23D,Race(7),,
11,0,0,5,5,1,0,1,2,0,0,0,0,1,0,6,7,13,13,0.0,M2018-05-23D,Race(7),,
12,10,5,5,20,3,10,7,20,4,8,3,15,17,23,15,55,3.4,3.4,1.0,M2018-05-23D,Race(7),,
1,9,9,7,25,17,6,2,25,7,6,1,14,33,21,10,64,3.3,3.3,3.0,M2018-05-23D,Race(8),,
2,0,0,2,2,1,2,7,10,3,3,7,13,4,5,16,25,15,15,0.0,M2018-05-23D,Race(8),,
3,13,8,9,30,4,3,14,21,6,5,8,19,23,16,31,70,4.8,4.8,1.0,M2018-05-23D,Race(8),,
4,0,0,0,0,0,0,0,0,0,0,0,0,0,0,0,0,21,21,0.0,M2018-05-23D,Race(8),,
5,0,0,0,0,0,0,2,2,1,0,2,3,1,0,4,5,17,17,0.0,M2018-05-23D,Race(8),,
6,8,8,12,28,8,12,3,23,9,5,1,15,25,25,16,66,4.2,4.2,0.0,M2018-05-23D,Race(8),,
7,0,3,0,3,0,5,1,6,0,5,2,7,0,13,3,16,18,21,0.0,M2018-05-23D,Race(8),,
8,0,0,0,0,0,0,0,0,0,0,0,0,0,0,0,0,12,12,0.0,M2018-05-23D,Race(8),,
9,0,0,0,0,0,0,0,0,0,0,0,0,0,0,0,0,21,21,0.0,M2018-05-23D,Race(8),,
10,0,2,0,2,0,0,0,0,0,0,2,2,0,2,2,4,17,17,2.0,M2018-05-23D,Race(8),,
11,0,0,0,0,0,2,0,2,0,2,2,4,0,4,2,6,9,9,0.0,M2018-05-23D,Race(8),,
12,0,0,0,0,0,0,1,1,0,0,1,1,0,0,2,2,34,34,0.0,M2018-05-23D,Race(8),,
1,0,0,3,3,0,0,0,0,0,1,0,1,0,1,3,4,14,14,0.0,M2018-05-27D,Race(1),,
2,0,0,0,0,0,0,0,0,0,0,0,0,0,0,0,0,26,26,0.0,M2018-05-27D,Race(1),,
3,0,2,0,2,0,0,9,9,0,0,5,5,0,2,14,16,18,17,0.0,M2018-05-27D,Race(1),,
4,8,10,3,21,4,9,6,19,5,8,3,16,17,27,12,56,8,8,3.0,M2018-05-27D,Race(1),,
5,4,0,7,11,10,4,7,21,4,4,6,14,18,8,20,46,3.5,3.4,0.0,M2018-05-27D,Race(1),,
6,13,4,8,25,7,12,4,23,9,10,4,23,29,26,16,71,2.45,2.6,2.0,M2018-05-27D,Race(1),,
7,5,14,9,28,9,5,4,18,8,3,8,19,22,22,21,65,4,4,1.0,M2018-05-27D,Race(1),,
1,0,0,2,2,1,8,1,10,1,1,2,4,2,9,5,16,13,12,0.0,M2018-05-27D,Race(10),,
2,3,5,7,15,5,6,5,16,4,11,1,16,12,22,13,47,7.5,8,2.0,M2018-05-27D,Race(10),,
3,3,10,10,23,5,6,4,15,6,4,4,14,14,20,18,52,5,5,0.0,M2018-05-27D,Race(10),,
4,0,3,2,5,0,0,8,8,0,1,3,4,0,4,13,17,9,10,0.0,M2018-05-27D,Race(10),,
5,0,0,0,0,0,0,0,0,0,0,0,0,0,0,0,0,91,81,0.0,M2018-05-27D,Race(10),,
6,0,0,0,0,0,0,0,0,1,0,1,2,1,0,1,2,31,31,0.0,M2018-05-27D,Race(10),,
7,2,0,0,2,0,3,5,8,1,2,4,7,3,5,9,17,15,15,0.0,M2018-05-27D,Race(10),,
8,0,2,0,2,0,0,0,0,0,0,0,0,0,2,0,2,15,15,3.0,M2018-05-27D,Race(10),,
9,22,3,3,28,11,5,3,19,11,5,7,23,44,13,13,70,2.5,2.6,1.0,M2018-05-27D,Race(10),,
10,0,0,0,0,0,0,0,0,0,0,0,0,0,0,0,0,151,151,0.0,M2018-05-27D,Race(10),,
11,0,5,3,8,8,2,3,13,2,2,4,8,10,9,10,29,12,12,0.0,M2018-05-27D,Race(10),,
12,0,0,0,0,0,0,0,0,0,0,0,0,0,0,0,0,34,38,0.0,M2018-05-27D,Race(10),,
13,0,2,3,5,0,0,1,1,0,0,0,0,0,2,4,6,18,16,0.0,M2018-05-27D,Race(10),,
1,0,0,0,0,0,0,0,0,1,1,0,2,1,1,0,2,26,26,0.0,M2018-05-27D,Race(11),,
2,5,2,13,20,7,8,1,16,5,8,2,15,17,18,16,51,7.5,8.2,0.0,M2018-05-27D,Race(11),,
3,3,0,0,3,0,1,4,5,1,2,6,9,4,3,10,17,15,16,0.0,M2018-05-27D,Race(11),,
4,2,0,0,2,2,2,5,9,5,0,2,7,9,2,7,18,11,12,1.0,M2018-05-27D,Race(11),,
5,0,2,0,2,0,1,8,9,1,1,2,4,1,4,10,15,19,19,0.0,M2018-05-27D,Race(11),,
6,0,0,0,0,0,0,0,0,0,0,0,0,0,0,0,0,23,18,0.0,M2018-05-27D,Race(11),,
7,0,6,2,8,0,0,3,3,1,0,2,3,1,6,7,14,23,22,0.0,M2018-05-27D,Race(11),,
8,0,0,0,0,0,0,0,0,0,0,0,0,0,0,0,0,15,13,0.0,M2018-05-27D,Race(11),,
9,0,0,0,0,0,0,2,2,0,0,3,3,0,0,5,5,14,14,0.0,M2018-05-27D,Race(11),,
10,0,3,4,7,1,8,1,10,1,2,3,6,2,13,8,23,13,14,3.0,M2018-05-27D,Race(11),,
11,0,2,3,5,0,0,1,1,0,1,1,2,0,3,5,8,11,13,0.0,M2018-05-27D,Race(11),,
12,3,10,0,13,8,2,3,13,0,2,1,3,11,14,4,29,8.5,8.9,2.0,M2018-05-27D,Race(11),,
13,17,5,8,30,12,8,3,23,11,9,4,24,40,22,15,77,2.9,2.9,0.0,M2018-05-27D,Race(11),,
14,0,0,0,0,0,0,0,0,0,0,0,0,0,0,0,0,41,49,0.0,M2018-05-27D,Race(11),,
1,7,2,7,16,4,10,10,24,6,4,5,15,17,16,22,55,5,5,2.0,M2018-05-27D,Race(2),,
2,7,3,7,17,8,4,5,17,7,3,6,16,22,10,18,50,6,6,0.0,M2018-05-27D,Race(2),,
3,0,0,0,0,0,0,0,0,0,0,0,0,0,0,0,0,17,17,0.0,M2018-05-27D,Race(2),,
4,0,0,0,0,0,0,0,0,0,0,0,0,0,0,0,0,61,51,0.0,M2018-05-27D,Race(2),,
5,2,3,0,5,0,0,0,0,0,1,1,2,2,4,1,7,11,11,0.0,M2018-05-27D,Race(2),,
6,0,0,0,0,0,0,0,0,0,0,0,0,0,0,0,0,26,26,0.0,M2018-05-27D,Race(2),,
7,0,0,0,0,0,0,0,0,0,1,0,1,0,1,0,1,61,61,0.0,M2018-05-27D,Race(2),,
8,0,2,5,7,0,0,0,0,0,0,1,1,0,2,6,8,11,11,3.0,M2018-05-27D,Race(2),,
9,0,0,0,0,0,0,0,0,0,0,1,1,0,0,1,1,101,101,0.0,M2018-05-27D,Race(2),,
10,0,2,0,2,0,0,0,0,0,0,0,0,0,2,0,2,26,26,0.0,M2018-05-27D,Race(2),,
11,9,3,5,17,7,7,6,20,6,9,6,21,22,19,17,58,4.6,4.6,1.0,M2018-05-27D,Race(2),,
12,5,15,6,26,11,9,9,29,7,8,6,21,23,32,21,76,3.2,3.2,0.0,M2018-05-27D,Race(2),,
13,0,0,0,0,0,0,0,0,0,0,0,0,0,0,0,0,61,61,0.0,M2018-05-27D,Race(2),,
14,0,0,0,0,0,0,0,0,0,0,0,0,0,0,0,0,31,31,0.0,M2018-05-27D,Race(2),,
1,2,4,2,8,8,0,1,9,2,0,0,2,12,4,3,19,9,9,0.0,M2018-05-27D,Race(3),,
2,0,2,2,4,0,0,2,2,0,0,1,1,0,2,5,7,26,26,0.0,M2018-05-27D,Race(3),,
3,4,0,5,9,0,0,8,8,0,0,1,1,4,0,14,18,8,8,2.0,M2018-05-27D,Race(3),,
4,0,0,0,0,0,0,0,0,0,1,0,1,0,1,0,1,16,16,0.0,M2018-05-27D,Race(3),,
5,3,3,3,9,1,2,6,9,0,3,3,6,4,8,12,24,7.5,7.5,0.0,M2018-05-27D,Race(3),,
6,16,7,3,26,11,6,3,20,13,4,3,20,40,17,9,66,2.6,2.6,1.0,M2018-05-27D,Race(3),,
7,0,0,0,0,8,12,1,21,0,0,0,0,8,12,1,21,0,0,0.0,M2018-05-27D,Race(3),,
8,2,9,7,18,1,2,7,10,1,3,10,14,4,14,24,42,6.5,6.5,0.0,M2018-05-27D,Race(3),,
9,0,0,0,0,0,0,0,0,0,0,0,0,0,0,0,0,26,26,0.0,M2018-05-27D,Race(3),,
10,0,0,0,0,0,0,0,0,1,1,0,2,1,1,0,2,16,16,3.0,M2018-05-27D,Race(3),,
11,3,2,3,8,1,0,2,3,2,0,1,3,6,2,6,14,13,13,0.0,M2018-05-27D,Race(3),,
12,0,0,0,0,0,0,0,0,0,0,0,0,0,0,0,0,101,101,0.0,M2018-05-27D,Race(3),,
13,0,3,5,8,0,8,0,8,0,1,4,5,0,12,9,21,10,10,0.0,M2018-05-27D,Race(3),,
1,2,9,10,21,5,6,6,17,5,9,5,19,12,24,21,57,4.8,4.8,0.0,M2018-05-27D,Race(4),,
2,21,3,0,24,11,5,3,19,13,6,1,20,45,14,4,63,2.6,2.6,0.0,M2018-05-27D,Race(4),,
3,5,12,5,22,3,10,5,18,5,3,10,18,13,25,20,58,4.8,4.8,1.0,M2018-05-27D,Race(4),,
4,2,0,0,2,0,0,0,0,0,1,1,2,2,1,1,4,9,9,0.0,M2018-05-27D,Race(4),,
5,0,0,5,5,0,4,10,14,0,2,5,7,0,6,20,26,12,12,2.0,M2018-05-27D,Race(4),,
6,0,2,3,5,8,0,1,9,1,0,2,3,9,2,6,17,12,12,0.0,M2018-05-27D,Race(4),,
7,0,4,2,6,0,0,1,1,0,1,0,1,0,5,3,8,17,17,0.0,M2018-05-27D,Race(4),,
8,0,0,5,5,3,5,4,12,2,4,2,8,5,9,11,25,7,7,3.0,M2018-05-27D,Race(4),,
1,3,3,0,6,1,3,3,7,1,3,2,6,5,9,5,19,7,7,3.0,M2018-05-27D,Race(5),,
2,2,3,3,8,1,3,2,6,3,2,3,8,6,8,8,22,21,21,0.0,M2018-05-27D,Race(5),,
3,5,2,8,15,0,7,3,10,0,8,5,13,5,17,16,38,7,7,0.0,M2018-05-27D,Race(5),,
4,0,5,5,10,2,0,2,4,1,1,2,4,3,6,9,18,10,10,0.0,M2018-05-27D,Race(5),,
5,11,4,7,22,1,4,7,12,2,5,6,13,14,13,20,47,3.4,3.4,0.0,M2018-05-27D,Race(5),,
6,0,0,0,0,0,0,0,0,0,0,0,0,0,0,0,0,126,126,0.0,M2018-05-27D,Race(5),,
7,2,2,3,7,1,9,4,14,3,3,3,9,6,14,10,30,6.5,6.5,1.0,M2018-05-27D,Race(5),,
8,5,8,2,15,16,4,0,20,14,3,2,19,35,15,4,54,9,9,0.0,M2018-05-27D,Race(5),,
9,0,3,0,3,0,0,0,0,0,0,0,0,0,3,0,3,61,61,0.0,M2018-05-27D,Race(5),,
10,0,0,0,0,0,0,0,0,0,0,0,0,0,0,0,0,34,34,0.0,M2018-05-27D,Race(5),,
11,0,0,0,0,0,0,8,8,0,0,1,1,0,0,9,9,101,101,0.0,M2018-05-27D,Race(5),,
12,0,0,0,0,0,0,0,0,1,1,0,2,1,1,0,2,21,21,0.0,M2018-05-27D,Race(5),,
13,2,0,2,4,8,0,1,9,1,0,2,3,11,0,5,16,7,7,0.0,M2018-05-27D,Race(5),,
14,0,0,0,0,0,0,0,0,0,0,0,0,0,0,0,0,21,21,2.0,M2018-05-27D,Race(5),,
1,20,8,2,30,18,3,2,23,17,5,3,25,55,16,7,78,2.2,2.2,0.0,M2018-05-27D,Race(6),,
2,5,10,8,23,2,9,7,18,4,5,7,16,11,24,22,57,10,11,1.0,M2018-05-27D,Race(6),,
3,0,0,3,3,0,1,1,2,0,5,1,6,0,6,5,11,21,22,0.0,M2018-05-27D,Race(6),,
4,0,0,2,2,0,0,0,0,0,0,0,0,0,0,2,2,21,22,0.0,M2018-05-27D,Race(6),,
5,0,2,0,2,0,8,0,8,1,0,1,2,1,10,1,12,14,14,0.0,M2018-05-27D,Race(6),,
6,0,0,0,0,0,0,8,8,0,1,1,2,0,1,9,10,41,35,0.0,M2018-05-27D,Race(6),,
7,0,0,12,12,0,2,6,8,0,1,11,12,0,3,29,32,6,5.7,2.0,M2018-05-27D,Race(6),,
8,5,10,3,18,10,7,6,23,3,9,0,12,18,26,9,53,4.6,4.8,0.0,M2018-05-27D,Race(6),,
9,0,0,0,0,0,0,0,0,0,0,0,0,0,0,0,0,41,46,0.0,M2018-05-27D,Race(6),,
10,0,0,0,0,0,0,0,0,0,0,0,0,0,0,0,0,34,32,3.0,M2018-05-27D,Race(6),,
11,0,0,0,0,0,0,0,0,0,0,0,0,0,0,0,0,201,165,0.0,M2018-05-27D,Race(6),,
12,0,0,0,0,0,0,0,0,1,0,2,3,1,0,2,3,16,17,0.0,M2018-05-27D,Race(6),,
1,0,17,3,20,3,2,9,14,3,2,5,10,6,21,17,44,0,0,1.0,M2018-05-27D,Race(7),,
2,5,0,2,7,3,1,2,6,4,2,1,7,12,3,5,20,0,0,0.0,M2018-05-27D,Race(7),,
3,0,0,3,3,1,8,3,12,2,3,4,9,3,11,10,24,0,0,0.0,M2018-05-27D,Race(7),,
4,0,0,0,0,0,0,0,0,1,0,1,2,1,0,1,2,0,0,0.0,M2018-05-27D,Race(7),,
5,2,2,3,7,1,0,8,9,1,1,2,4,4,3,13,20,0,0,0.0,M2018-05-27D,Race(7),,
6,10,6,9,25,8,8,2,18,4,5,8,17,22,19,19,60,0,0,0.0,M2018-05-27D,Race(7),,
7,2,0,0,2,0,0,0,0,0,0,0,0,2,0,0,2,0,0,2.0,M2018-05-27D,Race(7),,
8,11,2,3,16,5,7,2,14,9,6,1,16,25,15,6,46,0,0,0.0,M2018-05-27D,Race(7),,
9,0,0,3,3,0,0,0,0,0,1,0,1,0,1,3,4,0,0,0.0,M2018-05-27D,Race(7),,
10,0,0,0,0,8,0,0,8,1,1,0,2,9,1,0,10,0,0,3.0,M2018-05-27D,Race(7),,
11,0,0,2,2,0,0,0,0,0,0,0,0,0,0,2,2,0,0,0.0,M2018-05-27D,Race(7),,
12,0,0,0,0,0,0,0,0,0,0,0,0,0,0,0,0,0,0,0.0,M2018-05-27D,Race(7),,
13,0,3,2,5,1,3,7,11,1,4,3,8,2,10,12,24,0,0,0.0,M2018-05-27D,Race(7),,
14,0,0,0,0,0,1,0,1,0,1,1,2,0,2,1,3,0,0,0.0,M2018-05-27D,Race(7),,
1,27,3,0,30,17,4,0,21,19,3,0,22,63,10,0,73,1.7,1.75,1.0,M2018-05-27D,Race(8),,
2,3,2,11,16,0,3,9,12,0,3,4,7,3,8,24,35,11,12,0.0,M2018-05-27D,Race(8),,
3,0,7,8,15,0,8,15,23,0,6,12,18,0,21,35,56,6.5,7,0.0,M2018-05-27D,Race(8),,
4,0,0,2,2,0,0,4,4,0,1,6,7,0,1,12,13,17,15,0.0,M2018-05-27D,Race(8),,
5,0,18,9,27,13,15,2,30,7,13,4,24,20,46,15,81,3,3,2.0,M2018-05-27D,Race(8),,
1,0,10,5,15,1,8,7,16,4,8,6,18,5,26,18,49,8.5,9.5,0.0,M2018-05-27D,Race(9),,
2,23,5,0,28,17,4,0,21,19,5,0,24,59,14,0,73,1.8,1.8,1.0,M2018-05-27D,Race(9),,
3,0,0,0,0,0,0,0,0,0,1,0,1,0,1,0,1,101,94,0.0,M2018-05-27D,Race(9),,
4,2,5,5,12,0,2,6,8,0,2,7,9,2,9,18,29,14,13,3.0,M2018-05-27D,Race(9),,
5,3,6,14,23,2,3,7,12,1,6,6,13,6,15,27,48,7.5,7.5,0.0,M2018-05-27D,Race(9),,
6,0,0,0,0,8,1,0,9,0,0,1,1,8,1,1,10,11,11,2.0,M2018-05-27D,Race(9),,
7,0,4,6,10,1,1,10,12,2,1,3,6,3,6,19,28,13,15,0.0,M2018-05-27D,Race(9),,
8,0,0,0,0,0,0,0,0,0,0,0,0,0,0,0,0,51,50,0.0,M2018-05-27D,Race(9),,
9,0,0,0,0,0,0,0,0,0,0,0,0,0,0,0,0,41,48,0.0,M2018-05-27D,Race(9),,
10,2,0,0,2,1,3,0,4,0,2,2,4,3,5,2,10,16,15,0.0,M2018-05-27D,Race(9),,
11,0,0,0,0,0,0,0,0,0,0,0,0,0,0,0,0,34,31,0.0,M2018-05-27D,Race(9),,
12,0,0,0,0,0,0,0,0,0,0,0,0,0,0,0,0,71,63,0.0,M2018-05-27D,Race(9),,
13,0,0,0,0,0,8,0,8,0,1,1,2,0,9,1,10,34,34,0.0,M2018-05-27D,Race(9),,
14,0,0,0,0,0,0,0,0,0,0,0,0,0,0,0,0,91,84,0.0,M2018-05-27D,Race(9),,
1,4,2,0,6,4,4,13,21,6,2,5,13,14,8,18,40,14,14,0.0,M2018-05-30D,Race(1),,
2,3,8,6,17,4,2,2,8,3,4,0,7,10,14,8,32,5.5,5.5,2.0,M2018-05-30D,Race(1),,
3,0,2,5,7,0,1,5,6,0,4,5,9,0,7,15,22,10,10,0.0,M2018-05-30D,Race(1),,
4,0,2,3,5,1,1,1,3,0,0,1,1,1,3,5,9,19,19,0.0,M2018-05-30D,Race(1),,
5,0,0,2,2,1,1,2,4,3,2,4,9,4,3,8,15,16,16,0.0,M2018-05-30D,Race(1),,
6,0,0,3,3,0,0,1,1,1,0,3,4,1,0,7,8,26,26,1.0,M2018-05-30D,Race(1),,
7,6,13,9,28,2,18,2,22,4,6,4,14,12,37,15,64,4.6,4.5,3.0,M2018-05-30D,Race(1),,
8,17,3,0,20,18,3,4,25,8,7,3,18,43,13,7,63,4,4,0.0,M2018-05-30D,Race(1),,
9,0,0,0,0,0,0,0,0,0,0,1,1,0,0,1,1,11,11,0.0,M2018-05-30D,Race(1),,
10,0,0,2,2,0,0,0,0,0,0,0,0,0,0,2,2,11,11,0.0,M2018-05-30D,Race(1),,
11,0,0,0,0,0,0,0,0,1,0,0,1,1,0,0,1,14,14,0.0,M2018-05-30D,Race(1),,
12,0,0,0,0,0,0,0,0,0,1,0,1,0,1,0,1,15,15,0.0,M2018-05-30D,Race(1),,
1,11,2,15,28,6,2,15,23,4,5,6,15,21,9,36,66,4,4,0.0,M2018-05-30D,Race(2),,
2,11,9,7,27,15,7,4,26,7,3,6,16,33,19,17,69,4.6,4.6,2.0,M2018-05-30D,Race(2),,
3,0,2,5,7,2,1,5,8,5,2,2,9,7,5,12,24,19,19,0.0,M2018-05-30D,Race(2),,
4,2,0,0,2,0,1,0,1,0,2,3,5,2,3,3,8,10,10,1.0,M2018-05-30D,Race(2),,
5,0,0,0,0,0,0,0,0,0,1,0,1,0,1,0,1,51,51,0.0,M2018-05-30D,Race(2),,
6,0,4,0,4,0,0,0,0,2,0,0,2,2,4,0,6,17,17,0.0,M2018-05-30D,Race(2),,
7,0,0,0,0,0,0,0,0,0,0,0,0,0,0,0,0,51,51,0.0,M2018-05-30D,Race(2),,
8,0,0,0,0,0,3,0,3,0,2,0,2,0,5,0,5,14,14,0.0,M2018-05-30D,Race(2),,
9,0,0,0,0,0,0,0,0,0,0,0,0,0,0,0,0,15,15,0.0,M2018-05-30D,Race(2),,
10,0,0,0,0,0,0,1,1,0,1,2,3,0,1,3,4,14,14,3.0,M2018-05-30D,Race(2),,
11,6,13,0,19,7,16,4,27,8,9,6,23,21,38,10,69,3.9,4,0.0,M2018-05-30D,Race(2),,
12,0,0,3,3,0,0,1,1,0,1,1,2,0,1,5,6,9.5,9.5,0.0,M2018-05-30D,Race(2),,
1,3,2,0,5,2,1,1,4,2,1,1,4,7,4,2,13,18,18,0.0,M2018-05-30D,Race(3),,
2,8,7,9,24,4,18,0,22,7,10,0,17,19,35,9,63,3.5,3.5,2.0,M2018-05-30D,Race(3),,
3,2,3,3,8,2,1,1,4,1,1,1,3,5,5,5,15,7,7,0.0,M2018-05-30D,Race(3),,
4,3,11,5,19,14,6,5,25,7,5,4,16,24,22,14,60,4.6,4.6,0.0,M2018-05-30D,Race(3),,
5,14,0,10,24,7,3,15,25,8,6,7,21,29,9,32,70,4.8,4.8,1.0,M2018-05-30D,Race(3),,
6,0,0,0,0,0,0,0,0,0,0,1,1,0,0,1,1,20,21,0.0,M2018-05-30D,Race(3),,
7,0,2,3,5,1,1,4,6,1,1,5,7,2,4,12,18,7,7,3.0,M2018-05-30D,Race(3),,
8,0,0,0,0,0,0,1,1,0,1,2,3,0,1,3,4,41,41,0.0,M2018-05-30D,Race(3),,
9,0,5,0,5,0,0,0,0,0,0,0,0,0,5,0,5,31,34,0.0,M2018-05-30D,Race(3),,
10,0,0,0,0,0,0,2,2,0,1,4,5,0,1,6,7,18,17,0.0,M2018-05-30D,Race(3),,
11,0,0,0,0,0,0,1,1,0,0,0,0,0,0,1,1,26,26,0.0,M2018-05-30D,Race(3),,
12,0,0,0,0,0,0,0,0,0,0,1,1,0,0,1,1,23,26,0.0,M2018-05-30D,Race(3),,
1,5,10,2,17,18,6,3,27,10,7,4,21,33,23,9,65,5,5,0.0,M2018-05-30D,Race(4),,
2,0,0,0,0,0,0,0,0,0,0,1,1,0,0,1,1,81,81,0.0,M2018-05-30D,Race(4),,
3,0,0,0,0,0,0,0,0,0,0,0,0,0,0,0,0,14,14,0.0,M2018-05-30D,Race(4),,
4,7,3,9,19,1,5,1,7,2,3,0,5,10,11,10,31,6,6,1.0,M2018-05-30D,Race(4),,
5,0,4,0,4,0,1,2,3,0,1,2,3,0,6,4,10,14,14,0.0,M2018-05-30D,Race(4),,
6,0,0,0,0,0,0,0,0,0,0,0,0,0,0,0,0,15,15,0.0,M2018-05-30D,Race(4),,
7,0,0,0,0,0,1,0,1,1,1,2,4,1,2,2,5,17,17,0.0,M2018-05-30D,Race(4),,
8,11,0,10,21,3,9,6,18,5,1,7,13,19,10,23,52,6,6,3.0,M2018-05-30D,Race(4),,
9,2,2,0,4,1,0,1,2,1,0,1,2,4,2,2,8,15,15,0.0,M2018-05-30D,Race(4),,
10,2,3,3,8,3,4,1,8,3,6,2,11,8,13,6,27,6.5,6.5,0.0,M2018-05-30D,Race(4),,
11,3,8,3,14,4,2,16,22,4,5,6,15,11,15,25,51,4.6,4.6,2.0,M2018-05-30D,Race(4),,
12,0,0,3,3,0,2,0,2,0,2,1,3,0,4,4,8,20,19,0.0,M2018-05-30D,Race(4),,
1,0,2,3,5,1,3,12,16,1,2,3,6,2,7,18,27,13,13,3.0,M2018-05-30D,Race(5),,
2,4,3,0,7,4,0,3,7,3,0,0,3,11,3,3,17,11,11,0.0,M2018-05-30D,Race(5),,
3,0,5,0,5,1,1,3,5,3,1,5,9,4,7,8,19,16,16,2.0,M2018-05-30D,Race(5),,
4,0,0,0,0,0,0,0,0,0,0,0,0,0,0,0,0,51,51,0.0,M2018-05-30D,Race(5),,
5,0,0,0,0,0,0,1,1,0,2,0,2,0,2,1,3,31,34,0.0,M2018-05-30D,Race(5),,
6,0,0,0,0,0,0,0,0,1,0,0,1,1,0,0,1,23,21,0.0,M2018-05-30D,Race(5),,
7,2,0,2,4,0,0,0,0,1,0,0,1,3,0,2,5,18,18,1.0,M2018-05-30D,Race(5),,
8,0,0,0,0,0,0,0,0,0,1,0,1,0,1,0,1,17,17,0.0,M2018-05-30D,Race(5),,
9,19,2,4,25,21,4,2,27,11,6,2,19,51,12,8,71,2.25,2.2,0.0,M2018-05-30D,Race(5),,
10,0,13,10,23,2,20,2,24,3,11,2,16,5,44,14,63,4.8,5,0.0,M2018-05-30D,Race(5),,
11,0,2,8,10,1,1,3,5,2,1,6,9,3,4,17,24,16,16,0.0,M2018-05-30D,Race(5),,
12,3,0,3,6,0,0,2,2,1,0,5,6,4,0,10,14,14,14,0.0,M2018-05-30D,Race(5),,
13,0,0,0,0,0,0,0,0,0,0,0,0,0,0,0,0,151,151,0.0,M2018-05-30D,Race(5),,
14,2,3,0,5,0,1,2,3,0,2,3,5,2,6,5,13,19,19,0.0,M2018-05-30D,Race(5),,
1,2,3,4,9,3,3,3,9,3,1,1,5,8,7,8,23,9,9,3.0,M2018-05-30D,Race(6),,
2,14,5,5,24,16,8,3,27,12,4,1,17,42,17,9,68,4,4,2.0,M2018-05-30D,Race(6),,
3,5,12,3,20,6,3,6,15,6,4,6,16,17,19,15,51,7,7,0.0,M2018-05-30D,Race(6),,
4,0,0,0,0,0,0,0,0,1,2,0,3,1,2,0,3,15,15,0.0,M2018-05-30D,Race(6),,
5,0,0,6,6,0,1,4,5,1,2,9,12,1,3,19,23,8.5,8.5,0.0,M2018-05-30D,Race(6),,
6,9,8,2,19,3,2,12,17,2,4,4,10,14,14,18,46,4.8,4.8,1.0,M2018-05-30D,Race(6),,
7,0,0,2,2,0,0,1,1,0,0,1,1,0,0,4,4,26,26,0.0,M2018-05-30D,Race(6),,
8,0,0,0,0,0,0,0,0,0,1,0,1,0,1,0,1,9,9,0.0,M2018-05-30D,Race(6),,
9,0,2,8,10,1,13,1,15,1,8,1,10,2,23,10,35,6,6,0.0,M2018-05-30D,Race(6),,
10,0,0,0,0,0,0,0,0,0,0,2,2,0,0,2,2,81,81,0.0,M2018-05-30D,Race(6),,
11,0,0,0,0,1,0,0,1,0,0,0,0,1,0,0,1,34,34,0.0,M2018-05-30D,Race(6),,
12,0,0,0,0,0,0,0,0,0,0,1,1,0,0,1,1,19,19,0.0,M2018-05-30D,Race(6),,
1,2,11,6,19,1,4,5,10,2,3,12,17,5,18,23,46,8,8,0.0,M2018-05-30D,Race(7),,
2,0,0,0,0,1,0,1,2,1,1,1,3,2,1,2,5,9,9,0.0,M2018-05-30D,Race(7),,
3,5,3,4,12,0,2,2,4,0,0,3,3,5,5,9,19,13,13,0.0,M2018-05-30D,Race(7),,
4,0,4,8,12,4,3,11,18,3,5,3,11,7,12,22,41,13,13,0.0,M2018-05-30D,Race(7),,
5,0,0,0,0,1,0,0,1,0,1,0,1,1,1,0,2,17,17,0.0,M2018-05-30D,Race(7),,
6,3,4,5,12,0,1,0,1,0,5,0,5,3,10,5,18,10,10,0.0,M2018-05-30D,Race(7),,
7,2,0,0,2,1,0,0,1,0,0,0,0,3,0,0,3,31,31,2.0,M2018-05-30D,Race(7),,
8,10,3,5,18,18,5,3,26,14,2,6,22,42,10,14,66,3.9,4,0.0,M2018-05-30D,Race(7),,
9,0,0,0,0,0,0,0,0,0,1,1,2,0,1,1,2,34,34,0.0,M2018-05-30D,Race(7),,
10,0,0,0,0,0,0,1,1,0,0,0,0,0,0,1,1,19,19,3.0,M2018-05-30D,Race(7),,
11,0,0,0,0,0,0,0,0,0,0,0,0,0,0,0,0,19,19,0.0,M2018-05-30D,Race(7),,
12,8,5,2,15,4,16,7,27,6,8,0,14,18,29,9,56,3.1,3,1.0,M2018-05-30D,Race(7),,
1,3,3,12,18,5,16,8,29,8,8,7,23,16,27,27,70,8.5,8.5,0.0,M2018-05-30D,Race(8),,
2,0,0,0,0,0,0,0,0,0,0,0,0,0,0,0,0,61,61,0.0,M2018-05-30D,Race(8),,
3,0,0,0,0,0,0,0,0,0,0,0,0,0,0,0,0,23,21,0.0,M2018-05-30D,Race(8),,
4,18,7,2,27,18,8,3,29,12,9,4,25,48,24,9,81,2.9,2.9,1.0,M2018-05-30D,Race(8),,
5,0,0,3,3,0,0,0,0,0,0,0,0,0,0,3,3,61,61,0.0,M2018-05-30D,Race(8),,
6,0,2,0,2,0,0,2,2,0,0,1,1,0,2,3,5,16,16,2.0,M2018-05-30D,Race(8),,
7,0,0,3,3,0,0,0,0,0,0,0,0,0,0,3,3,23,21,0.0,M2018-05-30D,Race(8),,
8,0,0,0,0,0,0,0,0,0,0,0,0,0,0,0,0,31,31,0.0,M2018-05-30D,Race(8),,
9,0,0,0,0,0,0,0,0,0,0,2,2,0,0,2,2,41,41,0.0,M2018-05-30D,Race(8),,
10,0,0,0,0,0,0,1,1,2,2,0,4,2,2,1,5,11,11,0.0,M2018-05-30D,Race(8),,
11,5,10,8,23,5,5,14,24,4,6,9,19,14,21,31,66,3.7,3.8,3.0,M2018-05-30D,Race(8),,
12,0,0,0,0,1,0,0,1,0,0,0,0,1,0,0,1,41,41,0.0,M2018-05-30D,Race(8),,
13,2,2,0,4,0,0,1,1,0,0,1,1,2,2,2,6,9,9,0.0,M2018-05-30D,Race(8),,
14,2,6,2,10,0,1,1,2,0,1,2,3,2,8,5,15,15,15,0.0,M2018-05-30D,Race(8),,
1,0,0,0,0,8,0,2,10,1,1,2,4,9,1,4,14,7.5,7.5,0.0,M2018-06-03D,Race(1),,
2,0,3,0,3,1,0,8,9,1,1,1,3,2,4,9,15,17,17,3.0,M2018-06-03D,Race(1),,
3,0,0,0,0,0,0,0,0,0,1,0,1,0,1,0,1,13,13,0.0,M2018-06-03D,Race(1),,
4,18,8,2,28,10,6,5,21,16,6,2,24,44,20,9,73,3.8,3.8,2.0,M2018-06-03D,Race(1),,
5,0,0,0,0,0,0,0,0,0,0,3,3,0,0,3,3,31,31,0.0,M2018-06-03D,Race(1),,
6,0,4,16,20,2,7,7,16,0,8,6,14,2,19,29,50,7,7,0.0,M2018-06-03D,Race(1),,
7,0,2,0,2,0,0,0,0,1,0,1,2,1,2,1,4,13,13,0.0,M2018-06-03D,Race(1),,
8,2,11,2,15,3,8,4,15,2,2,6,10,7,21,12,40,11,11,0.0,M2018-06-03D,Race(1),,
9,10,2,10,22,6,9,4,19,5,7,5,17,21,18,19,58,2.7,2.7,1.0,M2018-06-03D,Race(1),,
10,0,0,0,0,0,0,0,0,0,0,0,0,0,0,0,0,21,21,0.0,M2018-06-03D,Race(1),,
1,0,0,0,0,0,0,0,0,0,0,0,0,0,0,0,0,21,21,0.0,M2018-06-03D,Race(10),,
2,0,0,0,0,1,1,8,10,1,2,3,6,2,3,11,16,13,13,0.0,M2018-06-03D,Race(10),,
3,2,0,3,5,1,8,0,9,2,0,0,2,5,8,3,16,17,17,0.0,M2018-06-03D,Race(10),,
4,0,2,3,5,8,1,4,13,2,2,10,14,10,5,17,32,26,26,1.0,M2018-06-03D,Race(10),,
5,9,7,5,21,8,10,4,22,8,9,2,19,25,26,11,62,4,4,3.0,M2018-06-03D,Race(10),,
6,0,0,6,6,0,1,3,4,1,1,3,5,1,2,12,15,26,26,0.0,M2018-06-03D,Race(10),,
7,0,0,2,2,0,0,0,0,1,0,0,1,1,0,2,3,34,34,0.0,M2018-06-03D,Race(10),,
8,0,2,0,2,0,0,0,0,0,0,0,0,0,2,0,2,12,12,0.0,M2018-06-03D,Race(10),,
9,0,0,0,0,0,0,0,0,0,0,0,0,0,0,0,0,34,34,0.0,M2018-06-03D,Race(10),,
10,0,0,0,0,0,0,3,3,0,0,3,3,0,0,6,6,31,31,0.0,M2018-06-03D,Race(10),,
11,0,0,0,0,0,0,0,0,0,0,0,0,0,0,0,0,126,126,0.0,M2018-06-03D,Race(10),,
12,9,5,9,23,2,5,5,12,2,5,4,11,13,15,18,46,4.4,4.4,0.0,M2018-06-03D,Race(10),,
13,0,0,0,0,0,0,0,0,0,0,0,0,0,0,0,0,81,81,0.0,M2018-06-03D,Race(10),,
14,10,14,2,26,10,4,3,17,9,7,1,17,29,25,6,60,2.8,2.8,2.0,M2018-06-03D,Race(10),,
1,2,0,0,2,0,0,0,0,0,0,0,0,2,0,0,2,41,41,0.0,M2018-06-03D,Race(2),,
2,5,4,0,9,4,3,2,9,2,2,0,4,11,9,2,22,14,14,0.0,M2018-06-03D,Race(2),,
3,2,3,4,9,4,6,5,15,7,5,3,15,13,14,12,39,12,12,0.0,M2018-06-03D,Race(2),,
4,7,16,0,23,12,6,2,20,12,6,4,22,31,28,6,65,3.4,3.4,0.0,M2018-06-03D,Race(2),,
5,0,2,0,2,0,0,0,0,0,0,0,0,0,2,0,2,26,26,0.0,M2018-06-03D,Race(2),,
6,0,2,8,10,0,0,0,0,0,0,1,1,0,2,9,11,10,10,2.0,M2018-06-03D,Race(2),,
7,0,0,3,3,8,0,2,10,1,1,3,5,9,1,8,18,21,21,3.0,M2018-06-03D,Race(2),,
8,0,0,5,5,0,0,10,10,0,1,3,4,0,1,18,19,7,7,0.0,M2018-06-03D,Race(2),,
9,11,3,0,14,0,5,5,10,1,7,4,12,12,15,9,36,7,7,0.0,M2018-06-03D,Race(2),,
10,3,0,4,7,2,2,0,4,2,1,0,3,7,3,4,14,7.5,7.5,1.0,M2018-06-03D,Race(2),,
11,0,0,0,0,0,0,0,0,0,0,0,0,0,0,0,0,34,34,0.0,M2018-06-03D,Race(2),,
12,0,0,0,0,0,0,0,0,0,0,0,0,0,0,0,0,18,18,0.0,M2018-06-03D,Race(2),,
13,0,0,6,6,0,8,4,12,1,3,7,11,1,11,17,29,9,9,0.0,M2018-06-03D,Race(2),,
14,0,0,0,0,0,0,0,0,0,0,1,1,0,0,1,1,41,41,0.0,M2018-06-03D,Race(2),,
1,2,0,0,2,0,0,1,1,0,0,2,2,2,0,3,5,41,41,0.0,M2018-06-03D,Race(3),,
2,9,9,4,22,11,6,1,18,13,8,1,22,33,23,6,62,4,4,2.0,M2018-06-03D,Race(3),,
3,10,9,7,26,7,10,4,21,9,13,3,25,26,32,14,72,4,4,1.0,M2018-06-03D,Race(3),,
4,0,2,0,2,0,8,2,10,0,0,0,0,0,10,2,12,61,61,0.0,M2018-06-03D,Race(3),,
5,0,0,0,0,0,0,0,0,0,0,0,0,0,0,0,0,71,71,0.0,M2018-06-03D,Race(3),,
6,0,0,10,10,8,2,6,16,1,1,7,9,9,3,23,35,4.6,4.6,3.0,M2018-06-03D,Race(3),,
7,5,10,3,18,3,0,4,7,2,0,4,6,10,10,11,31,3.6,3.6,4.0,M2018-06-03D,Race(3),,
8,2,0,0,2,0,0,9,9,0,0,2,2,2,0,11,13,31,31,0.0,M2018-06-03D,Race(3),,
9,2,0,6,8,1,4,3,8,0,3,7,10,3,7,16,26,9,9,0.0,M2018-06-03D,Race(3),,
10,0,0,0,0,0,0,0,0,0,0,0,0,0,0,0,0,71,67,0.0,M2018-06-03D,Race(3),,
11,0,0,0,0,0,0,0,0,0,0,0,0,0,0,0,0,81,81,0.0,M2018-06-03D,Race(3),,
12,0,0,0,0,0,0,0,0,0,0,0,0,0,0,0,0,41,41,0.0,M2018-06-03D,Race(3),,
13,0,0,0,0,0,0,0,0,1,1,1,3,1,1,1,3,21,21,0.0,M2018-06-03D,Race(3),,
14,0,0,0,0,0,0,0,0,0,0,0,0,0,0,0,0,151,151,0.0,M2018-06-03D,Race(3),,
1,0,0,2,2,0,0,0,0,0,0,0,0,0,0,2,2,21,0,0.0,M2018-06-03D,Race(4),,
2,0,2,3,5,0,8,1,9,0,1,1,2,0,11,5,16,12,0,0.0,M2018-06-03D,Race(4),,
3,20,7,3,30,12,9,2,23,12,10,4,26,44,26,9,79,2.8,0,0.0,M2018-06-03D,Race(4),,
4,0,3,2,5,0,0,1,1,0,0,1,1,0,3,4,7,21,0,0.0,M2018-06-03D,Race(4),,
5,0,0,0,0,0,0,8,8,0,0,0,0,0,0,8,8,41,0,3.0,M2018-06-03D,Race(4),,
6,0,0,0,0,0,0,0,0,0,0,0,0,0,0,0,0,81,0,0.0,M2018-06-03D,Race(4),,
7,0,0,0,0,0,0,0,0,0,1,0,1,0,1,0,1,101,0,0.0,M2018-06-03D,Race(4),,
8,8,11,9,28,3,6,7,16,2,5,7,14,13,22,23,58,2.9,0,1.0,M2018-06-03D,Race(4),,
9,0,0,0,0,0,0,0,0,0,0,0,0,0,0,0,0,81,0,0.0,M2018-06-03D,Race(4),,
10,2,5,0,7,8,1,1,10,5,2,3,10,15,8,4,27,7,0,0.0,M2018-06-03D,Race(4),,
11,0,2,9,11,2,0,3,5,2,0,4,6,4,2,16,22,15,0,0.0,M2018-06-03D,Race(4),,
12,0,0,0,0,0,0,1,1,0,0,1,1,0,0,2,2,101,0,0.0,M2018-06-03D,Race(4),,
13,0,0,0,0,0,0,0,0,0,1,0,1,0,1,0,1,151,0,0.0,M2018-06-03D,Race(4),,
14,0,0,2,2,0,0,1,1,0,0,1,1,0,0,4,4,7,0,2.0,M2018-06-03D,Race(4),,
1,0,0,0,0,0,0,0,0,0,0,1,1,0,0,1,1,15,15,0.0,M2018-06-03D,Race(5),,
2,0,0,0,0,0,0,0,0,0,0,0,0,0,0,0,0,21,21,0.0,M2018-06-03D,Race(5),,
3,7,11,5,23,6,4,5,15,8,6,6,20,21,21,16,58,4.2,4.2,1.0,M2018-06-03D,Race(5),,
4,0,0,0,0,0,0,1,1,0,0,1,1,0,0,2,2,61,61,0.0,M2018-06-03D,Race(5),,
5,12,5,5,22,11,9,3,23,10,10,0,20,33,24,8,65,3.6,3.6,3.0,M2018-06-03D,Race(5),,
6,0,5,15,20,8,7,2,17,3,6,2,11,11,18,19,48,6.5,6.5,2.0,M2018-06-03D,Race(5),,
7,0,0,0,0,0,0,0,0,0,0,0,0,0,0,0,0,31,31,0.0,M2018-06-03D,Race(5),,
8,2,0,3,5,0,8,1,9,0,2,2,4,2,10,6,18,12,12,0.0,M2018-06-03D,Race(5),,
9,9,6,2,17,5,2,10,17,4,2,11,17,18,10,23,51,4.6,4.6,0.0,M2018-06-03D,Race(5),,
10,0,0,0,0,0,0,0,0,0,0,0,0,0,0,0,0,61,61,0.0,M2018-06-03D,Race(5),,
11,0,0,0,0,0,0,0,0,0,0,0,0,0,0,0,0,61,61,0.0,M2018-06-03D,Race(5),,
12,0,0,0,0,0,0,0,0,0,0,0,0,0,0,0,0,126,126,0.0,M2018-06-03D,Race(5),,
13,0,0,0,0,0,0,8,8,0,0,3,3,0,0,11,11,13,13,0.0,M2018-06-03D,Race(5),,
14,0,3,0,3,0,0,0,0,1,0,0,1,1,3,0,4,21,21,0.0,M2018-06-03D,Race(5),,
1,17,9,4,30,17,5,0,22,15,5,1,21,49,19,5,73,2.2,2.2,0.0,M2018-06-03D,Race(6),,
2,0,0,0,0,0,0,0,0,0,0,1,1,0,0,1,1,71,71,0.0,M2018-06-03D,Race(6),,
3,6,6,3,15,1,9,8,18,6,8,7,21,13,23,18,54,6,6,2.0,M2018-06-03D,Race(6),,
4,0,6,0,6,0,8,4,12,1,1,3,5,1,15,7,23,17,17,3.0,M2018-06-03D,Race(6),,
5,3,7,13,23,4,7,5,16,3,9,3,15,10,23,21,54,4.2,4.2,1.0,M2018-06-03D,Race(6),,
6,0,0,0,0,0,0,8,8,0,0,1,1,0,0,9,9,26,26,0.0,M2018-06-03D,Race(6),,
7,0,0,0,0,0,0,0,0,1,0,0,1,1,0,0,1,151,151,0.0,M2018-06-03D,Race(6),,
8,2,0,5,7,0,0,0,0,0,0,0,0,2,0,5,7,41,41,0.0,M2018-06-03D,Race(6),,
9,2,0,0,2,0,0,1,1,0,1,4,5,2,1,5,8,13,13,0.0,M2018-06-03D,Race(6),,
10,0,0,2,2,8,1,3,12,0,2,5,7,8,3,10,21,7,7,0.0,M2018-06-03D,Race(6),,
11,0,0,0,0,0,0,0,0,0,0,0,0,0,0,0,0,34,35,0.0,M2018-06-03D,Race(6),,
12,0,0,0,0,0,0,0,0,0,0,0,0,0,0,0,0,61,61,0.0,M2018-06-03D,Race(6),,
13,0,2,3,5,0,0,1,1,0,0,1,1,0,2,5,7,31,31,0.0,M2018-06-03D,Race(6),,
1,7,5,8,20,8,6,5,19,8,7,5,20,23,18,18,59,4,4,0.0,M2018-06-03D,Race(7),,
2,6,8,6,20,5,7,4,16,8,6,4,18,19,21,14,54,4.6,4.6,2.0,M2018-06-03D,Race(7),,
3,3,2,5,10,0,8,3,11,0,3,6,9,3,13,14,30,21,21,0.0,M2018-06-03D,Race(7),,
4,5,0,0,5,0,0,9,9,0,1,4,5,5,1,13,19,17,17,3.0,M2018-06-03D,Race(7),,
5,0,5,2,7,0,0,0,0,0,0,0,0,0,5,2,7,10,10,0.0,M2018-06-03D,Race(7),,
6,0,3,0,3,9,4,4,17,2,2,5,9,11,9,9,29,13,13,0.0,M2018-06-03D,Race(7),,
7,0,0,0,0,0,0,0,0,0,0,0,0,0,0,0,0,26,27,0.0,M2018-06-03D,Race(7),,
8,9,7,6,22,8,6,4,18,7,7,1,15,24,20,11,55,2.5,2.5,1.0,M2018-06-03D,Race(7),,
9,0,0,0,0,0,0,0,0,0,0,0,0,0,0,0,0,26,27,0.0,M2018-06-03D,Race(7),,
10,0,0,3,3,0,0,0,0,1,0,1,2,1,0,4,5,15,15,0.0,M2018-06-03D,Race(7),,
1,3,5,6,14,1,5,6,12,4,5,5,14,8,15,17,40,10,10,0.0,M2018-06-03D,Race(8),,
2,0,0,2,2,0,0,0,0,0,0,0,0,0,0,2,2,126,126,0.0,M2018-06-03D,Race(8),,
3,2,0,0,2,0,0,8,8,0,2,1,3,2,2,9,13,8,8,0.0,M2018-06-03D,Race(8),,
4,0,0,0,0,0,0,0,0,0,0,0,0,0,0,0,0,101,101,0.0,M2018-06-03D,Race(8),,
5,2,11,0,13,2,4,2,8,0,4,1,5,4,19,3,26,6.5,6.5,0.0,M2018-06-03D,Race(8),,
6,0,5,9,14,6,6,4,16,8,6,5,19,14,17,18,49,4.4,4.4,1.0,M2018-06-03D,Race(8),,
7,0,0,0,0,0,0,0,0,0,0,0,0,0,0,0,0,126,126,0.0,M2018-06-03D,Race(8),,
8,0,0,0,0,0,0,0,0,0,0,0,0,0,0,0,0,34,34,0.0,M2018-06-03D,Race(8),,
9,0,0,0,0,0,0,0,0,0,0,1,1,0,0,1,1,26,26,0.0,M2018-06-03D,Race(8),,
10,0,0,0,0,1,0,1,2,2,1,1,4,3,1,2,6,41,41,0.0,M2018-06-03D,Race(8),,
11,2,2,0,4,8,0,3,11,1,0,1,2,11,2,4,17,21,21,0.0,M2018-06-03D,Race(8),,
12,21,4,5,30,12,7,3,22,10,7,6,23,43,18,14,75,2.6,2.6,2.0,M2018-06-03D,Race(8),,
13,0,3,8,11,0,8,2,10,1,1,5,7,1,12,15,28,7,7,3.0,M2018-06-03D,Race(8),,
1,0,3,2,5,1,1,8,10,0,2,1,3,1,6,11,18,19,19,0.0,M2018-06-03D,Race(9),,
2,9,6,5,20,4,4,10,18,5,4,7,16,18,14,22,54,5,5,0.0,M2018-06-03D,Race(9),,
3,3,0,6,9,1,8,1,10,1,1,5,7,5,9,12,26,5.5,5.5,3.0,M2018-06-03D,Race(9),,
4,0,0,0,0,0,0,0,0,0,0,0,0,0,0,0,0,17,17,0.0,M2018-06-03D,Race(9),,
5,0,2,3,5,0,0,2,2,3,1,3,7,3,3,8,14,14,14,0.0,M2018-06-03D,Race(9),,
6,2,0,4,6,0,2,1,3,1,3,1,5,3,5,6,14,14,14,0.0,M2018-06-03D,Race(9),,
7,3,15,3,21,6,7,3,16,6,5,4,15,15,27,10,52,4.4,4.4,1.0,M2018-06-03D,Race(9),,
8,0,0,0,0,0,0,0,0,0,0,0,0,0,0,0,0,81,81,2.0,M2018-06-03D,Race(9),,
9,13,4,5,22,10,8,2,20,8,8,4,20,31,20,11,62,4.2,4.2,0.0,M2018-06-03D,Race(9),,
10,0,0,0,0,0,0,0,0,0,1,0,1,0,1,0,1,13,13,0.0,M2018-06-03D,Race(9),,
11,0,0,2,2,8,0,3,11,2,1,1,4,10,1,6,17,12,12,0.0,M2018-06-03D,Race(9),,
12,0,0,0,0,0,0,0,0,0,0,0,0,0,0,0,0,41,41,0.0,M2018-06-03D,Race(9),,
1,0,0,0,0,1,1,0,2,3,3,0,6,4,4,0,8,26,26,0.0,M2018-06-06D,Race(1),,
2,0,0,0,0,0,0,0,0,1,0,1,2,1,0,1,2,10,10,0.0,M2018-06-06D,Race(1),,
3,2,4,0,6,1,3,3,7,4,3,3,10,7,10,6,23,8.5,8.5,0.0,M2018-06-06D,Race(1),,
4,2,0,0,2,6,11,6,23,5,6,4,15,13,17,10,40,11,11,1.0,M2018-06-06D,Race(1),,
5,10,11,5,26,4,5,5,14,5,4,6,15,19,20,16,55,4.4,4.4,0.0,M2018-06-06D,Race(1),,
6,0,0,0,0,0,0,0,0,0,0,0,0,0,0,0,0,13,13,0.0,M2018-06-06D,Race(1),,
7,0,0,0,0,0,0,0,0,1,0,3,4,1,0,3,4,31,31,2.0,M2018-06-06D,Race(1),,
8,0,0,2,2,0,0,0,0,0,0,0,0,0,0,2,2,19,19,0.0,M2018-06-06D,Race(1),,
9,13,10,7,30,16,8,2,26,6,5,3,14,35,23,12,70,3.5,3.5,0.0,M2018-06-06D,Race(1),,
10,0,0,3,3,1,1,0,2,1,2,2,5,2,3,5,10,19,19,0.0,M2018-06-06D,Race(1),,
11,3,3,13,19,1,1,14,16,0,3,4,7,4,7,31,42,6,6,3.0,M2018-06-06D,Race(1),,
12,0,2,0,2,0,0,0,0,0,0,0,0,0,2,0,2,17,17,0.0,M2018-06-06D,Race(1),,
1,,,,,,,,,,,,,,,,,0,0,0.0,M2018-06-06D,Race(2),,
2,20,8,2,30,23,7,0,30,17,5,2,24,60,20,4,84,1.8,1.8,1.0,M2018-06-06D,Race(2),,
3,0,7,3,10,0,0,0,0,0,1,2,3,0,8,5,13,8.5,8.5,0.0,M2018-06-06D,Race(2),,
4,0,0,5,5,0,0,2,2,0,1,2,3,0,1,9,10,14,14,0.0,M2018-06-06D,Race(2),,
5,5,7,8,20,0,4,5,9,3,6,7,16,8,17,20,45,6,6,0.0,M2018-06-06D,Race(2),,
6,0,5,5,10,0,0,0,0,0,0,0,0,0,5,5,10,10,10,2.0,M2018-06-06D,Race(2),,
7,5,3,7,15,1,3,16,20,3,3,5,11,9,9,28,46,4.4,4.4,0.0,M2018-06-06D,Race(2),,
1,14,7,3,24,18,4,7,29,6,8,8,22,38,19,18,75,2.6,2.6,0.0,M2018-06-06D,Race(3),,
2,2,3,0,5,1,2,1,4,2,1,0,3,5,6,1,12,17,17,0.0,M2018-06-06D,Race(3),,
3,0,0,0,0,2,0,0,2,1,1,0,2,3,1,0,4,21,21,1.0,M2018-06-06D,Race(3),,
4,5,2,10,17,0,4,10,14,3,3,3,9,8,9,23,40,8.5,8.5,0.0,M2018-06-06D,Race(3),,
5,3,6,0,9,3,0,1,4,7,3,1,11,13,9,2,24,7.5,7.5,3.0,M2018-06-06D,Race(3),,
6,0,0,3,3,0,0,1,1,0,0,1,1,0,0,5,5,19,19,0.0,M2018-06-06D,Race(3),,
7,3,0,2,5,1,0,0,1,0,3,4,7,4,3,6,13,15,15,0.0,M2018-06-06D,Race(3),,
8,0,0,0,0,0,3,0,3,0,0,0,0,0,3,0,3,10,10,0.0,M2018-06-06D,Race(3),,
9,0,2,6,8,1,2,5,8,0,3,3,6,1,7,14,22,17,17,0.0,M2018-06-06D,Race(3),,
10,0,0,0,0,0,1,0,1,0,3,1,4,0,4,1,5,26,26,2.0,M2018-06-06D,Race(3),,
11,3,10,4,17,4,14,5,23,7,4,5,16,14,28,14,56,4.8,4.8,0.0,M2018-06-06D,Race(3),,
12,0,0,2,2,0,0,0,0,0,0,0,0,0,0,2,2,34,34,0.0,M2018-06-06D,Race(3),,
1,2,4,9,15,1,0,5,6,1,3,6,10,4,7,20,31,13,13,0.0,M2018-06-06D,Race(4),,
2,18,3,6,27,19,6,0,25,10,5,0,15,47,14,6,67,2.7,2.7,0.0,M2018-06-06D,Race(4),,
3,0,2,2,4,0,1,1,2,0,1,0,1,0,4,3,7,16,16,0.0,M2018-06-06D,Race(4),,
4,3,11,2,16,4,12,4,20,4,3,6,13,11,26,12,49,3.5,3.5,1.0,M2018-06-06D,Race(4),,
5,2,2,3,7,0,2,1,3,0,1,2,3,2,5,6,13,16,16,0.0,M2018-06-06D,Race(4),,
6,0,0,0,0,0,0,0,0,0,0,1,1,0,0,1,1,26,26,0.0,M2018-06-06D,Race(4),,
7,0,0,2,2,0,0,0,0,0,0,0,0,0,0,2,2,19,19,0.0,M2018-06-06D,Race(4),,
8,0,0,3,3,0,2,2,4,0,3,2,5,0,5,7,12,21,21,0.0,M2018-06-06D,Race(4),,
9,2,0,0,2,1,1,5,7,6,2,3,11,9,3,8,20,8,8,3.0,M2018-06-06D,Race(4),,
10,3,8,3,14,5,6,12,23,5,8,6,19,13,22,21,56,6.5,6.5,2.0,M2018-06-06D,Race(4),,
11,0,0,0,0,0,0,0,0,0,0,0,0,0,0,0,0,41,41,0.0,M2018-06-06D,Race(4),,
1,5,5,3,13,3,2,1,6,4,2,0,6,12,9,4,25,9,9,0.0,M2018-06-06D,Race(5),,
2,8,5,2,15,2,6,10,18,5,4,2,11,15,15,14,44,6.5,6.5,1.0,M2018-06-06D,Race(5),,
3,0,0,0,0,0,0,0,0,0,0,0,0,0,0,0,0,26,26,0.0,M2018-06-06D,Race(5),,
4,0,3,4,7,2,13,4,19,2,4,5,11,4,20,13,37,4.2,4.2,2.0,M2018-06-06D,Race(5),,
5,0,0,0,0,0,0,0,0,0,0,0,0,0,0,0,0,26,26,0.0,M2018-06-06D,Race(5),,
6,0,3,3,6,1,0,4,5,0,1,10,11,1,4,17,22,19,19,0.0,M2018-06-06D,Race(5),,
7,2,2,0,4,0,0,2,2,1,0,2,3,3,2,4,9,19,19,0.0,M2018-06-06D,Race(5),,
8,9,9,7,25,16,3,6,25,6,8,5,19,31,20,18,69,3.3,3.3,3.0,M2018-06-06D,Race(5),,
9,2,0,0,2,0,0,0,0,0,0,0,0,2,0,0,2,17,17,0.0,M2018-06-06D,Race(5),,
10,0,3,0,3,0,0,0,0,0,0,0,0,0,3,0,3,15,15,0.0,M2018-06-06D,Race(5),,
11,2,0,11,13,5,3,2,10,5,3,2,10,12,6,15,33,8.5,8.5,0.0,M2018-06-06D,Race(5),,
12,2,0,0,2,1,2,0,3,3,2,0,5,6,4,0,10,15,15,0.0,M2018-06-06D,Race(5),,
1,5,13,12,30,1,16,8,25,1,8,6,15,7,37,26,70,4.4,4.4,0.0,M2018-06-06D,Race(6),,
2,0,0,0,0,0,1,2,3,0,2,3,5,0,3,5,8,34,34,0.0,M2018-06-06D,Race(6),,
3,18,7,3,28,29,1,0,30,22,2,2,26,69,10,5,84,2.3,2.3,1.0,M2018-06-06D,Race(6),,
4,0,2,0,2,0,0,0,0,0,0,0,0,0,2,0,2,15,15,0.0,M2018-06-06D,Race(6),,
5,0,2,3,5,0,1,0,1,1,0,1,2,1,3,4,8,21,21,0.0,M2018-06-06D,Race(6),,
6,0,0,0,0,0,0,0,0,0,0,1,1,0,0,1,1,17,17,0.0,M2018-06-06D,Race(6),,
7,0,0,0,0,0,3,0,3,0,3,0,3,0,6,0,6,34,34,0.0,M2018-06-06D,Race(6),,
8,5,3,10,18,0,1,2,3,0,4,2,6,5,8,14,27,4.6,4.5,0.0,M2018-06-06D,Race(6),,
9,0,0,0,0,0,0,0,0,0,0,0,0,0,0,0,0,81,81,0.0,M2018-06-06D,Race(6),,
10,0,3,2,5,0,4,12,16,1,3,4,8,1,10,18,29,17,17,0.0,M2018-06-06D,Race(6),,
11,2,0,0,2,0,1,2,3,0,0,2,2,2,1,4,7,17,17,2.0,M2018-06-06D,Race(6),,
12,0,0,0,0,0,0,1,1,0,1,1,2,0,1,2,3,21,21,3.0,M2018-06-06D,Race(6),,
1,0,0,3,3,1,0,1,2,1,1,4,6,2,1,8,11,19,19,0.0,M2018-06-06D,Race(7),,
2,16,5,2,23,17,7,3,27,14,8,0,22,47,20,5,72,3.5,3.5,2.0,M2018-06-06D,Race(7),,
3,2,0,2,4,0,0,6,6,0,0,0,0,2,0,8,10,51,51,0.0,M2018-06-06D,Race(7),,
4,0,6,0,6,0,1,3,4,2,0,1,3,2,7,4,13,7,7,3.0,M2018-06-06D,Race(7),,
5,0,0,0,0,0,0,0,0,0,0,0,0,0,0,0,0,26,26,0.0,M2018-06-06D,Race(7),,
6,7,13,6,26,7,10,2,19,2,3,5,10,16,26,13,55,4.2,4.2,1.0,M2018-06-06D,Race(7),,
7,0,0,5,5,0,0,2,2,0,1,3,4,0,1,10,11,13,13,0.0,M2018-06-06D,Race(7),,
8,0,2,2,4,0,0,2,2,1,1,3,5,1,3,7,11,19,19,0.0,M2018-06-06D,Race(7),,
9,0,0,6,6,1,0,0,1,0,1,1,2,1,1,7,9,7,7,0.0,M2018-06-06D,Race(7),,
10,0,0,0,0,0,0,0,0,0,0,0,0,0,0,0,0,31,31,0.0,M2018-06-06D,Race(7),,
11,0,2,4,6,3,5,14,22,5,5,7,17,8,12,25,45,7.5,7.5,0.0,M2018-06-06D,Race(7),,
12,5,2,0,7,1,7,3,11,1,6,2,9,7,15,5,27,12,12,0.0,M2018-06-06D,Race(7),,
1,8,3,0,11,4,3,6,13,4,4,4,12,16,10,10,36,4.6,4.6,2.0,M2018-06-06D,Race(8),,
2,0,0,0,0,0,0,2,2,0,1,4,5,0,1,6,7,17,17,0.0,M2018-06-06D,Race(8),,
3,3,2,3,8,1,0,3,4,0,0,3,3,4,2,9,15,19,19,1.0,M2018-06-06D,Race(8),,
4,8,6,10,24,15,7,4,26,11,5,4,20,34,18,18,70,3.4,3.4,3.0,M2018-06-06D,Race(8),,
5,0,0,0,0,1,0,0,1,0,0,0,0,1,0,0,1,19,19,0.0,M2018-06-06D,Race(8),,
6,0,0,0,0,0,0,0,0,0,0,0,0,0,0,0,0,13,13,0.0,M2018-06-06D,Race(8),,
7,5,14,0,19,7,18,1,26,11,10,2,23,23,42,3,68,4.4,4.4,0.0,M2018-06-06D,Race(8),,
8,0,0,0,0,0,0,0,0,0,0,0,0,0,0,0,0,34,34,0.0,M2018-06-06D,Race(8),,
9,0,0,0,0,0,0,0,0,0,0,0,0,0,0,0,0,41,41,0.0,M2018-06-06D,Race(8),,
10,6,3,7,16,2,2,14,18,0,5,6,11,8,10,27,45,7,7,0.0,M2018-06-06D,Race(8),,
11,0,0,4,4,0,0,0,0,0,1,1,2,0,1,5,6,12,12,0.0,M2018-06-06D,Race(8),,
12,0,2,6,8,0,0,0,0,0,0,2,2,0,2,8,10,26,26,0.0,M2018-06-06D,Race(8),,
1,0,0,0,0,0,0,9,9,1,1,5,7,1,1,14,16,13,13,0.0,M2018-06-10D,Race(1),,
2,11,17,2,30,6,14,2,22,8,17,1,26,25,48,5,78,2.7,2.7,0.0,M2018-06-10D,Race(1),,
3,19,11,0,30,16,6,1,23,16,7,2,25,51,24,3,78,1.95,1.95,3.0,M2018-06-10D,Race(1),,
4,0,0,0,0,0,2,5,7,0,0,6,6,0,2,11,13,51,51,0.0,M2018-06-10D,Race(1),,
5,0,0,17,17,0,8,3,11,0,1,3,4,0,9,23,32,10,10,2.0,M2018-06-10D,Race(1),,
6,0,0,7,7,8,0,10,18,1,0,8,9,9,0,25,34,8,8,1.0,M2018-06-10D,Race(1),,
7,0,2,4,6,0,0,0,0,0,0,1,1,0,2,5,7,16,16,0.0,M2018-06-10D,Race(1),,
1,0,0,6,6,8,3,2,13,1,2,3,6,9,5,11,25,16,16,0.0,M2018-06-10D,Race(10),,
2,6,5,0,11,1,8,2,11,1,1,4,6,8,14,6,28,6,6,2.0,M2018-06-10D,Race(10),,
3,10,9,0,19,3,5,6,14,4,3,3,10,17,17,9,43,4,4,1.0,M2018-06-10D,Race(10),,
4,-,-,-,0,1,2,8,11,0,0,0,0,,,,11,0,0,0.0,M2018-06-10D,Race(10),,
5,0,0,0,0,0,0,0,0,2,0,0,2,2,0,0,2,31,31,0.0,M2018-06-10D,Race(10),,
6,4,8,9,21,4,4,4,12,2,7,4,13,10,19,17,46,4.6,4.6,0.0,M2018-06-10D,Race(10),,
7,0,2,0,2,0,0,0,0,0,0,0,0,0,2,0,2,51,51,0.0,M2018-06-10D,Race(10),,
8,0,0,7,7,2,2,3,7,1,3,4,8,3,5,14,22,13,13,0.0,M2018-06-10D,Race(10),,
9,8,3,8,19,11,6,3,20,12,6,1,19,31,15,12,58,6,6,0.0,M2018-06-10D,Race(10),,
10,2,3,0,5,0,0,3,3,0,0,5,5,2,3,8,13,12,12,3.0,M2018-06-10D,Race(10),,
11,0,0,0,0,0,0,0,0,0,0,0,0,0,0,0,0,34,34,0.0,M2018-06-10D,Race(10),,
12,0,0,0,0,0,0,0,0,0,0,0,0,0,0,0,0,16,16,0.0,M2018-06-10D,Race(10),,
13,0,0,0,0,0,0,0,0,0,0,0,0,0,0,0,0,21,21,0.0,M2018-06-10D,Race(10),,
14,0,0,0,0,0,0,0,0,1,0,0,1,1,0,0,1,12,12,0.0,M2018-06-10D,Race(10),,
1,0,0,2,2,8,1,0,9,1,1,1,3,9,2,3,14,9,9,0.0,M2018-06-10D,Race(11),,
2,13,15,2,30,11,4,1,16,10,7,0,17,34,26,3,63,4.4,4.4,0.0,M2018-06-10D,Race(11),,
3,0,0,0,0,0,0,0,0,0,0,0,0,0,0,0,0,26,26,0.0,M2018-06-10D,Race(11),,
4,0,0,0,0,0,0,0,0,0,0,0,0,0,0,0,0,26,26,0.0,M2018-06-10D,Race(11),,
5,0,3,7,10,1,3,3,7,1,0,4,5,2,6,14,22,7,7,2.0,M2018-06-10D,Race(11),,
6,0,0,0,0,0,0,0,0,0,1,0,1,0,1,0,1,31,31,0.0,M2018-06-10D,Race(11),,
7,10,10,0,20,6,9,4,19,6,9,4,19,22,28,8,58,3,3,3.0,M2018-06-10D,Race(11),,
8,4,0,11,15,1,8,9,18,4,4,10,18,9,12,30,51,6.5,6.5,1.0,M2018-06-10D,Race(11),,
9,3,0,0,3,0,0,2,2,0,0,2,2,3,0,4,7,14,14,0.0,M2018-06-10D,Race(11),,
10,0,2,0,2,0,0,8,8,0,0,0,0,0,2,8,10,41,41,0.0,M2018-06-10D,Race(11),,
11,0,0,0,0,0,0,0,0,0,1,0,1,0,1,0,1,31,31,0.0,M2018-06-10D,Race(11),,
12,0,0,0,0,0,0,0,0,0,0,0,0,0,0,0,0,101,101,0.0,M2018-06-10D,Race(11),,
13,0,0,8,8,3,5,3,11,4,3,5,12,7,8,16,31,14,14,0.0,M2018-06-10D,Race(11),,
14,0,0,0,0,0,0,0,0,0,0,0,0,0,0,0,0,81,81,0.0,M2018-06-10D,Race(11),,
1,0,3,3,6,0,2,0,2,0,0,0,0,0,5,3,8,21,21,0.0,M2018-06-10D,Race(2),,
2,6,3,0,9,8,0,3,11,3,2,5,10,17,5,8,30,7.5,7.5,0.0,M2018-06-10D,Race(2),,
3,4,10,0,14,1,2,3,6,1,3,4,8,6,15,7,28,18,18,0.0,M2018-06-10D,Race(2),,
4,0,0,3,3,2,8,2,12,3,2,0,5,5,10,5,20,15,15,0.0,M2018-06-10D,Race(2),,
5,2,0,0,2,0,2,8,10,0,2,1,3,2,4,9,15,51,51,0.0,M2018-06-10D,Race(2),,
6,8,5,8,21,8,5,3,16,7,3,4,14,23,13,15,51,4.8,4.8,3.0,M2018-06-10D,Race(2),,
7,2,2,5,9,2,1,6,9,2,3,5,10,6,6,16,28,9,9,2.0,M2018-06-10D,Race(2),,
8,0,0,2,2,0,0,0,0,0,0,0,0,0,0,2,2,12,12,1.0,M2018-06-10D,Race(2),,
9,0,0,2,2,0,0,0,0,0,0,1,1,0,0,3,3,34,34,0.0,M2018-06-10D,Race(2),,
10,0,0,0,0,0,0,0,0,0,0,0,0,0,0,0,0,34,34,0.0,M2018-06-10D,Race(2),,
11,2,3,4,9,9,6,3,18,9,7,2,18,20,16,9,45,4,4,0.0,M2018-06-10D,Race(2),,
12,0,2,0,2,0,1,0,1,0,1,2,3,0,4,2,6,31,31,0.0,M2018-06-10D,Race(2),,
13,0,0,0,0,0,0,0,0,0,0,0,0,0,0,0,0,34,34,0.0,M2018-06-10D,Race(2),,
14,6,2,3,11,0,3,2,5,1,3,2,6,7,8,7,22,5,5,0.0,M2018-06-10D,Race(2),,
1,5,0,3,8,8,0,1,9,1,1,2,4,14,1,6,21,8.5,8.5,0.0,M2018-06-10D,Race(3),,
2,0,3,6,9,2,8,3,13,2,3,4,9,4,14,13,31,6.5,6.5,0.0,M2018-06-10D,Race(3),,
3,3,0,2,5,5,8,5,18,5,6,9,20,13,14,16,43,7,7,0.0,M2018-06-10D,Race(3),,
4,0,2,3,5,0,0,8,8,1,1,1,3,1,3,12,16,21,21,0.0,M2018-06-10D,Race(3),,
5,2,5,0,7,0,0,1,1,0,1,1,2,2,6,2,10,10,10,0.0,M2018-06-10D,Race(3),,
6,0,0,0,0,0,0,0,0,0,0,0,0,0,0,0,0,11,11,3.0,M2018-06-10D,Race(3),,
7,0,0,0,0,0,0,0,0,1,0,1,2,1,0,1,2,61,61,0.0,M2018-06-10D,Race(3),,
8,7,11,4,22,12,5,1,18,12,5,1,18,31,21,6,58,7.5,7.5,2.0,M2018-06-10D,Race(3),,
9,0,0,0,0,0,0,0,0,0,0,0,0,0,0,0,0,21,21,0.0,M2018-06-10D,Race(3),,
10,11,6,8,25,1,7,8,16,2,7,2,11,14,20,18,52,4.4,4.4,0.0,M2018-06-10D,Race(3),,
11,0,0,0,0,0,0,0,0,0,0,0,0,0,0,0,0,17,17,0.0,M2018-06-10D,Race(3),,
12,2,3,2,7,1,2,2,5,0,2,3,5,3,7,7,17,14,14,0.0,M2018-06-10D,Race(3),,
13,0,0,0,0,0,0,1,1,0,0,2,2,0,0,3,3,34,34,0.0,M2018-06-10D,Race(3),,
14,0,0,2,2,1,0,0,1,2,0,0,2,3,0,2,5,17,17,1.0,M2018-06-10D,Race(3),,
1,0,7,0,7,8,1,1,10,0,2,3,5,8,10,4,22,11,11,0.0,M2018-06-10D,Race(4),,
2,4,3,15,22,9,9,3,21,14,7,3,24,27,19,21,67,2.3,2.3,0.0,M2018-06-10D,Race(4),,
3,0,0,0,0,0,0,0,0,0,0,0,0,0,0,0,0,31,31,0.0,M2018-06-10D,Race(4),,
4,3,6,2,11,1,5,3,9,1,7,5,13,5,18,10,33,5,5,2.0,M2018-06-10D,Race(4),,
5,3,2,0,5,4,8,7,19,6,3,7,16,13,13,14,40,7,7,0.0,M2018-06-10D,Race(4),,
6,12,5,2,19,8,5,3,16,5,5,4,14,25,15,9,49,8.5,8.5,0.0,M2018-06-10D,Race(4),,
7,0,2,0,2,0,0,2,2,0,0,1,1,0,2,3,5,41,41,3.0,M2018-06-10D,Race(4),,
8,0,5,3,8,0,0,8,8,0,0,0,0,0,5,11,16,6,6,1.0,M2018-06-10D,Race(4),,
9,8,0,8,16,0,2,3,5,0,2,3,5,8,4,14,26,11,11,0.0,M2018-06-10D,Race(4),,
1,5,8,5,18,2,2,10,14,1,1,9,11,8,11,24,43,7.5,7.5,3.0,M2018-06-10D,Race(5),,
2,14,5,5,24,13,5,4,22,15,4,5,24,42,14,14,70,2.1,2.1,1.0,M2018-06-10D,Race(5),,
3,0,0,0,0,0,0,0,0,0,1,0,1,0,1,0,1,81,81,0.0,M2018-06-10D,Race(5),,
4,0,2,6,8,0,0,8,8,0,2,1,3,0,4,15,19,21,21,0.0,M2018-06-10D,Race(5),,
5,0,0,2,2,0,1,1,2,1,2,1,4,1,3,4,8,13,13,2.0,M2018-06-10D,Race(5),,
6,8,12,5,25,7,14,1,22,7,13,3,23,22,39,9,70,3.7,3.7,0.0,M2018-06-10D,Race(5),,
7,-,-,-,0,0,1,3,4,0,0,0,0,,,,4,0,0,0.0,M2018-06-10D,Race(5),,
8,0,0,0,0,0,8,3,11,0,0,0,0,0,8,3,11,26,26,0.0,M2018-06-10D,Race(5),,
9,0,3,5,8,0,0,0,0,0,0,1,1,0,3,6,9,12,12,0.0,M2018-06-10D,Race(5),,
10,0,0,0,0,0,0,1,1,0,0,1,1,0,0,2,2,17,17,0.0,M2018-06-10D,Race(5),,
11,3,0,2,5,8,0,1,9,2,1,2,5,13,1,5,19,10,10,0.0,M2018-06-10D,Race(5),,
1,8,7,8,23,6,9,4,19,6,5,4,15,20,21,16,57,5,5,0.0,M2018-06-10D,Race(6),,
2,9,5,5,19,6,9,4,19,7,6,8,21,22,20,17,59,3.8,3.8,0.0,M2018-06-10D,Race(6),,
3,0,3,5,8,6,8,3,17,6,4,2,12,12,15,10,37,6.5,6.5,0.0,M2018-06-10D,Race(6),,
4,0,0,0,0,0,0,0,0,0,0,1,1,0,0,1,1,51,51,0.0,M2018-06-10D,Race(6),,
5,0,0,3,3,0,0,0,0,0,0,0,0,0,0,3,3,51,51,0.0,M2018-06-10D,Race(6),,
6,8,5,2,15,4,2,9,15,5,5,3,13,17,12,14,43,4.2,4.2,0.0,M2018-06-10D,Race(6),,
7,2,10,2,14,8,2,2,12,2,4,3,9,12,16,7,35,5.5,5.5,2.0,M2018-06-10D,Race(6),,
8,0,0,0,0,0,0,0,0,0,1,0,1,0,1,0,1,13,13,0.0,M2018-06-10D,Race(6),,
9,3,0,2,5,0,0,8,8,0,0,4,4,3,0,14,17,14,14,3.0,M2018-06-10D,Race(6),,
10,0,0,0,0,0,0,0,0,0,0,0,0,0,0,0,0,61,61,0.0,M2018-06-10D,Race(6),,
11,0,0,3,3,0,0,0,0,0,1,1,2,0,1,4,5,17,17,1.0,M2018-06-10D,Race(6),,
1,0,0,0,0,0,0,1,1,0,0,1,1,0,0,2,2,51,51,0.0,M2018-06-10D,Race(7),,
2,0,3,4,7,3,2,1,6,3,6,0,9,6,11,5,22,12,12,0.0,M2018-06-10D,Race(7),,
3,7,0,2,9,1,4,8,13,2,4,1,7,10,8,11,29,12,12,0.0,M2018-06-10D,Race(7),,
4,5,3,3,11,6,7,3,16,9,6,3,18,20,16,9,45,7,7,0.0,M2018-06-10D,Race(7),,
5,13,2,2,17,10,4,4,18,10,6,4,20,33,12,10,55,3.2,3.2,2.0,M2018-06-10D,Race(7),,
6,0,0,0,0,0,0,0,0,0,0,0,0,0,0,0,0,101,101,0.0,M2018-06-10D,Race(7),,
7,2,5,6,13,1,8,5,14,0,0,7,7,3,13,18,34,11,11,1.0,M2018-06-10D,Race(7),,
8,0,13,0,13,1,3,3,7,1,3,4,8,2,19,7,28,6.5,6.5,0.0,M2018-06-10D,Race(7),,
9,0,0,0,0,0,0,1,1,0,0,0,0,0,0,1,1,21,21,0.0,M2018-06-10D,Race(7),,
10,3,4,13,20,8,2,4,14,1,1,5,7,12,7,22,41,5.5,5.5,0.0,M2018-06-10D,Race(7),,
11,0,0,0,0,0,0,0,0,0,0,0,0,0,0,0,0,26,26,0.0,M2018-06-10D,Race(7),,
12,0,0,0,0,0,0,0,0,0,0,1,1,0,0,1,1,16,16,0.0,M2018-06-10D,Race(7),,
13,0,0,0,0,0,0,0,0,0,0,0,0,0,0,0,0,15,15,3.0,M2018-06-10D,Race(7),,
14,0,0,0,0,0,0,0,0,0,0,0,0,0,0,0,0,151,151,0.0,M2018-06-10D,Race(7),,
1,6,15,5,26,11,5,4,20,11,4,7,22,28,24,16,68,2.8,2.8,3.0,M2018-06-10D,Race(8),,
2,0,10,3,13,9,3,6,18,2,4,5,11,11,17,14,42,7.5,7.5,0.0,M2018-06-10D,Race(8),,
3,8,0,3,11,6,6,5,17,7,4,8,19,21,10,16,47,4.8,4.8,2.0,M2018-06-10D,Race(8),,
4,0,0,3,3,0,8,9,17,0,2,4,6,0,10,16,26,19,19,0.0,M2018-06-10D,Race(8),,
5,0,0,6,6,0,0,0,0,0,1,0,1,0,1,6,7,11,11,0.0,M2018-06-10D,Race(8),,
6,0,0,0,0,0,0,0,0,0,0,0,0,0,0,0,0,101,101,0.0,M2018-06-10D,Race(8),,
7,14,5,8,27,4,8,6,18,5,10,2,17,23,23,16,62,3.4,3.4,1.0,M2018-06-10D,Race(8),,
8,2,0,2,4,0,0,0,0,0,1,0,1,2,1,2,5,26,26,0.0,M2018-06-10D,Race(8),,
9,0,0,0,0,0,0,0,0,0,0,0,0,0,0,0,0,31,31,0.0,M2018-06-10D,Race(8),,
10,0,0,0,0,0,0,0,0,1,0,0,1,1,0,0,1,19,19,0.0,M2018-06-10D,Race(8),,
11,0,0,0,0,0,0,0,0,0,0,0,0,0,0,0,0,34,35,0.0,M2018-06-10D,Race(8),,
1,21,2,7,30,19,2,2,23,21,1,2,24,61,5,11,77,2.3,2.3,0.0,M2018-06-10D,Race(9),,
2,4,16,8,28,2,6,6,14,1,9,4,14,7,31,18,56,4.6,4.6,3.0,M2018-06-10D,Race(9),,
3,0,0,0,0,0,0,0,0,0,0,0,0,0,0,0,0,41,41,0.0,M2018-06-10D,Race(9),,
4,0,0,0,0,0,0,0,0,0,0,0,0,0,0,0,0,21,21,0.0,M2018-06-10D,Race(9),,
5,0,0,0,0,0,0,0,0,1,0,0,1,1,0,0,1,21,21,0.0,M2018-06-10D,Race(9),,
6,0,0,0,0,0,0,0,0,0,1,0,1,0,1,0,1,26,26,0.0,M2018-06-10D,Race(9),,
7,0,0,0,0,8,3,1,12,1,3,1,5,9,6,2,17,13,13,2.0,M2018-06-10D,Race(9),,
8,0,0,0,0,0,0,0,0,0,0,2,2,0,0,2,2,51,51,0.0,M2018-06-10D,Race(9),,
9,0,0,0,0,0,0,8,8,0,0,0,0,0,0,8,8,34,34,0.0,M2018-06-10D,Race(9),,
10,5,7,6,18,0,10,4,14,0,6,7,13,5,23,17,45,5.5,5.5,1.0,M2018-06-10D,Race(9),,
11,0,3,9,12,1,9,7,17,1,6,7,14,2,18,23,43,9,9,0.0,M2018-06-10D,Race(9),,
12,0,2,0,2,0,0,2,2,1,0,3,4,1,2,5,8,15,15,0.0,M2018-06-10D,Race(9),,
1,18,8,4,30,22,5,2,29,15,6,4,25,55,19,10,84,2.6,2.6,1.0,M2018-06-13D,Race(1),,
2,0,3,7,10,3,3,3,9,3,4,2,9,6,10,12,28,7,7,0.0,M2018-06-13D,Race(1),,
3,0,3,0,3,0,12,4,16,1,3,5,9,1,18,9,28,12,12,0.0,M2018-06-13D,Race(1),,
4,3,12,8,23,4,6,16,26,4,7,7,18,11,25,31,67,3.7,3.7,2.0,M2018-06-13D,Race(1),,
5,0,0,0,0,0,0,0,0,1,1,1,3,1,1,1,3,26,26,0.0,M2018-06-13D,Race(1),,
6,0,4,5,9,0,1,0,1,0,0,2,2,0,5,7,12,11,11,0.0,M2018-06-13D,Race(1),,
7,5,0,0,5,0,3,2,5,1,3,2,6,6,6,4,16,16,16,0.0,M2018-06-13D,Race(1),,
8,2,0,3,5,1,0,2,3,1,1,3,5,4,1,8,13,17,17,0.0,M2018-06-13D,Race(1),,
9,0,0,0,0,0,0,1,1,0,0,0,0,0,0,1,1,41,41,0.0,M2018-06-13D,Race(1),,
10,0,0,0,0,0,0,0,0,0,1,0,1,0,1,0,1,41,41,0.0,M2018-06-13D,Race(1),,
11,0,0,3,3,0,0,0,0,0,0,0,0,0,0,3,3,16,16,3.0,M2018-06-13D,Race(1),,
12,2,0,0,2,0,0,0,0,0,0,0,0,2,0,0,2,19,19,0.0,M2018-06-13D,Race(1),,
1,7,14,6,27,19,4,4,27,12,5,4,21,38,23,14,75,3.3,3.3,0.0,M2018-06-13D,Race(2),,
2,4,11,7,22,4,12,7,23,4,2,4,10,12,25,18,55,7,7,2.0,M2018-06-13D,Race(2),,
3,6,0,4,10,1,3,2,6,2,3,2,7,9,6,8,23,6,6,0.0,M2018-06-13D,Race(2),,
4,0,0,3,3,0,2,0,2,0,1,1,2,0,3,4,7,13,13,0.0,M2018-06-13D,Race(2),,
5,3,3,6,12,0,0,0,0,0,0,0,0,3,3,6,12,7,7,1.0,M2018-06-13D,Race(2),,
6,0,0,0,0,0,0,1,1,0,1,2,3,0,1,3,4,21,21,0.0,M2018-06-13D,Race(2),,
7,0,0,2,2,1,0,0,1,1,0,2,3,2,0,4,6,21,21,0.0,M2018-06-13D,Race(2),,
8,8,0,2,10,3,2,3,8,4,2,4,10,15,4,9,28,7,7,0.0,M2018-06-13D,Race(2),,
9,0,0,0,0,0,0,0,0,0,1,0,1,0,1,0,1,34,35,0.0,M2018-06-13D,Race(2),,
10,2,0,0,2,0,4,0,4,2,4,2,8,4,8,2,14,15,15,0.0,M2018-06-13D,Race(2),,
11,0,2,0,2,0,0,1,1,0,2,0,2,0,4,1,5,21,21,0.0,M2018-06-13D,Race(2),,
12,0,0,0,0,0,0,0,0,0,0,0,0,0,0,0,0,17,17,3.0,M2018-06-13D,Race(2),,
1,3,0,0,3,1,0,1,2,1,0,2,3,5,0,3,8,14,14,0.0,M2018-06-13D,Race(3),,
2,2,2,2,6,0,13,4,17,0,5,2,7,2,20,8,30,8.5,8.5,0.0,M2018-06-13D,Race(3),,
3,16,12,2,30,20,2,3,25,15,4,2,21,51,18,7,76,3.4,3.4,3.0,M2018-06-13D,Race(3),,
4,3,3,0,6,0,0,0,0,0,0,0,0,3,3,0,6,14,14,0.0,M2018-06-13D,Race(3),,
5,0,3,2,5,4,6,2,12,3,6,4,13,7,15,8,30,5.5,5.5,0.0,M2018-06-13D,Race(3),,
6,4,3,6,13,1,1,3,5,0,1,4,5,5,5,13,23,7.5,7.5,0.0,M2018-06-13D,Race(3),,
7,0,0,0,0,0,0,0,0,0,0,0,0,0,0,0,0,101,101,0.0,M2018-06-13D,Race(3),,
8,0,7,8,15,1,3,12,16,4,2,5,11,5,12,25,42,7.5,7.5,1.0,M2018-06-13D,Race(3),,
9,0,0,0,0,0,0,0,0,0,0,0,0,0,0,0,0,21,21,2.0,M2018-06-13D,Race(3),,
10,0,0,3,3,0,0,0,0,0,0,0,0,0,0,3,3,17,17,0.0,M2018-06-13D,Race(3),,
11,0,0,2,2,1,0,5,6,0,3,4,7,1,3,11,15,16,16,0.0,M2018-06-13D,Race(3),,
12,2,0,5,7,2,5,0,7,3,5,3,11,7,10,8,25,8.5,8.5,0.0,M2018-06-13D,Race(3),,
1,3,2,4,9,3,6,10,19,4,8,2,14,10,16,16,42,13,13,0.0,M2018-06-13D,Race(4),,
2,7,5,2,14,2,14,3,19,2,4,4,10,11,23,9,43,4.4,4.4,0.0,M2018-06-13D,Race(4),,
3,2,0,0,2,0,0,0,0,0,2,0,2,2,2,0,4,31,31,0.0,M2018-06-13D,Race(4),,
4,2,11,4,17,3,5,6,14,7,6,5,18,12,22,15,49,8.5,8.5,0.0,M2018-06-13D,Race(4),,
5,14,5,2,21,18,3,4,25,12,2,5,19,44,10,11,65,3.1,3.1,1.0,M2018-06-13D,Race(4),,
6,0,0,0,0,0,0,0,0,0,0,0,0,0,0,0,0,41,41,0.0,M2018-06-13D,Race(4),,
7,0,0,0,0,0,0,1,1,0,0,0,0,0,0,1,1,34,35,0.0,M2018-06-13D,Race(4),,
8,0,0,0,0,0,0,0,0,0,0,0,0,0,0,0,0,34,35,2.0,M2018-06-13D,Race(4),,
9,2,5,6,13,1,2,4,7,0,3,6,9,3,10,16,29,6,6,0.0,M2018-06-13D,Race(4),,
10,0,0,9,9,1,0,2,3,0,1,4,5,1,1,15,17,15,15,0.0,M2018-06-13D,Race(4),,
11,0,0,0,0,0,0,0,0,0,0,0,0,0,0,0,0,41,41,0.0,M2018-06-13D,Race(4),,
12,0,2,3,5,2,0,0,2,1,0,0,1,3,2,3,8,5.5,5.5,3.0,M2018-06-13D,Race(4),,
1,0,16,2,18,6,14,2,22,9,8,0,17,15,38,4,57,5,5,0.0,M2018-06-13D,Race(5),,
2,0,0,0,0,0,0,0,0,0,0,1,1,0,0,1,1,34,35,0.0,M2018-06-13D,Race(5),,
3,7,7,5,19,3,5,10,18,2,4,6,12,12,16,21,49,3.8,3.8,3.0,M2018-06-13D,Race(5),,
4,3,0,2,5,2,2,2,6,1,3,2,6,6,5,6,17,9,9,0.0,M2018-06-13D,Race(5),,
5,2,0,0,2,1,0,1,2,3,2,1,6,6,2,2,10,13,13,0.0,M2018-06-13D,Race(5),,
6,11,0,3,14,2,3,5,10,2,2,8,12,15,5,16,36,5.5,5.5,2.0,M2018-06-13D,Race(5),,
7,0,0,12,12,14,1,4,19,5,2,1,8,19,3,17,39,9,9,0.0,M2018-06-13D,Race(5),,
8,0,0,0,0,0,0,0,0,0,0,0,0,0,0,0,0,26,26,0.0,M2018-06-13D,Race(5),,
9,0,0,0,0,0,0,0,0,0,0,0,0,0,0,0,0,21,21,0.0,M2018-06-13D,Race(5),,
10,2,5,0,7,0,1,1,2,1,2,1,4,3,8,2,13,11,11,1.0,M2018-06-13D,Race(5),,
11,2,2,0,4,1,2,3,6,1,0,2,3,4,4,5,13,17,17,0.0,M2018-06-13D,Race(5),,
12,3,0,6,9,1,2,2,5,2,3,4,9,6,5,12,23,11,11,0.0,M2018-06-13D,Race(5),,
1,2,0,0,2,0,3,1,4,1,3,1,5,3,6,2,11,12,12,0.0,M2018-06-13D,Race(6),,
2,0,2,3,5,2,0,2,4,2,1,3,6,4,3,8,15,16,16,0.0,M2018-06-13D,Race(6),,
3,5,4,0,9,0,1,0,1,2,2,1,5,7,7,1,15,12,12,0.0,M2018-06-13D,Race(6),,
4,2,3,7,12,4,1,10,15,6,3,4,13,12,7,21,40,9,9,0.0,M2018-06-13D,Race(6),,
5,4,10,8,22,15,3,3,21,4,2,5,11,23,15,16,54,4,4,0.0,M2018-06-13D,Race(6),,
6,0,3,4,7,1,3,4,8,1,2,2,5,2,8,10,20,12,12,1.0,M2018-06-13D,Race(6),,
7,6,0,0,6,1,2,2,5,2,1,0,3,9,3,2,14,12,12,0.0,M2018-06-13D,Race(6),,
8,3,3,3,9,0,1,2,3,3,3,6,12,6,7,11,24,5,5,3.0,M2018-06-13D,Race(6),,
9,3,5,2,10,5,14,3,22,4,6,1,11,12,25,6,43,7.5,7.5,0.0,M2018-06-13D,Race(6),,
10,5,0,3,8,2,2,3,7,1,3,2,6,8,5,8,21,10,10,2.0,M2018-06-13D,Race(6),,
11,0,0,0,0,0,0,0,0,0,0,0,0,0,0,0,0,21,21,0.0,M2018-06-13D,Race(6),,
12,0,0,0,0,0,0,0,0,0,0,1,1,0,0,1,1,16,16,0.0,M2018-06-13D,Race(6),,
1,0,11,6,17,2,15,6,23,1,5,9,15,3,31,21,55,8.5,8.5,0.0,M2018-06-13D,Race(7),,
2,0,3,5,8,1,0,2,3,0,2,1,3,1,5,8,14,17,17,0.0,M2018-06-13D,Race(7),,
3,28,0,0,28,25,4,0,29,23,2,0,25,76,6,0,82,1.3,1.3,1.0,M2018-06-13D,Race(7),,
4,0,0,0,0,0,0,0,0,0,0,0,0,0,0,0,0,51,51,2.0,M2018-06-13D,Race(7),,
5,0,3,7,10,1,3,13,17,0,6,2,8,1,12,22,35,10,10,0.0,M2018-06-13D,Race(7),,
6,0,0,5,5,0,0,0,0,0,1,0,1,0,1,5,6,51,51,0.0,M2018-06-13D,Race(7),,
7,0,0,0,0,0,0,0,0,0,0,0,0,0,0,0,0,81,81,0.0,M2018-06-13D,Race(7),,
8,2,6,2,10,1,4,6,11,2,6,9,17,5,16,17,38,12,12,0.0,M2018-06-13D,Race(7),,
9,0,0,0,0,0,0,0,0,0,0,0,0,0,0,0,0,81,81,0.0,M2018-06-13D,Race(7),,
10,0,0,0,0,0,1,0,1,0,1,0,1,0,2,0,2,71,71,3.0,M2018-06-13D,Race(7),,
11,0,7,5,12,0,0,3,3,0,1,3,4,0,8,11,19,21,21,0.0,M2018-06-13D,Race(7),,
12,0,0,0,0,0,0,0,0,0,0,0,0,0,0,0,0,51,51,0.0,M2018-06-13D,Race(7),,
1,10,9,9,28,20,6,1,27,16,4,1,21,46,19,11,76,5.5,5.5,1.0,M2018-06-13D,Race(8),,
2,3,3,2,8,1,1,4,6,1,2,2,5,5,6,8,19,13,13,0.0,M2018-06-13D,Race(8),,
3,0,0,0,0,0,0,0,0,0,0,0,0,0,0,0,0,21,21,0.0,M2018-06-13D,Race(8),,
4,3,4,8,15,3,4,13,20,3,6,1,10,9,14,22,45,5.5,5.5,0.0,M2018-06-13D,Race(8),,
5,0,0,0,0,1,1,0,2,1,2,1,4,2,3,1,6,34,34,0.0,M2018-06-13D,Race(8),,
6,0,0,0,0,0,0,0,0,0,0,0,0,0,0,0,0,31,31,0.0,M2018-06-13D,Race(8),,
7,0,7,9,16,2,1,2,5,1,3,6,10,3,11,17,31,8,8,0.0,M2018-06-13D,Race(8),,
8,7,3,0,10,2,15,4,21,2,7,7,16,11,25,11,47,3.8,3.8,0.0,M2018-06-13D,Race(8),,
9,5,4,0,9,0,0,1,1,1,0,3,4,6,4,4,14,9,9,3.0,M2018-06-13D,Race(8),,
10,0,0,0,0,0,0,0,0,0,0,0,0,0,0,0,0,34,34,0.0,M2018-06-13D,Race(8),,
11,0,0,2,2,0,1,3,4,0,1,4,5,0,2,9,11,13,13,0.0,M2018-06-13D,Race(8),,
12,2,0,0,2,1,1,2,4,1,1,1,3,4,2,3,9,7,7,2.0,M2018-06-13D,Race(8),,
1,0,15,0,15,2,5,9,16,4,9,10,23,6,29,19,54,5,5,0.0,M2018-06-16D,Race(1),,
2,23,5,2,30,16,10,4,30,19,1,3,23,58,16,9,83,1.9,1.9,0.0,M2018-06-16D,Race(1),,
3,0,0,0,0,0,0,0,0,0,0,0,0,0,0,0,0,101,101,0.0,M2018-06-16D,Race(1),,
4,0,0,0,0,0,0,0,0,0,0,0,0,0,0,0,0,101,101,0.0,M2018-06-16D,Race(1),,
5,7,5,5,17,9,4,5,18,1,6,3,10,17,15,13,45,6,6,3.0,M2018-06-16D,Race(1),,
6,0,3,20,23,3,11,4,18,2,10,8,20,5,24,32,61,5,5,1.0,M2018-06-16D,Race(1),,
7,-,-,-,0,0,0,0,0,0,0,0,0,,,,0,0,0,0.0,M2018-06-16D,Race(1),,
8,0,0,0,0,0,0,0,0,0,0,1,1,0,0,1,1,26,26,0.0,M2018-06-16D,Race(1),,
9,0,0,0,0,0,0,8,8,0,0,0,0,0,0,8,8,51,51,0.0,M2018-06-16D,Race(1),,
10,0,0,0,0,0,0,0,0,0,0,0,0,0,0,0,0,16,16,2.0,M2018-06-16D,Race(1),,
11,0,0,0,0,0,0,0,0,0,0,0,0,0,0,0,0,126,126,0.0,M2018-06-16D,Race(1),,
12,0,2,3,5,0,0,0,0,0,0,1,1,0,2,4,6,17,17,0.0,M2018-06-16D,Race(1),,
1,0,0,0,0,0,1,0,1,0,1,2,3,0,2,2,4,14,14,0.0,M2018-06-16D,Race(10),,
2,26,2,0,28,19,2,2,23,21,3,2,26,66,7,4,77,2,2,0.0,M2018-06-16D,Race(10),,
3,0,0,0,0,0,1,8,9,1,3,1,5,1,4,9,14,21,21,0.0,M2018-06-16D,Race(10),,
4,0,3,0,3,0,0,0,0,0,1,0,1,0,4,0,4,15,15,0.0,M2018-06-16D,Race(10),,
5,2,0,3,5,0,0,0,0,0,0,0,0,2,0,3,5,17,17,0.0,M2018-06-16D,Race(10),,
6,0,0,0,0,0,8,0,8,0,0,0,0,0,8,0,8,51,51,0.0,M2018-06-16D,Race(10),,
7,0,2,7,9,1,1,3,5,0,3,4,7,1,6,14,21,11,11,0.0,M2018-06-16D,Race(10),,
8,0,5,0,5,0,0,2,2,1,0,0,1,1,5,2,8,26,26,0.0,M2018-06-16D,Race(10),,
9,0,0,5,5,2,1,1,4,2,2,0,4,4,3,6,13,21,21,0.0,M2018-06-16D,Race(10),,
10,0,4,7,11,8,1,2,11,1,2,2,5,9,7,11,27,17,17,3.0,M2018-06-16D,Race(10),,
11,0,11,8,19,0,12,8,20,0,8,11,19,0,31,27,58,7,7,2.0,M2018-06-16D,Race(10),,
12,2,3,0,5,0,3,4,7,0,3,4,7,2,9,8,19,11,11,1.0,M2018-06-16D,Race(10),,
13,0,0,0,0,0,0,0,0,0,0,0,0,0,0,0,0,26,26,0.0,M2018-06-16D,Race(10),,
14,0,0,0,0,0,0,0,0,0,0,0,0,0,0,0,0,41,41,0.0,M2018-06-16D,Race(10),,
1,10,12,3,25,14,5,3,22,13,4,7,24,37,21,13,71,2.6,2.6,1.0,M2018-06-16D,Race(2),,
2,0,0,0,0,0,0,1,1,0,0,2,2,0,0,3,3,21,21,0.0,M2018-06-16D,Race(2),,
3,0,5,0,5,1,8,1,10,1,1,2,4,2,14,3,19,11,11,0.0,M2018-06-16D,Race(2),,
4,3,0,0,3,0,3,2,5,0,2,2,4,3,5,4,12,13,13,0.0,M2018-06-16D,Race(2),,
5,2,0,2,4,8,0,2,10,1,0,1,2,11,0,5,16,9,9,0.0,M2018-06-16D,Race(2),,
6,5,3,0,8,0,4,10,14,3,11,3,17,8,18,13,39,9,9,0.0,M2018-06-16D,Race(2),,
7,0,0,3,3,0,0,8,8,0,1,1,2,0,1,12,13,16,16,0.0,M2018-06-16D,Race(2),,
8,2,3,10,15,1,0,1,2,4,0,3,7,7,3,14,24,10,10,3.0,M2018-06-16D,Race(2),,
9,0,0,2,2,0,0,0,0,0,0,0,0,0,0,2,2,34,34,0.0,M2018-06-16D,Race(2),,
10,0,0,0,0,0,0,0,0,0,0,0,0,0,0,0,0,71,71,0.0,M2018-06-16D,Race(2),,
11,2,0,3,5,0,1,3,4,1,3,5,9,3,4,11,18,17,17,0.0,M2018-06-16D,Race(2),,
12,6,7,7,20,2,3,6,11,3,4,0,7,11,14,13,38,4.8,4.8,2.0,M2018-06-16D,Race(2),,
1,0,2,6,8,2,1,4,7,2,2,5,9,4,5,15,24,9,9,0.0,M2018-06-16D,Race(3),,
2,2,0,2,4,1,8,0,9,1,1,0,2,4,9,2,15,17,17,2.0,M2018-06-16D,Race(3),,
3,2,0,5,7,8,2,0,10,0,1,0,1,10,3,5,18,15,15,0.0,M2018-06-16D,Race(3),,
4,26,2,2,30,19,3,1,23,20,5,1,26,65,10,4,79,1.8,1.8,1.0,M2018-06-16D,Race(3),,
5,0,10,10,20,0,2,5,7,2,7,4,13,2,19,19,40,8,8,3.0,M2018-06-16D,Race(3),,
6,0,0,0,0,0,1,8,9,0,2,2,4,0,3,10,13,17,17,0.0,M2018-06-16D,Race(3),,
7,0,3,0,3,0,0,0,0,0,0,0,0,0,3,0,3,61,61,0.0,M2018-06-16D,Race(3),,
8,0,0,0,0,0,0,0,0,0,0,0,0,0,0,0,0,17,17,0.0,M2018-06-16D,Race(3),,
9,0,0,0,0,0,1,0,1,0,0,0,0,0,1,0,1,101,101,0.0,M2018-06-16D,Race(3),,
10,0,13,3,16,0,6,6,12,0,5,4,9,0,24,13,37,8,8,0.0,M2018-06-16D,Race(3),,
11,0,0,0,0,0,2,0,2,0,0,2,2,0,2,2,4,101,101,0.0,M2018-06-16D,Race(3),,
12,0,0,2,2,0,0,2,2,0,0,1,1,0,0,5,5,10,10,0.0,M2018-06-16D,Race(3),,
1,5,2,6,13,7,2,2,11,5,5,3,13,17,9,11,37,5,5,0.0,M2018-06-16D,Race(4),,
2,2,5,5,12,2,6,5,13,1,6,8,15,5,17,18,40,8,8,3.0,M2018-06-16D,Race(4),,
3,0,4,5,9,0,10,1,11,2,2,2,6,2,16,8,26,12,12,1.0,M2018-06-16D,Race(4),,
4,13,3,2,18,6,3,8,17,6,2,4,12,25,8,14,47,4.4,4.5,2.0,M2018-06-16D,Race(4),,
5,0,0,0,0,0,0,0,0,0,0,0,0,0,0,0,0,51,51,0.0,M2018-06-16D,Race(4),,
6,0,0,0,0,0,0,0,0,0,0,1,1,0,0,1,1,34,34,0.0,M2018-06-16D,Race(4),,
7,8,8,2,18,6,4,2,12,9,7,0,16,23,19,4,46,4.8,4.8,0.0,M2018-06-16D,Race(4),,
8,0,5,3,8,0,0,4,4,0,2,4,6,0,7,11,18,11,11,0.0,M2018-06-16D,Race(4),,
9,0,0,0,0,0,0,0,0,0,0,0,0,0,0,0,0,10,10,0.0,M2018-06-16D,Race(4),,
10,2,0,0,2,0,0,0,0,0,0,0,0,2,0,0,2,126,101,0.0,M2018-06-16D,Race(4),,
11,0,3,5,8,1,3,0,4,1,2,2,5,2,8,7,17,9,9,0.0,M2018-06-16D,Race(4),,
12,0,0,0,0,8,0,0,8,1,0,1,2,9,0,1,10,19,19,0.0,M2018-06-16D,Race(4),,
13,0,0,2,2,0,2,8,10,1,0,1,2,1,2,11,14,21,21,0.0,M2018-06-16D,Race(4),,
1,11,6,7,24,13,2,8,23,18,2,5,25,42,10,20,72,2.7,2.7,0.0,M2018-06-16D,Race(5),,
2,2,5,3,10,7,1,0,8,0,1,0,1,9,7,3,19,11,11,3.0,M2018-06-16D,Race(5),,
3,0,5,8,13,0,8,8,16,1,9,7,17,1,22,23,46,10,10,0.0,M2018-06-16D,Race(5),,
4,0,3,0,3,0,0,0,0,0,1,0,1,0,4,0,4,26,26,0.0,M2018-06-16D,Race(5),,
5,15,6,0,21,8,10,3,21,6,7,7,20,29,23,10,62,4.2,4.2,0.0,M2018-06-16D,Race(5),,
6,0,0,0,0,0,0,0,0,0,0,0,0,0,0,0,0,41,41,0.0,M2018-06-16D,Race(5),,
7,0,0,0,0,0,0,0,0,0,0,0,0,0,0,0,0,61,61,0.0,M2018-06-16D,Race(5),,
8,0,0,6,6,0,0,8,8,0,2,1,3,0,2,15,17,9,9,0.0,M2018-06-16D,Race(5),,
9,0,3,2,5,1,1,2,4,1,2,2,5,2,6,6,14,17,17,0.0,M2018-06-16D,Race(5),,
10,0,0,0,0,0,0,0,0,0,0,0,0,0,0,0,0,81,81,2.0,M2018-06-16D,Race(5),,
11,0,0,2,2,0,0,0,0,0,0,0,0,0,0,2,2,21,21,0.0,M2018-06-16D,Race(5),,
12,0,2,2,4,0,0,0,0,0,0,1,1,0,2,3,5,11,11,1.0,M2018-06-16D,Race(5),,
13,2,0,0,2,0,8,1,9,0,2,3,5,2,10,4,16,9.5,10,0.0,M2018-06-16D,Race(5),,
1,0,0,0,0,0,0,0,0,0,0,0,0,0,0,0,0,51,51,0.0,M2018-06-16D,Race(6),,
2,7,0,8,15,12,8,0,20,8,9,5,22,27,17,13,57,3.4,3.4,0.0,M2018-06-16D,Race(6),,
3,0,3,5,8,1,2,4,7,5,6,3,14,6,11,12,29,5,5,3.0,M2018-06-16D,Race(6),,
4,8,2,0,10,7,5,4,16,4,3,6,13,19,10,10,39,7.5,7.5,2.0,M2018-06-16D,Race(6),,
5,3,8,2,13,8,0,0,8,1,0,0,1,12,8,2,22,26,26,0.0,M2018-06-16D,Race(6),,
6,0,0,0,0,0,0,0,0,0,0,0,0,0,0,0,0,71,71,0.0,M2018-06-16D,Race(6),,
7,2,6,4,12,1,8,1,10,1,1,3,5,4,15,8,27,17,17,1.0,M2018-06-16D,Race(6),,
8,0,0,0,0,0,0,8,8,1,1,1,3,1,1,9,11,19,19,0.0,M2018-06-16D,Race(6),,
9,0,5,0,5,0,0,3,3,0,1,0,1,0,6,3,9,9,9,0.0,M2018-06-16D,Race(6),,
10,0,6,6,12,0,0,4,4,0,0,3,3,0,6,13,19,10,10,0.0,M2018-06-16D,Race(6),,
11,10,0,5,15,1,7,6,14,6,5,5,16,17,12,16,45,4.2,4.2,0.0,M2018-06-16D,Race(6),,
12,0,0,0,0,0,0,0,0,0,0,0,0,0,0,0,0,26,26,0.0,M2018-06-16D,Race(6),,
1,0,2,0,2,0,0,0,0,0,1,0,1,0,3,0,3,34,34,0.0,M2018-06-16D,Race(7),,
2,9,0,5,14,3,4,5,12,5,4,4,13,17,8,14,39,5,5,1.0,M2018-06-16D,Race(7),,
3,10,6,3,19,12,4,3,19,13,7,3,23,35,17,9,61,4.4,4.4,0.0,M2018-06-16D,Race(7),,
4,2,6,0,8,8,2,3,13,3,1,4,8,13,9,7,29,5,5,0.0,M2018-06-16D,Race(7),,
5,2,0,5,7,2,2,4,8,1,0,3,4,5,2,12,19,7,7,0.0,M2018-06-16D,Race(7),,
6,0,0,0,0,0,0,0,0,0,0,0,0,0,0,0,0,26,26,0.0,M2018-06-16D,Race(7),,
7,2,3,3,8,1,8,0,9,1,1,0,2,4,12,3,19,13,13,0.0,M2018-06-16D,Race(7),,
8,3,5,5,13,2,3,4,9,2,6,5,13,7,14,14,35,12,12,0.0,M2018-06-16D,Race(7),,
9,0,0,0,0,0,0,0,0,0,0,0,0,0,0,0,0,41,41,0.0,M2018-06-16D,Race(7),,
10,2,6,9,17,2,7,2,11,1,6,3,10,5,19,14,38,6,6,2.0,M2018-06-16D,Race(7),,
11,0,0,0,0,0,0,0,0,0,0,0,0,0,0,0,0,21,21,0.0,M2018-06-16D,Race(7),,
12,0,2,0,2,0,0,9,9,0,0,4,4,0,2,13,15,17,17,3.0,M2018-06-16D,Race(7),,
1,-,-,-,0,0,0,0,0,0,0,0,0,,,,0,0,0,0.0,M2018-06-16D,Race(8),,
2,5,2,0,7,0,1,0,1,0,1,0,1,5,4,0,9,15,15,0.0,M2018-06-16D,Race(8),,
3,17,6,3,26,13,7,0,20,13,9,2,24,43,22,5,70,2.3,2.3,1.0,M2018-06-16D,Race(8),,
4,3,13,8,24,5,7,3,15,4,6,7,17,12,26,18,56,5,5,0.0,M2018-06-16D,Race(8),,
5,0,2,0,2,0,2,2,4,1,2,3,6,1,6,5,12,26,26,0.0,M2018-06-16D,Race(8),,
6,3,0,6,9,0,1,2,3,0,3,1,4,3,4,9,16,10,10,0.0,M2018-06-16D,Race(8),,
7,0,0,0,0,0,0,0,0,0,1,0,1,0,1,0,1,51,51,3.0,M2018-06-16D,Race(8),,
8,0,0,2,2,0,0,0,0,0,0,0,0,0,0,2,2,41,41,0.0,M2018-06-16D,Race(8),,
9,0,2,0,2,0,0,8,8,0,0,3,3,0,2,11,13,17,17,0.0,M2018-06-16D,Race(8),,
10,2,5,9,16,3,2,5,10,3,2,3,8,8,9,17,34,5,5,2.0,M2018-06-16D,Race(8),,
11,0,0,2,2,1,8,1,10,1,0,1,2,2,8,4,14,6.5,6.5,0.0,M2018-06-16D,Race(8),,
1,0,3,8,11,2,3,1,6,0,3,2,5,2,9,11,22,14,14,0.0,M2018-06-16D,Race(9),,
2,10,2,10,22,9,3,5,17,15,2,2,19,34,7,17,58,5.5,5.5,0.0,M2018-06-16D,Race(9),,
3,12,11,2,25,7,11,3,21,8,11,2,21,27,33,7,67,2.3,2.3,1.0,M2018-06-16D,Race(9),,
4,0,2,0,2,8,1,1,10,1,0,1,2,9,3,2,14,14,14,0.0,M2018-06-16D,Race(9),,
5,0,0,0,0,0,8,0,8,0,1,1,2,0,9,1,10,26,26,0.0,M2018-06-16D,Race(9),,
6,3,0,0,3,0,0,0,0,0,0,0,0,3,0,0,3,21,21,0.0,M2018-06-16D,Race(9),,
7,0,7,10,17,0,0,8,8,0,1,1,2,0,8,19,27,10,10,0.0,M2018-06-16D,Race(9),,
8,0,0,0,0,0,2,3,5,0,1,3,4,0,3,6,9,26,26,0.0,M2018-06-16D,Race(9),,
9,0,0,0,0,0,0,0,0,0,0,0,0,0,0,0,0,21,21,0.0,M2018-06-16D,Race(9),,
10,5,5,0,10,3,1,7,11,1,2,11,14,9,8,18,35,7.5,7.5,0.0,M2018-06-16D,Race(9),,
11,0,0,0,0,0,0,0,0,0,0,0,0,0,0,0,0,81,81,0.0,M2018-06-16D,Race(9),,
12,0,0,0,0,1,1,2,4,1,5,3,9,2,6,5,13,12,12,3.0,M2018-06-16D,Race(9),,
13,0,0,0,0,0,0,0,0,0,0,0,0,0,0,0,0,26,26,2.0,M2018-06-16D,Race(9),,
1,4,8,14,26,5,5,6,16,6,7,4,17,15,20,24,59,4.4,4.5,0.0,M2018-06-24D,Race(1),,
2,24,4,0,28,12,7,3,22,12,6,2,20,48,17,5,70,3.5,3.5,2.0,M2018-06-24D,Race(1),,
3,0,0,0,0,0,2,1,3,0,2,1,3,0,4,2,6,17,17,0.0,M2018-06-24D,Race(1),,
4,0,2,2,4,0,0,0,0,2,0,0,2,2,2,2,6,21,21,0.0,M2018-06-24D,Race(1),,
5,0,3,6,9,0,8,4,12,2,4,8,14,2,15,18,35,10,10,0.0,M2018-06-24D,Race(1),,
6,0,0,0,0,8,0,0,8,0,0,0,0,8,0,0,8,26,26,0.0,M2018-06-24D,Race(1),,
7,0,11,8,19,5,8,6,19,4,7,8,19,9,26,22,57,2.8,2.8,1.0,M2018-06-24D,Race(1),,
8,0,0,0,0,0,0,0,0,0,0,0,0,0,0,0,0,26,26,0.0,M2018-06-24D,Race(1),,
9,2,0,0,2,0,0,0,0,0,0,0,0,2,0,0,2,21,21,3.0,M2018-06-24D,Race(1),,
10,0,2,0,2,0,0,2,2,0,0,2,2,0,2,4,6,12,12,0.0,M2018-06-24D,Race(1),,
11,0,0,0,0,0,0,8,8,0,0,1,1,0,0,9,9,51,51,0.0,M2018-06-24D,Race(1),,
1,0,0,0,0,0,0,0,0,0,0,0,0,0,0,0,0,41,41,0.0,M2018-06-24D,Race(10),,
2,27,3,0,30,22,1,0,23,24,2,0,26,73,6,0,79,2.3,2.3,3.0,M2018-06-24D,Race(10),,
3,0,0,2,2,0,8,0,8,0,1,0,1,0,9,2,11,26,26,0.0,M2018-06-24D,Race(10),,
4,0,0,0,0,0,1,8,9,0,1,1,2,0,2,9,11,31,31,0.0,M2018-06-24D,Race(10),,
5,0,3,0,3,0,0,0,0,0,0,0,0,0,3,0,3,26,26,0.0,M2018-06-24D,Race(10),,
6,0,2,2,4,0,0,0,0,0,0,0,0,0,2,2,4,26,26,0.0,M2018-06-24D,Race(10),,
7,0,0,0,0,0,0,0,0,0,0,0,0,0,0,0,0,17,17,0.0,M2018-06-24D,Race(10),,
8,0,0,3,3,0,0,0,0,0,0,0,0,0,0,3,3,15,15,0.0,M2018-06-24D,Race(10),,
9,0,13,8,21,0,17,3,20,1,17,4,22,1,47,15,63,6,6,2.0,M2018-06-24D,Race(10),,
10,0,0,0,0,0,0,0,0,0,0,0,0,0,0,0,0,101,101,0.0,M2018-06-24D,Race(10),,
11,0,2,2,4,0,0,3,3,0,0,4,4,0,2,9,11,17,17,0.0,M2018-06-24D,Race(10),,
12,0,0,0,0,0,0,0,0,0,0,0,0,0,0,0,0,151,151,0.0,M2018-06-24D,Race(10),,
13,0,0,5,5,8,0,5,13,1,0,5,6,9,0,15,24,8.5,8.5,0.0,M2018-06-24D,Race(10),,
14,3,7,8,18,0,3,10,13,0,5,12,17,3,15,30,48,4.8,4.8,1.0,M2018-06-24D,Race(10),,
1,3,5,6,14,10,5,5,20,13,3,3,19,26,13,14,53,7,7,0.0,M2018-06-24D,Race(2),,
2,3,0,2,5,0,2,0,2,0,2,0,2,3,4,2,9,14,14,0.0,M2018-06-24D,Race(2),,
3,7,10,5,22,8,6,4,18,7,8,3,18,22,24,12,58,3.3,3.3,0.0,M2018-06-24D,Race(2),,
4,0,2,0,2,0,8,1,9,0,0,1,1,0,10,2,12,21,21,0.0,M2018-06-24D,Race(2),,
5,0,6,0,6,0,1,3,4,2,3,5,10,2,10,8,20,8,8,2.0,M2018-06-24D,Race(2),,
6,2,0,0,2,0,0,1,1,0,0,2,2,2,0,3,5,12,12,0.0,M2018-06-24D,Race(2),,
7,7,2,9,18,0,2,3,5,0,4,6,10,7,8,18,33,6,6,0.0,M2018-06-24D,Race(2),,
8,6,5,2,13,0,0,0,0,0,0,0,0,6,5,2,13,7.5,7.5,3.0,M2018-06-24D,Race(2),,
9,0,0,0,0,0,0,0,0,0,0,0,0,0,0,0,0,151,151,0.0,M2018-06-24D,Race(2),,
10,0,0,3,3,0,0,8,8,0,0,0,0,0,0,11,11,26,26,1.0,M2018-06-24D,Race(2),,
11,0,0,0,0,0,0,0,0,0,0,0,0,0,0,0,0,31,31,0.0,M2018-06-24D,Race(2),,
12,0,0,0,0,1,0,0,1,2,0,1,3,3,0,1,4,19,19,0.0,M2018-06-24D,Race(2),,
13,0,0,3,3,0,0,0,0,0,0,0,0,0,0,3,3,21,21,0.0,M2018-06-24D,Race(2),,
14,2,0,0,2,8,0,0,8,0,0,1,1,10,0,1,11,21,21,0.0,M2018-06-24D,Race(2),,
1,11,10,5,26,13,5,4,22,17,7,2,26,41,22,11,74,2,2,1.0,M2018-06-24D,Race(3),,
2,7,11,8,26,5,11,3,19,4,10,6,20,16,32,17,65,3.8,3.8,2.0,M2018-06-24D,Race(3),,
3,4,0,5,9,4,3,6,13,5,6,3,14,13,9,14,36,6,6,3.0,M2018-06-24D,Race(3),,
4,0,4,5,9,0,3,9,12,0,1,2,3,0,8,16,24,8.5,8.5,0.0,M2018-06-24D,Race(3),,
5,8,5,5,18,0,8,5,13,0,1,4,5,8,14,14,36,7,7,0.0,M2018-06-24D,Race(3),,
6,0,0,2,2,8,0,3,11,0,1,9,10,8,1,14,23,15,15,0.0,M2018-06-24D,Race(3),,
7,0,0,0,0,0,0,0,0,0,0,0,0,0,0,0,0,34,34,0.0,M2018-06-24D,Race(3),,
8,0,0,0,0,0,0,0,0,0,0,0,0,0,0,0,0,101,101,0.0,M2018-06-24D,Race(3),,
1,13,5,10,28,13,3,4,20,15,3,4,22,41,11,18,70,3.2,3.2,0.0,M2018-06-24D,Race(4),,
2,9,2,10,21,5,11,3,19,3,12,4,19,17,25,17,59,4.2,4.2,3.0,M2018-06-24D,Race(4),,
3,2,3,0,5,1,9,4,14,2,1,5,8,5,13,9,27,6,6,1.0,M2018-06-24D,Race(4),,
4,2,0,0,2,1,0,0,1,2,0,1,3,5,0,1,6,11,11,0.0,M2018-06-24D,Race(4),,
5,0,0,2,2,0,0,8,8,1,0,1,2,1,0,11,12,34,34,0.0,M2018-06-24D,Race(4),,
6,0,0,3,3,0,4,7,11,0,3,1,4,0,7,11,18,16,16,0.0,M2018-06-24D,Race(4),,
7,0,0,0,0,0,0,0,0,0,0,0,0,0,0,0,0,34,34,0.0,M2018-06-24D,Race(4),,
8,0,0,0,0,0,0,0,0,0,1,0,1,0,1,0,1,21,21,0.0,M2018-06-24D,Race(4),,
9,0,2,5,7,0,0,0,0,1,0,1,2,1,2,6,9,14,14,0.0,M2018-06-24D,Race(4),,
10,2,16,0,18,2,3,3,8,2,6,6,14,6,25,9,40,8.5,8.5,0.0,M2018-06-24D,Race(4),,
11,0,2,0,2,0,0,0,0,0,0,0,0,0,2,0,2,26,26,0.0,M2018-06-24D,Race(4),,
12,2,0,0,2,8,0,1,9,0,0,3,3,10,0,4,14,11,11,2.0,M2018-06-24D,Race(4),,
1,15,2,8,25,12,5,3,20,13,5,3,21,40,12,14,66,3.8,3.8,0.0,M2018-06-24D,Race(5),,
2,2,0,0,2,0,1,8,9,1,0,2,3,3,1,10,14,13,13,0.0,M2018-06-24D,Race(5),,
3,8,16,2,26,7,7,7,21,6,9,9,24,21,32,18,71,3.6,3.6,0.0,M2018-06-24D,Race(5),,
4,0,0,0,0,0,0,0,0,0,0,0,0,0,0,0,0,26,27,0.0,M2018-06-24D,Race(5),,
5,0,0,0,0,0,0,0,0,0,0,0,0,0,0,0,0,26,27,3.0,M2018-06-24D,Race(5),,
6,0,0,0,0,0,0,0,0,0,0,0,0,0,0,0,0,71,67,0.0,M2018-06-24D,Race(5),,
7,0,2,5,7,0,8,2,10,0,1,1,2,0,11,8,19,13,13,0.0,M2018-06-24D,Race(5),,
8,0,10,11,21,3,5,9,17,5,8,6,19,8,23,26,57,3.8,3.8,1.0,M2018-06-24D,Race(5),,
9,0,0,0,0,0,0,0,0,0,0,0,0,0,0,0,0,101,101,0.0,M2018-06-24D,Race(5),,
10,0,0,0,0,0,0,0,0,0,0,0,0,0,0,0,0,101,101,0.0,M2018-06-24D,Race(5),,
11,0,0,0,0,0,0,0,0,0,0,1,1,0,0,1,1,101,101,0.0,M2018-06-24D,Race(5),,
12,5,0,2,7,8,3,1,12,1,2,3,6,14,5,6,25,7,7,2.0,M2018-06-24D,Race(5),,
13,0,0,0,0,0,0,0,0,0,0,1,1,0,0,1,1,51,51,0.0,M2018-06-24D,Race(5),,
14,0,0,2,2,0,1,0,1,0,1,0,1,0,2,2,4,19,19,0.0,M2018-06-24D,Race(5),,
1,8,6,4,18,2,1,5,8,3,2,5,10,13,9,14,36,4.2,4.2,0.0,M2018-06-24D,Race(6),,
2,0,0,0,0,0,0,0,0,0,0,0,0,0,0,0,0,31,31,0.0,M2018-06-24D,Race(6),,
3,0,0,0,0,0,8,2,10,0,1,2,3,0,9,4,13,31,31,0.0,M2018-06-24D,Race(6),,
4,0,0,0,0,0,0,0,0,0,0,0,0,0,0,0,0,31,31,0.0,M2018-06-24D,Race(6),,
5,16,12,0,28,14,4,1,19,13,3,3,19,43,19,4,66,2.6,2.6,0.0,M2018-06-24D,Race(6),,
6,2,2,6,10,0,7,5,12,1,5,5,11,3,14,16,33,7,7,1.0,M2018-06-24D,Race(6),,
7,0,2,10,12,8,2,5,15,4,3,6,13,12,7,21,40,11,11,0.0,M2018-06-24D,Race(6),,
8,0,0,0,0,0,0,0,0,0,0,0,0,0,0,0,0,31,31,0.0,M2018-06-24D,Race(6),,
9,0,0,0,0,0,0,0,0,0,0,0,0,0,0,0,0,61,61,0.0,M2018-06-24D,Race(6),,
10,2,2,0,4,0,1,1,2,0,2,2,4,2,5,3,10,19,19,2.0,M2018-06-24D,Race(6),,
11,2,6,7,15,5,6,3,14,5,8,2,15,12,20,12,44,5.5,5.5,3.0,M2018-06-24D,Race(6),,
12,0,0,3,3,1,1,8,10,0,2,1,3,1,3,12,16,16,16,0.0,M2018-06-24D,Race(6),,
1,13,5,6,24,17,10,2,29,11,10,2,23,41,25,10,76,2.4,2.4,0.0,M2018-06-24D,Race(7),,
2,0,3,0,3,0,0,9,9,0,0,3,3,0,3,12,15,10,10,3.0,M2018-06-24D,Race(7),,
3,11,10,2,23,13,6,3,22,14,9,2,25,38,25,7,70,3.4,3.4,0.0,M2018-06-24D,Race(7),,
4,3,0,10,13,0,8,4,12,0,2,4,6,3,10,18,31,7.5,7.5,2.0,M2018-06-24D,Race(7),,
5,0,2,3,5,0,0,2,2,0,0,5,5,0,2,10,12,16,16,0.0,M2018-06-24D,Race(7),,
6,0,2,5,7,0,4,0,4,0,2,0,2,0,8,5,13,11,11,0.0,M2018-06-24D,Race(7),,
7,3,8,4,15,0,2,10,12,1,3,10,14,4,13,24,41,6.5,6.5,1.0,M2018-06-24D,Race(7),,
8,0,0,0,0,0,0,0,0,0,0,0,0,0,0,0,0,19,19,0.0,M2018-06-24D,Race(7),,
1,12,5,5,22,10,7,4,21,13,5,3,21,35,17,12,64,4,4,2.0,M2018-06-24D,Race(8),,
2,0,0,0,0,0,0,0,0,0,0,0,0,0,0,0,0,19,19,0.0,M2018-06-24D,Race(8),,
3,0,9,5,14,2,9,7,18,9,6,4,19,11,24,16,51,4.4,4.5,3.0,M2018-06-24D,Race(8),,
4,6,4,7,17,2,3,2,7,1,7,8,16,9,14,17,40,4.4,4.5,0.0,M2018-06-24D,Race(8),,
5,0,0,0,0,0,0,0,0,0,0,0,0,0,0,0,0,34,35,0.0,M2018-06-24D,Race(8),,
6,2,0,2,4,8,0,0,8,1,2,2,5,11,2,4,17,21,21,0.0,M2018-06-24D,Race(8),,
7,0,0,0,0,0,0,0,0,0,0,0,0,0,0,0,0,71,67,0.0,M2018-06-24D,Race(8),,
8,4,6,0,10,1,8,4,13,1,2,2,5,6,16,6,28,21,21,0.0,M2018-06-24D,Race(8),,
9,0,0,0,0,0,0,0,0,0,0,0,0,0,0,0,0,26,26,0.0,M2018-06-24D,Race(8),,
10,6,4,2,12,7,3,5,15,1,4,4,9,14,11,11,36,4.8,4.8,0.0,M2018-06-24D,Race(8),,
11,0,2,0,2,0,0,0,0,0,0,0,0,0,2,0,2,51,51,0.0,M2018-06-24D,Race(8),,
12,0,0,0,0,0,0,0,0,0,0,0,0,0,0,0,0,71,67,0.0,M2018-06-24D,Race(8),,
13,0,0,9,9,0,0,8,8,0,0,3,3,0,0,20,20,18,18,1.0,M2018-06-24D,Race(8),,
14,0,0,0,0,0,0,0,0,0,0,0,0,0,0,0,0,14,14,0.0,M2018-06-24D,Race(8),,
1,3,2,9,14,0,3,4,7,1,2,5,8,4,7,18,29,6,6,1.0,M2018-06-24D,Race(9),,
2,0,12,7,19,12,12,5,29,5,14,3,22,17,38,15,70,4.6,4.6,2.0,M2018-06-24D,Race(9),,
3,2,0,0,2,0,0,0,0,0,0,1,1,2,0,1,3,15,14,0.0,M2018-06-24D,Race(9),,
4,0,0,0,0,0,0,0,0,0,0,0,0,0,0,0,0,71,67,0.0,M2018-06-24D,Race(9),,
5,0,0,2,2,0,0,1,1,0,0,1,1,0,0,4,4,26,26,0.0,M2018-06-24D,Race(9),,
6,23,5,0,28,18,5,0,23,20,5,0,25,61,15,0,76,2.15,2.1,0.0,M2018-06-24D,Race(9),,
7,0,0,0,0,0,0,0,0,0,1,0,1,0,1,0,1,17,16,0.0,M2018-06-24D,Race(9),,
8,0,0,5,5,0,8,8,16,0,3,9,12,0,11,22,33,19,18,0.0,M2018-06-24D,Race(9),,
9,0,3,0,3,0,0,0,0,0,0,2,2,0,3,2,5,19,19,0.0,M2018-06-24D,Race(9),,
10,0,0,0,0,0,0,0,0,0,0,0,0,0,0,0,0,34,35,0.0,M2018-06-24D,Race(9),,
11,0,8,4,12,0,2,4,6,0,1,1,2,0,11,9,20,12,18,0.0,M2018-06-24D,Race(9),,
12,2,0,3,5,0,0,8,8,0,0,4,4,2,0,15,17,17,17,3.0,M2018-06-24D,Race(9),,
1,0,0,5,5,3,0,4,7,7,4,3,14,10,4,12,26,9,9,0.0,M2018-06-27D,Race(1),,
2,0,0,0,0,0,0,0,0,0,0,0,0,0,0,0,0,41,41,0.0,M2018-06-27D,Race(1),,
3,22,8,0,30,19,4,2,25,12,6,3,21,53,18,5,76,2.8,2.8,1.0,M2018-06-27D,Race(1),,
4,3,6,5,14,2,13,5,20,2,6,9,17,7,25,19,51,6.5,6.5,0.0,M2018-06-27D,Race(1),,
5,0,0,2,2,0,0,0,0,0,1,0,1,0,1,2,3,51,51,0.0,M2018-06-27D,Race(1),,
6,0,0,0,0,0,0,0,0,0,0,0,0,0,0,0,0,21,21,0.0,M2018-06-27D,Race(1),,
7,3,0,6,9,0,0,1,1,1,0,2,3,4,0,9,13,10,10,3.0,M2018-06-27D,Race(1),,
8,0,8,2,10,0,3,2,5,0,2,3,5,0,13,7,20,10,10,0.0,M2018-06-27D,Race(1),,
9,0,0,3,3,0,2,8,10,0,3,3,6,0,5,14,19,15,15,0.0,M2018-06-27D,Race(1),,
10,2,0,0,2,0,1,0,1,0,0,0,0,2,1,0,3,7,7,0.0,M2018-06-27D,Race(1),,
11,0,8,5,13,2,3,4,9,4,4,3,11,6,15,12,33,6.5,6.5,0.0,M2018-06-27D,Race(1),,
12,0,0,2,2,0,0,0,0,0,0,0,0,0,0,2,2,34,34,2.0,M2018-06-27D,Race(1),,
1,0,0,0,0,1,0,0,1,0,0,0,0,1,0,0,1,17,17,0.0,M2018-06-27D,Race(2),,
2,0,2,5,7,3,3,2,8,3,3,2,8,6,8,9,23,6,6,0.0,M2018-06-27D,Race(2),,
3,0,0,0,0,0,0,0,0,0,0,0,0,0,0,0,0,71,67,0.0,M2018-06-27D,Race(2),,
4,19,2,6,27,20,8,2,30,16,7,2,25,55,17,10,82,2.4,2.4,0.0,M2018-06-27D,Race(2),,
5,2,0,3,5,0,0,1,1,1,3,2,6,3,3,6,12,21,21,0.0,M2018-06-27D,Race(2),,
6,6,11,5,22,3,5,16,24,3,4,6,13,12,20,27,59,4.8,4.8,1.0,M2018-06-27D,Race(2),,
7,0,0,0,0,0,0,0,0,0,1,1,2,0,1,1,2,51,51,0.0,M2018-06-27D,Race(2),,
8,0,12,8,20,3,13,7,23,2,8,7,17,5,33,22,60,5.5,5.5,0.0,M2018-06-27D,Race(2),,
9,3,0,3,6,0,1,1,2,0,0,1,1,3,1,5,9,21,21,0.0,M2018-06-27D,Race(2),,
10,0,3,0,3,0,0,1,1,1,0,5,6,1,3,6,10,9,9,2.0,M2018-06-27D,Race(2),,
11,0,0,0,0,0,0,0,0,0,0,0,0,0,0,0,0,41,41,3.0,M2018-06-27D,Race(2),,
12,0,0,0,0,0,0,0,0,0,0,0,0,0,0,0,0,151,151,0.0,M2018-06-27D,Race(2),,
1,4,11,5,20,3,14,6,23,4,6,5,15,11,31,16,58,5,5,0.0,M2018-06-27D,Race(3),,
2,7,9,5,21,18,6,6,30,11,9,2,22,36,24,13,73,6,6,0.0,M2018-06-27D,Race(3),,
3,0,0,3,3,0,0,0,0,0,0,0,0,0,0,3,3,34,34,0.0,M2018-06-27D,Race(3),,
4,3,0,0,3,0,0,1,1,2,0,1,3,5,0,2,7,8.5,8.5,3.0,M2018-06-27D,Race(3),,
5,0,0,0,0,0,0,0,0,0,0,2,2,0,0,2,2,10,10,0.0,M2018-06-27D,Race(3),,
6,5,2,0,7,0,0,0,0,0,0,0,0,5,2,0,7,19,19,0.0,M2018-06-27D,Race(3),,
7,5,4,13,22,8,9,10,27,7,7,8,22,20,20,31,71,3.4,3.4,0.0,M2018-06-27D,Race(3),,
8,0,0,0,0,1,1,3,5,1,2,3,6,2,3,6,11,17,17,0.0,M2018-06-27D,Race(3),,
9,0,0,0,0,0,0,0,0,0,0,0,0,0,0,0,0,13,13,2.0,M2018-06-27D,Race(3),,
10,6,2,4,12,0,0,3,3,1,2,5,8,7,4,12,23,9.5,9.5,1.0,M2018-06-27D,Race(3),,
11,0,2,0,2,0,0,1,1,0,0,0,0,0,2,1,3,13,13,0.0,M2018-06-27D,Race(3),,
12,0,0,0,0,0,0,0,0,0,0,0,0,0,0,0,0,34,34,0.0,M2018-06-27D,Race(3),,
1,6,7,2,15,4,8,3,15,5,3,4,12,15,18,9,42,5.5,5.5,0.0,M2018-06-27D,Race(4),,
2,13,8,9,30,18,6,2,26,10,6,4,20,41,20,15,76,3.6,3.6,2.0,M2018-06-27D,Race(4),,
3,3,3,2,8,0,3,13,16,0,2,4,6,3,8,19,30,7,7,0.0,M2018-06-27D,Race(4),,
4,0,6,3,9,3,4,5,12,2,3,2,7,5,13,10,28,10,10,3.0,M2018-06-27D,Race(4),,
5,0,2,0,2,0,0,0,0,1,2,1,4,1,4,1,6,12,12,0.0,M2018-06-27D,Race(4),,
6,0,2,0,2,0,0,0,0,3,0,2,5,3,2,2,7,10,10,0.0,M2018-06-27D,Race(4),,
7,2,0,3,5,1,0,1,2,4,1,2,7,7,1,6,14,8,8,0.0,M2018-06-27D,Race(4),,
8,2,0,0,2,3,0,0,3,0,1,0,1,5,1,0,6,19,19,0.0,M2018-06-27D,Race(4),,
9,2,2,11,15,0,0,1,1,0,4,3,7,2,6,15,23,8,8,1.0,M2018-06-27D,Race(4),,
10,0,0,0,0,0,2,1,3,1,4,2,7,1,6,3,10,19,19,0.0,M2018-06-27D,Race(4),,
11,2,0,0,2,1,4,3,8,0,0,2,2,3,4,5,12,26,26,0.0,M2018-06-27D,Race(4),,
12,0,0,0,0,0,1,1,2,0,0,0,0,0,1,1,2,41,41,0.0,M2018-06-27D,Race(4),,
1,20,10,0,30,17,10,1,28,11,8,2,21,48,28,3,79,2.3,2.3,1.0,M2018-06-27D,Race(5),,
2,0,2,5,7,0,1,16,17,1,2,6,9,1,5,27,33,12,12,3.0,M2018-06-27D,Race(5),,
3,0,0,0,0,0,0,1,1,0,0,1,1,0,0,2,2,15,15,0.0,M2018-06-27D,Race(5),,
4,4,5,11,20,7,9,6,22,8,4,6,18,19,18,23,60,4.8,4.8,2.0,M2018-06-27D,Race(5),,
5,0,2,3,5,0,0,0,0,0,1,0,1,0,3,3,6,17,17,0.0,M2018-06-27D,Race(5),,
6,0,3,2,5,0,1,1,2,0,2,1,3,0,6,4,10,17,17,0.0,M2018-06-27D,Race(5),,
7,6,2,9,17,6,8,3,17,6,8,7,21,18,18,19,55,4.8,4.8,0.0,M2018-06-27D,Race(5),,
8,0,0,0,0,0,0,0,0,0,0,0,0,0,0,0,0,12,12,0.0,M2018-06-27D,Race(5),,
9,0,6,0,6,0,1,2,3,0,1,3,4,0,8,5,13,9,9,0.0,M2018-06-27D,Race(5),,
1,3,12,8,23,5,19,3,27,6,11,4,21,14,42,15,71,8.5,8.5,3.0,M2018-06-27D,Race(6),,
2,13,10,2,25,24,6,0,30,17,6,2,25,54,22,4,80,2.8,2.8,0.0,M2018-06-27D,Race(6),,
3,4,0,3,7,0,0,1,1,0,1,2,3,4,1,6,11,13,13,0.0,M2018-06-27D,Race(6),,
4,0,0,0,0,0,0,0,0,0,0,2,2,0,0,2,2,71,67,0.0,M2018-06-27D,Race(6),,
5,2,3,7,12,0,3,13,16,0,4,4,8,2,10,24,36,7,7,2.0,M2018-06-27D,Race(6),,
6,5,0,8,13,0,1,6,7,1,1,4,6,6,2,18,26,6.5,6.5,0.0,M2018-06-27D,Race(6),,
7,0,2,0,2,0,0,2,2,0,1,2,3,0,3,4,7,26,26,1.0,M2018-06-27D,Race(6),,
8,0,3,2,5,1,1,3,5,1,1,5,7,2,5,10,17,5.5,5.5,0.0,M2018-06-27D,Race(6),,
9,0,0,0,0,0,0,0,0,0,0,0,0,0,0,0,0,41,41,0.0,M2018-06-27D,Race(6),,
10,3,0,0,3,0,0,2,2,1,0,1,2,4,0,3,7,9.5,9.5,0.0,M2018-06-27D,Race(6),,
11,0,0,0,0,0,0,0,0,0,0,0,0,0,0,0,0,34,34,0.0,M2018-06-27D,Race(6),,
12,0,0,0,0,0,0,0,0,0,1,0,1,0,1,0,1,17,17,0.0,M2018-06-27D,Race(6),,
1,0,0,0,0,0,0,0,0,0,1,0,1,0,1,0,1,41,41,0.0,M2018-06-27D,Race(7),,
2,13,6,2,21,8,14,4,26,14,6,1,21,35,26,7,68,4,4,0.0,M2018-06-27D,Race(7),,
3,2,8,4,14,16,9,2,27,6,10,5,21,24,27,11,62,6.5,6.5,0.0,M2018-06-27D,Race(7),,
4,0,0,0,0,0,1,0,1,0,0,0,0,0,1,0,1,71,67,0.0,M2018-06-27D,Race(7),,
5,3,2,3,8,0,0,0,0,0,0,1,1,3,2,4,9,11,11,0.0,M2018-06-27D,Race(7),,
6,6,3,5,14,2,2,3,7,2,2,3,7,10,7,11,28,5.5,5.5,3.0,M2018-06-27D,Race(7),,
7,0,0,0,0,0,0,0,0,0,0,0,0,0,0,0,0,71,67,0.0,M2018-06-27D,Race(7),,
8,0,3,5,8,1,1,3,5,1,2,3,6,2,6,11,19,8,8,2.0,M2018-06-27D,Race(7),,
9,2,0,5,7,1,1,2,4,1,1,3,5,4,2,10,16,7,7,0.0,M2018-06-27D,Race(7),,
10,2,4,6,12,2,1,14,17,2,4,9,15,6,9,29,44,5.5,5.5,1.0,M2018-06-27D,Race(7),,
11,0,2,0,2,0,0,2,2,0,0,1,1,0,2,3,5,11,10,0.0,M2018-06-27D,Race(7),,
12,2,2,0,4,0,1,0,1,0,0,0,0,2,3,0,5,21,21,0.0,M2018-06-27D,Race(7),,
1,0,0,0,0,0,0,0,0,0,0,0,0,0,0,0,0,9,9,0.0,M2018-06-27D,Race(8),,
2,0,0,0,0,0,0,0,0,1,0,0,1,1,0,0,1,71,67,0.0,M2018-06-27D,Race(8),,
3,0,3,0,3,0,0,0,0,1,0,0,1,1,3,0,4,34,34,0.0,M2018-06-27D,Race(8),,
4,0,0,0,0,0,0,0,0,0,1,1,2,0,1,1,2,9,9,0.0,M2018-06-27D,Race(8),,
5,5,0,0,5,0,1,3,4,0,0,4,4,5,1,7,13,15,15,3.0,M2018-06-27D,Race(8),,
6,10,8,4,22,5,19,5,29,5,12,5,22,20,39,14,73,4.4,4.5,1.0,M2018-06-27D,Race(8),,
7,0,0,7,7,1,1,4,6,0,2,4,6,1,3,15,19,9,9,2.0,M2018-06-27D,Race(8),,
8,10,2,6,18,1,2,12,15,2,2,7,11,13,6,25,44,9,9,0.0,M2018-06-27D,Race(8),,
9,0,4,0,4,0,0,0,0,0,0,0,0,0,4,0,4,41,41,0.0,M2018-06-27D,Race(8),,
10,0,11,0,11,1,0,2,3,0,1,2,3,1,12,4,17,6,6,0.0,M2018-06-27D,Race(8),,
11,0,0,0,0,0,0,0,0,0,0,0,0,0,0,0,0,21,21,0.0,M2018-06-27D,Race(8),,
12,5,2,13,20,0,2,2,4,0,2,2,4,5,6,17,28,3.5,3.6,0.0,M2018-06-27D,Race(8),,
1,13,10,7,30,13,5,5,23,13,4,3,20,39,19,15,73,2.9,3.2,0.0,M2018-07-01D,Race(1),,
2,0,0,0,0,0,0,0,0,1,0,0,1,1,0,0,1,51,51,0.0,M2018-07-01D,Race(1),,
3,5,4,3,12,8,3,3,14,3,3,1,7,16,10,7,33,8.5,8,0.0,M2018-07-01D,Race(1),,
4,0,3,7,10,3,2,3,8,2,1,5,8,5,6,15,26,8.5,8,0.0,M2018-07-01D,Race(1),,
5,0,0,0,0,0,0,0,0,0,1,0,1,0,1,0,1,71,67,2.0,M2018-07-01D,Race(1),,
6,0,0,0,0,0,0,0,0,0,0,0,0,0,0,0,0,41,41,0.0,M2018-07-01D,Race(1),,
7,3,6,2,11,3,3,1,7,2,6,1,9,8,15,4,27,8.5,8,0.0,M2018-07-01D,Race(1),,
8,0,0,5,5,2,3,3,8,3,4,4,11,5,7,12,24,6.5,6,0.0,M2018-07-01D,Race(1),,
9,0,4,3,7,0,8,1,9,0,0,1,1,0,12,5,17,26,26,1.0,M2018-07-01D,Race(1),,
10,0,0,0,0,0,0,0,0,0,0,0,0,0,0,0,0,51,51,3.0,M2018-07-01D,Race(1),,
11,5,3,0,8,1,6,5,12,2,5,8,15,8,14,13,35,6.5,5.5,0.0,M2018-07-01D,Race(1),,
12,2,0,0,2,0,0,8,8,0,0,0,0,2,0,8,10,12,12,0.0,M2018-07-01D,Race(1),,
13,0,0,0,0,0,0,1,1,0,1,1,2,0,1,2,3,19,21,0.0,M2018-07-01D,Race(1),,
14,2,0,3,5,0,0,0,0,0,0,1,1,2,0,4,6,26,26,0.0,M2018-07-01D,Race(1),,
1,2,7,6,15,6,5,1,12,2,4,1,7,10,16,8,34,8,8,1.0,M2018-07-01D,Race(10),,
2,0,0,0,0,0,0,0,0,0,0,0,0,0,0,0,0,15,15,0.0,M2018-07-01D,Race(10),,
3,2,0,5,7,8,2,4,14,3,2,6,11,13,4,15,32,6.5,6.5,0.0,M2018-07-01D,Race(10),,
4,0,0,0,0,0,0,0,0,0,0,0,0,0,0,0,0,34,34,0.0,M2018-07-01D,Race(10),,
5,17,8,3,28,14,3,2,19,19,4,1,24,50,15,6,71,3.2,3.2,0.0,M2018-07-01D,Race(10),,
6,6,0,7,13,2,5,7,14,2,4,9,15,10,9,23,42,10,10,0.0,M2018-07-01D,Race(10),,
7,0,0,0,0,0,0,0,0,0,0,0,0,0,0,0,0,34,34,0.0,M2018-07-01D,Race(10),,
8,0,3,0,3,0,4,3,7,0,4,4,8,0,11,7,18,9.5,9.5,0.0,M2018-07-01D,Race(10),,
9,0,0,0,0,0,0,0,0,0,0,0,0,0,0,0,0,71,67,3.0,M2018-07-01D,Race(10),,
10,0,0,0,0,0,2,3,5,0,0,1,1,0,2,4,6,12,12,2.0,M2018-07-01D,Race(10),,
11,3,6,9,18,0,9,2,11,0,6,2,8,3,21,13,37,8,8,0.0,M2018-07-01D,Race(10),,
12,0,2,0,2,0,0,0,0,0,1,0,1,0,3,0,3,13,13,0.0,M2018-07-01D,Race(10),,
13,0,0,0,0,0,0,0,0,0,0,0,0,0,0,0,0,71,67,0.0,M2018-07-01D,Race(10),,
14,0,4,0,4,0,0,8,8,0,1,2,3,0,5,10,15,19,19,0.0,M2018-07-01D,Race(10),,
1,0,5,3,8,0,0,0,0,1,2,2,5,1,7,5,13,9,9,0.0,M2018-07-01D,Race(2),,
2,9,7,12,28,5,7,13,25,3,9,8,20,17,23,33,73,3.4,3.4,1.0,M2018-07-01D,Race(2),,
3,9,13,2,24,11,6,5,22,15,4,7,26,35,23,14,72,3.6,3.6,3.0,M2018-07-01D,Race(2),,
4,0,0,0,0,0,0,0,0,0,0,1,1,0,0,1,1,101,101,0.0,M2018-07-01D,Race(2),,
5,0,0,0,0,0,0,0,0,0,0,0,0,0,0,0,0,101,101,0.0,M2018-07-01D,Race(2),,
6,0,0,0,0,0,8,0,8,0,0,1,1,0,8,1,9,26,26,0.0,M2018-07-01D,Race(2),,
7,2,0,0,2,8,4,3,15,2,5,2,9,12,9,5,26,7,7,0.0,M2018-07-01D,Race(2),,
8,10,5,13,28,6,5,6,17,5,6,5,16,21,16,24,61,2.8,2.8,2.0,M2018-07-01D,Race(2),,
9,0,0,0,0,0,0,0,0,0,0,0,0,0,0,0,0,101,101,0.0,M2018-07-01D,Race(2),,
10,0,0,0,0,0,0,0,0,0,0,0,0,0,0,0,0,26,26,0.0,M2018-07-01D,Race(2),,
11,0,0,0,0,0,0,0,0,0,0,0,0,0,0,0,0,101,101,0.0,M2018-07-01D,Race(2),,
12,0,0,0,0,0,0,0,0,0,0,0,0,0,0,0,0,0,0,0.0,M2018-07-01D,Race(2),,
13,0,0,0,0,0,0,0,0,0,0,0,0,0,0,0,0,0,0,0.0,M2018-07-01D,Race(2),,
14,0,0,0,0,0,0,0,0,0,0,0,0,0,0,0,0,0,0,0.0,M2018-07-01D,Race(2),,
1,6,5,9,20,4,7,1,12,7,7,3,17,17,19,13,49,7,7,0.0,M2018-07-01D,Race(3),,
2,7,5,6,18,10,2,1,13,2,4,2,8,19,11,9,39,8,8,1.0,M2018-07-01D,Race(3),,
3,5,0,0,5,0,2,2,4,0,4,3,7,5,6,5,16,8,8,0.0,M2018-07-01D,Race(3),,
4,0,0,9,9,3,8,1,12,0,2,0,2,3,10,10,23,7,7,2.0,M2018-07-01D,Race(3),,
5,6,3,2,11,6,5,4,15,9,2,6,17,21,10,12,43,4.2,4.2,0.0,M2018-07-01D,Race(3),,
6,0,0,0,0,0,0,2,2,0,0,2,2,0,0,4,4,15,15,0.0,M2018-07-01D,Race(3),,
7,3,0,0,3,0,0,8,8,0,2,2,4,3,2,10,15,10,10,0.0,M2018-07-01D,Race(3),,
8,3,15,4,22,7,6,6,19,6,5,3,14,16,26,13,55,4.8,4.8,3.0,M2018-07-01D,Race(3),,
9,0,2,0,2,0,0,5,5,2,0,5,7,2,2,10,14,7,7,0.0,M2018-07-01D,Race(3),,
10,0,0,0,0,0,0,0,0,0,0,0,0,0,0,0,0,0,0,0.0,M2018-07-01D,Race(3),,
11,0,0,0,0,0,0,0,0,0,0,0,0,0,0,0,0,0,0,0.0,M2018-07-01D,Race(3),,
12,0,0,0,0,0,0,0,0,0,0,0,0,0,0,0,0,0,0,0.0,M2018-07-01D,Race(3),,
13,0,0,0,0,0,0,0,0,0,0,0,0,0,0,0,0,0,0,0.0,M2018-07-01D,Race(3),,
14,0,0,0,0,0,0,0,0,0,0,0,0,0,0,0,0,0,0,0.0,M2018-07-01D,Race(3),,
1,5,12,0,17,4,6,3,13,4,5,3,12,13,23,6,42,4.2,4.2,0.0,M2018-07-01D,Race(4),,
2,10,11,7,28,14,1,2,17,19,1,0,20,43,13,9,65,4.2,4.2,0.0,M2018-07-01D,Race(4),,
3,6,3,8,17,0,6,5,11,1,5,7,13,7,14,20,41,6,6,0.0,M2018-07-01D,Race(4),,
4,0,0,5,5,0,1,0,1,0,1,0,1,0,2,5,7,17,17,1.0,M2018-07-01D,Race(4),,
5,4,0,3,7,3,3,3,9,1,8,6,15,8,11,12,31,7,7,2.0,M2018-07-01D,Race(4),,
6,0,0,0,0,0,0,0,0,0,0,0,0,0,0,0,0,34,34,0.0,M2018-07-01D,Race(4),,
7,2,0,3,5,1,0,9,10,0,0,2,2,3,0,14,17,19,19,0.0,M2018-07-01D,Race(4),,
8,0,0,4,4,8,2,5,15,0,3,4,7,8,5,13,26,8,8,0.0,M2018-07-01D,Race(4),,
9,0,0,0,0,0,0,0,0,0,0,0,0,0,0,0,0,101,101,0.0,M2018-07-01D,Race(4),,
10,0,2,0,2,0,3,3,6,1,2,4,7,1,7,7,15,9.5,9.5,3.0,M2018-07-01D,Race(4),,
11,0,0,0,0,0,0,0,0,0,1,0,1,0,1,0,1,34,34,0.0,M2018-07-01D,Race(4),,
12,0,0,0,0,0,0,0,0,0,0,0,0,0,0,0,0,51,51,0.0,M2018-07-01D,Race(4),,
13,0,0,0,0,0,0,0,0,0,0,0,0,0,0,0,0,71,67,0.0,M2018-07-01D,Race(4),,
14,3,2,0,5,0,8,0,8,0,0,0,0,3,10,0,13,15,15,0.0,M2018-07-01D,Race(4),,
1,0,0,0,0,0,0,2,2,1,0,2,3,1,0,4,5,26,26,0.0,M2018-07-01D,Race(5),,
2,16,10,0,26,21,1,1,23,20,5,1,26,57,16,2,75,3.5,3.5,0.0,M2018-07-01D,Race(5),,
3,2,6,2,10,0,5,5,10,1,5,4,10,3,16,11,30,10,10,0.0,M2018-07-01D,Race(5),,
4,2,8,3,13,0,10,2,12,0,2,5,7,2,20,10,32,9.5,9.5,0.0,M2018-07-01D,Race(5),,
5,0,2,0,2,0,0,0,0,0,0,1,1,0,2,1,3,26,26,0.0,M2018-07-01D,Race(5),,
6,3,0,10,13,8,2,5,15,2,3,3,8,13,5,18,36,6,6.5,0.0,M2018-07-01D,Race(5),,
7,0,0,0,0,0,0,0,0,0,1,0,1,0,1,0,1,34,34,3.0,M2018-07-01D,Race(5),,
8,5,0,9,14,0,0,2,2,0,1,4,5,5,1,15,21,8.5,8.5,0.0,M2018-07-01D,Race(5),,
9,0,0,0,0,0,0,0,0,0,0,0,0,0,0,0,0,34,34,0.0,M2018-07-01D,Race(5),,
10,2,0,3,5,0,0,8,8,0,1,2,3,2,1,13,16,11,11,0.0,M2018-07-01D,Race(5),,
11,0,4,3,7,1,12,4,17,2,8,2,12,3,24,9,36,4,4,1.0,M2018-07-01D,Race(5),,
12,0,0,0,0,0,0,1,1,0,0,1,1,0,0,2,2,81,81,0.0,M2018-07-01D,Race(5),,
13,0,0,0,0,0,0,0,0,0,0,1,1,0,0,1,1,71,67,2.0,M2018-07-01D,Race(5),,
14,0,0,0,0,0,0,0,0,0,0,0,0,0,0,0,0,41,41,0.0,M2018-07-01D,Race(5),,
1,8,3,11,22,11,4,3,18,8,8,1,17,27,15,15,57,4,4,0.0,M2018-07-01D,Race(6),,
2,0,0,0,0,0,0,1,1,0,0,2,2,0,0,3,3,21,21,0.0,M2018-07-01D,Race(6),,
3,0,0,0,0,0,0,0,0,0,1,1,2,0,1,1,2,26,26,1.0,M2018-07-01D,Race(6),,
4,2,2,0,4,10,1,2,13,4,1,1,6,16,4,3,23,19,19,0.0,M2018-07-01D,Race(6),,
5,0,2,0,2,0,2,1,3,1,0,1,2,1,4,2,7,26,26,0.0,M2018-07-01D,Race(6),,
6,5,11,6,22,3,3,5,11,0,4,2,6,8,18,13,39,3.2,3.2,3.0,M2018-07-01D,Race(6),,
7,8,6,6,20,2,3,4,9,5,3,8,16,15,12,18,45,6.5,6.5,0.0,M2018-07-01D,Race(6),,
8,2,6,3,11,0,8,3,11,0,1,8,9,2,15,14,31,7,7,2.0,M2018-07-01D,Race(6),,
9,0,0,0,0,0,0,8,8,0,0,1,1,0,0,9,9,12,12,0.0,M2018-07-01D,Race(6),,
10,5,0,2,7,4,9,3,16,8,8,1,17,17,17,6,40,10,10,0.0,M2018-07-01D,Race(6),,
11,0,0,0,0,0,0,0,0,0,0,0,0,0,0,0,0,101,101,0.0,M2018-07-01D,Race(6),,
12,0,0,0,0,0,0,0,0,0,0,0,0,0,0,0,0,101,101,0.0,M2018-07-01D,Race(6),,
13,0,0,2,2,0,0,0,0,0,0,0,0,0,0,2,2,19,19,0.0,M2018-07-01D,Race(6),,
14,0,0,0,0,0,0,0,0,0,0,0,0,0,0,0,0,101,101,0.0,M2018-07-01D,Race(6),,
1,0,0,0,0,0,0,0,0,0,0,0,0,0,0,0,0,71,67,0.0,M2018-07-01D,Race(7),,
2,0,3,4,7,0,5,3,8,1,4,4,9,1,12,11,24,8,8,0.0,M2018-07-01D,Race(7),,
3,0,0,0,0,0,0,0,0,0,0,0,0,0,0,0,0,0,0,0.0,M2018-07-01D,Race(7),,
4,2,0,0,2,0,0,0,0,0,0,0,0,2,0,0,2,15,15,1.0,M2018-07-01D,Race(7),,
5,3,0,0,3,0,9,1,10,1,1,2,4,4,10,3,17,19,19,0.0,M2018-07-01D,Race(7),,
6,0,0,0,0,0,0,8,8,0,0,1,1,0,0,9,9,51,51,0.0,M2018-07-01D,Race(7),,
7,2,0,0,2,0,0,0,0,0,0,1,1,2,0,1,3,21,21,2.0,M2018-07-01D,Race(7),,
8,0,2,0,2,0,0,1,1,0,1,3,4,0,3,4,7,9,9,0.0,M2018-07-01D,Race(7),,
9,15,10,5,30,13,6,3,22,14,6,4,24,42,22,12,76,2,2,0.0,M2018-07-01D,Race(7),,
10,0,3,16,19,0,5,7,12,0,7,5,12,0,15,28,43,8,8,3.0,M2018-07-01D,Race(7),,
11,0,0,0,0,0,0,0,0,0,0,0,0,0,0,0,0,71,67,0.0,M2018-07-01D,Race(7),,
12,8,12,5,25,17,5,7,29,10,7,6,23,35,24,18,77,6,6,0.0,M2018-07-01D,Race(7),,
13,0,0,0,0,0,0,0,0,0,0,0,0,0,0,0,0,41,41,0.0,M2018-07-01D,Race(7),,
14,0,0,0,0,0,0,0,0,0,0,0,0,0,0,0,0,41,41,0.0,M2018-07-01D,Race(7),,
1,13,12,3,28,13,8,2,23,16,8,2,26,42,28,7,77,2.4,2.4,1.0,M2018-07-01D,Race(8),,
2,0,3,3,6,0,0,0,0,0,0,1,1,0,3,4,7,19,19,0.0,M2018-07-01D,Race(8),,
3,0,0,8,8,0,3,4,7,0,4,2,6,0,7,14,21,15,15,0.0,M2018-07-01D,Race(8),,
4,0,2,7,9,0,8,8,16,0,1,7,8,0,11,22,33,6.5,6.5,2.0,M2018-07-01D,Race(8),,
5,0,2,0,2,0,0,0,0,0,0,0,0,0,2,0,2,26,26,0.0,M2018-07-01D,Race(8),,
6,0,0,0,0,0,0,8,8,0,0,3,3,0,0,11,11,34,34,0.0,M2018-07-01D,Race(8),,
7,0,0,0,0,0,0,0,0,0,1,0,1,0,1,0,1,101,101,0.0,M2018-07-01D,Race(8),,
8,0,0,2,2,0,0,0,0,0,0,1,1,0,0,3,3,21,21,0.0,M2018-07-01D,Race(8),,
9,2,0,0,2,8,0,1,9,0,2,2,4,10,2,3,15,21,21,0.0,M2018-07-01D,Race(8),,
10,0,0,0,0,0,0,0,0,0,0,0,0,0,0,0,0,41,41,0.0,M2018-07-01D,Race(8),,
11,0,6,5,11,1,3,3,7,0,0,4,4,1,9,12,22,12,12,0.0,M2018-07-01D,Race(8),,
12,0,0,0,0,0,0,0,0,0,1,0,1,0,1,0,1,81,81,0.0,M2018-07-01D,Race(8),,
13,15,5,2,22,8,8,4,20,10,9,4,23,33,22,10,65,3.4,3.4,3.0,M2018-07-01D,Race(8),,
14,0,0,0,0,0,0,0,0,0,0,0,0,0,0,0,0,71,67,0.0,M2018-07-01D,Race(8),,
1,0,2,0,2,1,1,2,4,0,1,2,3,1,4,4,9,21,21,0.0,M2018-07-01D,Race(9),,
2,7,8,0,15,6,3,5,14,10,4,5,19,23,15,10,48,7.5,7.5,0.0,M2018-07-01D,Race(9),,
3,0,5,0,5,1,2,0,3,1,0,0,1,2,7,0,9,17,17,0.0,M2018-07-01D,Race(9),,
4,3,0,4,7,0,0,2,2,1,1,1,3,4,1,7,12,10,10,2.0,M2018-07-01D,Race(9),,
5,0,0,0,0,0,0,0,0,0,1,0,1,0,1,0,1,51,51,1.0,M2018-07-01D,Race(9),,
6,2,0,0,2,2,0,1,3,1,1,2,4,5,1,3,9,15,15,0.0,M2018-07-01D,Race(9),,
7,0,2,3,5,0,0,0,0,0,1,0,1,0,3,3,6,12,12,0.0,M2018-07-01D,Race(9),,
8,0,5,3,8,1,0,8,9,1,0,3,4,2,5,14,21,12,12,0.0,M2018-07-01D,Race(9),,
9,3,0,8,11,0,3,5,8,1,4,4,9,4,7,17,28,6,6,0.0,M2018-07-01D,Race(9),,
10,4,0,0,4,0,8,1,9,0,1,1,2,4,9,2,15,15,15,0.0,M2018-07-01D,Race(9),,
11,11,5,9,25,11,9,3,23,11,10,4,25,33,24,16,73,3.4,3.4,0.0,M2018-07-01D,Race(9),,
12,0,0,3,3,0,2,3,5,0,2,3,5,0,4,9,13,13,13,0.0,M2018-07-01D,Race(9),,
13,0,0,0,0,0,0,0,0,0,0,0,0,0,0,0,0,51,51,0.0,M2018-07-01D,Race(9),,
14,0,3,0,3,8,2,0,10,0,0,1,1,8,5,1,14,12,12,3.0,M2018-07-01D,Race(9),,
1,7,3,5,15,14,4,3,21,4,6,3,13,25,13,11,49,6,6,3.0,M2018-07-04D,Race(1),,
2,2,12,3,17,2,4,3,9,5,1,5,11,9,17,11,37,6.5,6.5,0.0,M2018-07-04D,Race(1),,
3,5,0,3,8,1,1,2,4,2,1,0,3,8,2,5,15,8,8,1.0,M2018-07-04D,Race(1),,
4,0,0,0,0,1,1,0,2,1,1,0,2,2,2,0,4,18,17,0.0,M2018-07-04D,Race(1),,
5,2,0,2,4,0,0,1,1,0,0,2,2,2,0,5,7,21,21,0.0,M2018-07-04D,Race(1),,
6,2,0,3,5,3,13,3,19,3,2,3,8,8,15,9,32,21,21,0.0,M2018-07-04D,Race(1),,
7,0,4,3,7,1,0,4,5,1,2,5,8,2,6,12,20,10,10,0.0,M2018-07-04D,Race(1),,
8,0,5,2,7,0,2,0,2,0,3,0,3,0,10,2,12,10,10,0.0,M2018-07-04D,Race(1),,
9,0,0,0,0,1,1,2,4,2,3,4,9,3,4,6,13,7,7,0.0,M2018-07-04D,Race(1),,
10,6,6,6,18,7,4,10,21,8,7,1,16,21,17,17,55,4.4,4.5,2.0,M2018-07-04D,Race(1),,
11,6,0,3,9,0,0,2,2,0,0,2,2,6,0,7,13,9,9,0.0,M2018-07-04D,Race(1),,
12,0,0,0,0,0,0,0,0,0,0,1,1,0,0,1,1,26,26,0.0,M2018-07-04D,Race(1),,
1,3,2,3,8,2,1,2,5,1,2,1,4,6,5,6,17,13,13,0.0,M2018-07-04D,Race(2),,
2,0,2,0,2,0,1,0,1,0,2,0,2,0,5,0,5,17,17,0.0,M2018-07-04D,Race(2),,
3,0,0,0,0,0,0,0,0,0,0,0,0,0,0,0,0,34,34,0.0,M2018-07-04D,Race(2),,
4,5,6,0,11,3,5,12,20,6,8,4,18,14,19,16,49,8,8,0.0,M2018-07-04D,Race(2),,
5,6,0,3,9,1,1,3,5,1,4,4,9,8,5,10,23,8,8,1.0,M2018-07-04D,Race(2),,
6,0,0,0,0,0,0,0,0,0,1,1,2,0,1,1,2,71,71,0.0,M2018-07-04D,Race(2),,
7,0,18,7,25,16,6,6,28,10,3,8,21,26,27,21,74,3,3,2.0,M2018-07-04D,Race(2),,
8,0,0,5,5,0,0,0,0,0,0,1,1,0,0,6,6,15,15,0.0,M2018-07-04D,Race(2),,
9,14,2,5,21,6,14,5,25,7,3,6,16,27,19,16,62,3.7,3.8,3.0,M2018-07-04D,Race(2),,
10,2,0,0,2,0,1,0,1,0,2,0,2,2,3,0,5,21,21,0.0,M2018-07-04D,Race(2),,
11,0,0,7,7,2,1,2,5,1,1,1,3,3,2,10,15,8,8,0.0,M2018-07-04D,Race(2),,
12,0,0,0,0,0,0,0,0,0,0,0,0,0,0,0,0,81,81,0.0,M2018-07-04D,Race(2),,
1,2,2,13,17,16,2,2,20,9,0,1,10,27,4,16,47,7,6.5,2.0,M2018-07-04D,Race(3),,
2,0,4,0,4,0,1,2,3,0,1,6,7,0,6,8,14,10,10,0.0,M2018-07-04D,Race(3),,
3,0,0,0,0,0,0,0,0,0,0,0,0,0,0,0,0,26,26,0.0,M2018-07-04D,Race(3),,
4,0,5,0,5,3,4,3,10,1,4,5,10,4,13,8,25,9,9,0.0,M2018-07-04D,Race(3),,
5,5,0,3,8,1,2,0,3,1,5,1,7,7,7,4,18,9,9,0.0,M2018-07-04D,Race(3),,
6,7,6,5,18,6,16,4,26,7,8,2,17,20,30,11,61,5,5,1.0,M2018-07-04D,Race(3),,
7,0,0,0,0,0,0,1,1,0,1,2,3,0,1,3,4,26,26,0.0,M2018-07-04D,Race(3),,
8,7,6,6,19,3,3,11,17,5,3,4,12,15,12,21,48,5,5,0.0,M2018-07-04D,Race(3),,
9,0,0,0,0,0,0,0,0,0,0,0,0,0,0,0,0,51,51,3.0,M2018-07-04D,Race(3),,
10,0,0,0,0,1,1,2,4,2,1,2,5,3,2,4,9,26,26,0.0,M2018-07-04D,Race(3),,
11,9,5,3,17,0,1,5,6,1,3,3,7,10,9,11,30,4.2,4.2,0.0,M2018-07-04D,Race(3),,
12,0,2,0,2,0,0,0,0,0,0,0,0,0,2,0,2,19,19,0.0,M2018-07-04D,Race(3),,
1,0,2,5,7,0,16,4,20,2,7,3,12,2,25,12,39,8.5,8.5,0.0,M2018-07-04D,Race(4),,
2,0,0,0,0,0,0,0,0,0,0,0,0,0,0,0,0,11,11,2.0,M2018-07-04D,Race(4),,
3,0,0,0,0,0,0,1,1,0,0,1,1,0,0,2,2,21,21,0.0,M2018-07-04D,Race(4),,
4,0,0,0,0,0,0,2,2,0,0,2,2,0,0,4,4,21,21,0.0,M2018-07-04D,Race(4),,
5,0,11,7,18,2,3,3,8,0,5,4,9,2,19,14,35,3.7,3.8,0.0,M2018-07-04D,Race(4),,
6,18,7,3,28,26,2,0,28,20,2,1,23,64,11,4,79,3.5,3.5,1.0,M2018-07-04D,Race(4),,
7,0,0,0,0,0,0,0,0,0,1,0,1,0,1,0,1,101,101,0.0,M2018-07-04D,Race(4),,
8,5,2,10,17,1,5,13,19,1,6,8,15,7,13,31,51,9.5,9.5,0.0,M2018-07-04D,Race(4),,
9,0,0,0,0,0,0,0,0,0,0,0,0,0,0,0,0,21,21,0.0,M2018-07-04D,Race(4),,
10,3,0,0,3,1,1,1,3,0,2,3,5,4,3,4,11,17,17,3.0,M2018-07-04D,Race(4),,
11,4,8,5,17,0,1,1,2,1,1,2,4,5,10,8,23,5,5,0.0,M2018-07-04D,Race(4),,
12,0,0,0,0,0,0,0,0,0,0,0,0,0,0,0,0,71,67,0.0,M2018-07-04D,Race(4),,
1,0,0,0,0,0,1,0,1,0,1,0,1,0,2,0,2,34,34,1.0,M2018-07-04D,Race(5),,
2,2,0,5,7,4,3,2,9,2,2,3,7,8,5,10,23,7.5,7.5,3.0,M2018-07-04D,Race(5),,
3,0,0,5,5,1,0,1,2,1,0,3,4,2,0,9,11,7.5,7.5,0.0,M2018-07-04D,Race(5),,
4,0,0,0,0,0,0,0,0,0,0,1,1,0,0,1,1,15,15,0.0,M2018-07-04D,Race(5),,
5,3,0,0,3,0,1,0,1,2,2,0,4,5,3,0,8,10,10,0.0,M2018-07-04D,Race(5),,
6,0,0,0,0,0,0,1,1,0,0,0,0,0,0,1,1,5.5,5.5,0.0,M2018-07-04D,Race(5),,
7,13,12,2,27,4,3,12,19,6,3,4,13,23,18,18,59,5.5,6,0.0,M2018-07-04D,Race(5),,
8,9,11,5,25,16,6,5,27,8,7,5,20,33,24,15,72,4.6,4.6,2.0,M2018-07-04D,Race(5),,
9,0,4,5,9,0,1,0,1,1,1,0,2,1,6,5,12,13,13,0.0,M2018-07-04D,Race(5),,
10,3,3,6,12,3,1,3,7,2,2,4,8,8,6,13,27,7.5,7.5,0.0,M2018-07-04D,Race(5),,
11,0,0,0,0,2,14,6,22,4,7,6,17,6,21,12,39,0,0,0.0,M2018-07-04D,Race(5),,
12,0,0,2,2,0,0,0,0,0,1,0,1,0,1,2,3,26,26,0.0,M2018-07-04D,Race(5),,
1,0,0,0,0,0,2,7,9,2,4,5,11,2,6,12,20,15,15,0.0,M2018-07-04D,Race(6),,
2,7,7,10,24,20,6,1,27,16,5,0,21,43,18,11,72,3.6,3.5,2.0,M2018-07-04D,Race(6),,
3,2,0,5,7,1,1,2,4,1,1,1,3,4,2,8,14,13,13,3.0,M2018-07-04D,Race(6),,
4,0,0,0,0,0,0,0,0,0,0,0,0,0,0,0,0,15,15,0.0,M2018-07-04D,Race(6),,
5,0,0,0,0,0,0,1,1,0,1,2,3,0,1,3,4,26,26,0.0,M2018-07-04D,Race(6),,
6,0,0,0,0,0,0,0,0,0,0,0,0,0,0,0,0,26,26,0.0,M2018-07-04D,Race(6),,
7,2,0,0,2,2,0,0,2,1,0,1,2,5,0,1,6,19,19,0.0,M2018-07-04D,Race(6),,
8,0,0,0,0,0,0,0,0,0,1,0,1,0,1,0,1,81,81,0.0,M2018-07-04D,Race(6),,
9,0,0,0,0,0,0,0,0,0,1,0,1,0,1,0,1,71,67,0.0,M2018-07-04D,Race(6),,
10,7,11,0,18,2,3,14,19,1,4,12,17,10,18,26,54,7,7,0.0,M2018-07-04D,Race(6),,
11,9,7,5,21,4,14,3,21,5,3,3,11,18,24,11,53,3,3,1.0,M2018-07-04D,Race(6),,
12,3,5,10,18,1,4,2,7,0,6,2,8,4,15,14,33,6,6,0.0,M2018-07-04D,Race(6),,
1,8,10,2,20,4,15,7,26,7,4,9,20,19,29,18,66,3,3,2.0,M2018-07-04D,Race(7),,
2,10,5,0,15,18,3,3,24,11,6,2,19,39,14,5,58,6.5,6.5,0.0,M2018-07-04D,Race(7),,
3,5,0,10,15,2,3,2,7,2,1,2,5,9,4,14,27,5.5,5.5,3.0,M2018-07-04D,Race(7),,
4,2,8,0,10,0,1,13,14,1,3,6,10,3,12,19,34,7.5,7.5,1.0,M2018-07-04D,Race(7),,
5,0,0,0,0,0,0,0,0,0,0,0,0,0,0,0,0,41,41,0.0,M2018-07-04D,Race(7),,
6,0,0,3,3,0,1,0,1,0,2,0,2,0,3,3,6,17,17,0.0,M2018-07-04D,Race(7),,
7,0,3,2,5,1,2,0,3,3,5,1,9,4,10,3,17,6.5,6.5,0.0,M2018-07-04D,Race(7),,
8,0,0,0,0,0,0,0,0,0,0,0,0,0,0,0,0,26,26,0.0,M2018-07-04D,Race(7),,
9,3,2,7,12,5,5,4,14,2,5,4,11,10,12,15,37,0,0,0.0,M2018-07-04D,Race(7),,
10,2,2,0,4,0,0,0,0,0,0,0,0,2,2,0,4,11,11,0.0,M2018-07-04D,Race(7),,
11,0,0,6,6,0,0,1,1,0,0,2,2,0,0,9,9,11,11,0.0,M2018-07-04D,Race(7),,
12,0,0,0,0,0,0,0,0,0,0,0,0,0,0,0,0,31,31,0.0,M2018-07-04D,Race(7),,
1,2,8,4,14,1,6,10,17,3,2,3,8,6,16,17,39,3.6,3.6,0.0,M2018-07-04D,Race(8),,
2,12,0,4,16,2,1,3,6,2,2,3,7,16,3,10,29,6,6,0.0,M2018-07-04D,Race(8),,
3,0,3,3,6,0,0,1,1,0,1,1,2,0,4,5,9,13,13,0.0,M2018-07-04D,Race(8),,
4,0,0,0,0,0,2,0,2,0,2,1,3,0,4,1,5,13,13,0.0,M2018-07-04D,Race(8),,
5,0,0,0,0,0,0,1,1,0,0,1,1,0,0,2,2,41,41,0.0,M2018-07-04D,Race(8),,
6,0,2,0,2,0,0,0,0,0,0,0,0,0,2,0,2,51,51,3.0,M2018-07-04D,Race(8),,
7,5,2,2,9,3,1,4,8,8,1,4,13,16,4,10,30,8.5,8.5,2.0,M2018-07-04D,Race(8),,
8,4,6,0,10,6,11,4,21,6,6,5,17,16,23,9,48,5,5,0.0,M2018-07-04D,Race(8),,
9,2,4,11,17,18,6,3,27,7,7,5,19,27,17,19,63,8.5,8.5,0.0,M2018-07-04D,Race(8),,
10,0,2,0,2,0,0,2,2,0,0,2,2,0,2,4,6,15,15,0.0,M2018-07-04D,Race(8),,
11,3,3,0,6,0,1,0,1,0,2,0,2,3,6,0,9,12,12,1.0,M2018-07-04D,Race(8),,
12,2,0,6,8,0,2,2,4,0,3,1,4,2,5,9,16,13,13,0.0,M2018-07-04D,Race(8),,
1,0,0,2,2,0,2,1,3,0,1,4,5,0,3,7,10,15,15,0.0,M2018-07-08D,Race(1),,
2,0,0,0,0,0,0,0,0,1,0,0,1,1,0,0,1,15,15,0.0,M2018-07-08D,Race(1),,
3,0,0,0,0,0,0,0,0,0,0,0,0,0,0,0,0,15,15,2.0,M2018-07-08D,Race(1),,
4,0,0,0,0,0,0,0,0,0,0,0,0,0,0,0,0,26,27,0.0,M2018-07-08D,Race(1),,
5,0,0,2,2,0,1,8,9,2,1,1,4,2,2,11,15,34,35,0.0,M2018-07-08D,Race(1),,
6,2,13,8,23,8,12,7,27,3,4,13,20,13,29,28,70,5,5,3.0,M2018-07-08D,Race(1),,
7,4,3,13,20,3,3,12,18,3,4,4,11,10,10,29,49,4.8,4.8,1.0,M2018-07-08D,Race(1),,
8,19,9,2,30,19,3,1,23,15,11,0,26,53,23,3,79,2.6,2.6,0.0,M2018-07-08D,Race(1),,
9,0,0,0,0,0,0,0,0,0,0,0,0,0,0,0,0,0,0,0.0,M2018-07-08D,Race(1),,
10,0,0,0,0,0,0,0,0,0,0,0,0,0,0,0,0,21,21,0.0,M2018-07-08D,Race(1),,
11,0,0,0,0,0,0,0,0,0,0,0,0,0,0,0,0,34,35,0.0,M2018-07-08D,Race(1),,
12,5,5,3,13,0,9,1,10,2,5,5,12,7,19,9,35,6,6,0.0,M2018-07-08D,Race(1),,
1,0,0,0,0,0,0,0,0,0,0,0,0,0,0,0,0,34,35,0.0,M2018-07-08D,Race(10),,
2,0,0,0,0,7,0,0,7,1,0,0,1,8,0,0,8,41,41,0.0,M2018-07-08D,Race(10),,
3,12,5,9,26,8,11,4,23,9,6,7,22,29,22,20,71,3.5,3.5,2.0,M2018-07-08D,Race(10),,
4,0,0,0,0,0,0,0,0,0,1,0,1,0,1,0,1,17,17,0.0,M2018-07-08D,Race(10),,
5,7,11,7,25,7,6,8,21,4,8,8,20,18,25,23,66,3.5,3.5,1.0,M2018-07-08D,Race(10),,
6,7,4,9,20,8,5,7,20,9,8,6,23,24,17,22,63,5,5,0.0,M2018-07-08D,Race(10),,
7,0,0,0,0,0,0,0,0,0,0,0,0,0,0,0,0,26,26,0.0,M2018-07-08D,Race(10),,
8,2,0,0,2,0,8,1,9,0,2,2,4,2,10,3,15,7,7,0.0,M2018-07-08D,Race(10),,
9,2,8,3,13,0,0,2,2,3,1,2,6,5,9,7,21,11,11,0.0,M2018-07-08D,Race(10),,
10,0,2,0,2,0,0,8,8,0,0,1,1,0,2,9,11,15,15,0.0,M2018-07-08D,Race(10),,
11,0,0,2,2,0,0,0,0,0,0,0,0,0,0,2,2,26,26,3.0,M2018-07-08D,Race(10),,
12,0,0,0,0,0,0,0,0,0,0,0,0,0,0,0,0,34,35,0.0,M2018-07-08D,Race(10),,
1,0,0,3,3,2,2,3,7,1,3,3,7,3,5,9,17,0,8.5,2.0,M2018-07-08D,Race(11),,
2,0,0,0,0,0,0,1,1,1,0,1,2,1,0,2,3,0,21,0.0,M2018-07-08D,Race(11),,
3,0,5,0,5,2,3,4,9,1,1,3,5,3,9,7,19,0,19,0.0,M2018-07-08D,Race(11),,
4,5,3,2,10,1,0,4,5,2,5,5,12,8,8,11,27,0,13,0.0,M2018-07-08D,Race(11),,
5,3,5,14,22,4,4,3,11,5,4,5,14,12,13,22,47,0,5,0.0,M2018-07-08D,Race(11),,
6,18,5,0,23,9,7,1,17,10,7,2,19,37,19,3,59,0,5,0.0,M2018-07-08D,Race(11),,
7,0,0,0,0,0,0,0,0,0,0,1,1,0,0,1,1,0,26,0.0,M2018-07-08D,Race(11),,
8,0,7,0,7,4,2,3,9,3,0,4,7,7,9,7,23,0,6.5,0.0,M2018-07-08D,Race(11),,
9,0,0,0,0,0,0,0,0,0,0,0,0,0,0,0,0,0,51,0.0,M2018-07-08D,Race(11),,
10,0,2,2,4,0,8,2,10,0,1,1,2,0,11,5,16,0,12,3.0,M2018-07-08D,Race(11),,
11,0,0,0,0,0,0,0,0,0,0,0,0,0,0,0,0,0,26,1.0,M2018-07-08D,Race(11),,
12,0,0,0,0,0,0,0,0,0,0,0,0,0,0,0,0,0,26,0.0,M2018-07-08D,Race(11),,
13,2,3,5,10,0,4,8,12,3,4,1,8,5,11,14,30,0,8.5,0.0,M2018-07-08D,Race(11),,
14,2,0,4,6,8,0,1,9,0,1,0,1,10,1,5,16,0,9,0.0,M2018-07-08D,Race(11),,
1,2,0,2,4,8,0,0,8,0,0,0,0,10,0,2,12,13,13,0.0,M2018-07-08D,Race(2),,
2,5,6,6,17,1,8,5,14,0,1,3,4,6,15,14,35,6.5,6.5,3.0,M2018-07-08D,Race(2),,
3,3,5,2,10,3,0,4,7,5,3,5,13,11,8,11,30,11,11,0.0,M2018-07-08D,Race(2),,
4,0,4,2,6,4,2,8,14,2,3,1,6,6,9,11,26,5.5,5.5,0.0,M2018-07-08D,Race(2),,
5,0,0,0,0,0,0,0,0,0,0,0,0,0,0,0,0,41,41,0.0,M2018-07-08D,Race(2),,
6,0,5,7,12,3,13,2,18,5,10,4,19,8,28,13,49,6.5,6.5,0.0,M2018-07-08D,Race(2),,
7,0,3,3,6,1,0,0,1,1,0,0,1,2,3,3,8,17,17,0.0,M2018-07-08D,Race(2),,
8,0,0,0,0,0,0,0,0,0,0,0,0,0,0,0,0,34,35,0.0,M2018-07-08D,Race(2),,
9,4,5,0,9,2,2,5,9,3,4,5,12,9,11,10,30,9,9,0.0,M2018-07-08D,Race(2),,
10,16,2,8,26,8,5,6,19,10,5,5,20,34,12,19,65,3,3,1.0,M2018-07-08D,Race(2),,
11,0,0,0,0,0,0,0,0,0,0,0,0,0,0,0,0,19,19,2.0,M2018-07-08D,Race(2),,
12,0,0,0,0,0,0,0,0,0,0,3,3,0,0,3,3,41,41,0.0,M2018-07-08D,Race(2),,
1,19,3,0,22,9,8,3,20,11,6,3,20,39,17,6,62,3.6,3.6,1.0,M2018-07-08D,Race(3),,
2,0,4,3,7,2,3,2,7,4,3,2,9,6,10,7,23,26,26,0.0,M2018-07-08D,Race(3),,
3,0,0,2,2,0,0,8,8,0,0,1,1,0,0,11,11,26,26,0.0,M2018-07-08D,Race(3),,
4,9,4,6,19,0,1,4,5,0,4,4,8,9,9,14,32,7,7,0.0,M2018-07-08D,Race(3),,
5,0,0,0,0,0,0,0,0,0,0,1,1,0,0,1,1,21,21,0.0,M2018-07-08D,Race(3),,
6,0,0,0,0,0,8,0,8,0,0,0,0,0,8,0,8,13,13,0.0,M2018-07-08D,Race(3),,
7,0,2,5,7,2,2,3,7,1,2,3,6,3,6,11,20,9.5,9.5,2.0,M2018-07-08D,Race(3),,
8,0,0,2,2,1,0,4,5,2,0,2,4,3,0,8,11,15,15,3.0,M2018-07-08D,Race(3),,
9,0,0,0,0,8,0,1,9,1,0,2,3,9,0,3,12,7,7,0.0,M2018-07-08D,Race(3),,
10,0,3,5,8,0,2,1,3,2,3,4,9,2,8,10,20,11,11,0.0,M2018-07-08D,Race(3),,
11,2,3,0,5,1,1,3,5,0,2,2,4,3,6,5,14,26,26,0.0,M2018-07-08D,Race(3),,
12,0,9,7,16,7,5,1,13,5,6,1,12,12,20,9,41,7,7,0.0,M2018-07-08D,Race(3),,
13,0,0,0,0,0,0,0,0,0,0,0,0,0,0,0,0,51,51,0.0,M2018-07-08D,Race(3),,
14,0,2,0,2,0,0,0,0,0,0,1,1,0,2,1,3,15,15,0.0,M2018-07-08D,Race(3),,
1,3,12,10,25,6,5,6,17,7,10,4,21,16,27,20,63,5,5,0.0,M2018-07-08D,Race(4),,
2,0,5,10,15,1,8,10,19,2,7,11,20,3,20,31,54,4.6,4.6,2.0,M2018-07-08D,Race(4),,
3,2,0,0,2,1,10,4,15,2,3,6,11,5,13,10,28,9,9,0.0,M2018-07-08D,Race(4),,
4,25,0,5,30,14,6,2,22,15,5,3,23,54,11,10,75,1.85,1.85,1.0,M2018-07-08D,Race(4),,
5,0,3,5,8,0,1,8,9,0,0,1,1,0,4,14,18,21,21,0.0,M2018-07-08D,Race(4),,
6,0,3,0,3,0,0,0,0,0,0,0,0,0,3,0,3,21,21,0.0,M2018-07-08D,Race(4),,
7,0,0,0,0,0,0,0,0,0,0,0,0,0,0,0,0,21,21,0.0,M2018-07-08D,Race(4),,
8,0,7,0,7,8,0,0,8,0,1,1,2,8,8,1,17,12,12,3.0,M2018-07-08D,Race(4),,
1,0,5,2,7,6,2,2,10,5,3,3,11,11,10,7,28,8.5,8.5,3.0,M2018-07-08D,Race(5),,
2,3,0,2,5,8,1,0,9,3,1,1,5,14,2,3,19,7.5,7.5,0.0,M2018-07-08D,Race(5),,
3,2,2,0,4,1,8,4,13,1,4,4,9,4,14,8,26,13,13,0.0,M2018-07-08D,Race(5),,
4,9,8,6,23,8,5,6,19,6,4,4,14,23,17,16,56,5,5,0.0,M2018-07-08D,Race(5),,
5,0,0,0,0,0,0,0,0,0,0,0,0,0,0,0,0,51,51,0.0,M2018-07-08D,Race(5),,
6,0,0,0,0,0,0,0,0,0,1,0,1,0,1,0,1,51,51,0.0,M2018-07-08D,Race(5),,
7,11,4,13,28,3,9,6,18,6,6,8,20,20,19,27,66,3,3,1.0,M2018-07-08D,Race(5),,
8,5,9,7,21,4,5,4,13,4,7,3,14,13,21,14,48,5,5,0.0,M2018-07-08D,Race(5),,
9,0,0,0,0,0,0,0,0,0,0,0,0,0,0,0,0,71,67,0.0,M2018-07-08D,Race(5),,
10,0,2,0,2,0,0,0,0,1,0,1,2,1,2,1,4,11,11,2.0,M2018-07-08D,Race(5),,
11,0,0,0,0,0,0,8,8,0,0,2,2,0,0,10,10,19,19,0.0,M2018-07-08D,Race(5),,
12,0,0,0,0,0,0,0,0,0,0,0,0,0,0,0,0,26,26,0.0,M2018-07-08D,Race(5),,
1,18,5,3,26,8,9,4,21,8,11,4,23,34,25,11,70,3,3,1.0,M2018-07-08D,Race(6),,
2,8,8,3,19,13,5,4,22,16,5,3,24,37,18,10,65,4.8,4.8,0.0,M2018-07-08D,Race(6),,
3,0,2,0,2,0,0,2,2,1,0,2,3,1,2,4,7,8.5,8.5,0.0,M2018-07-08D,Race(6),,
4,0,11,12,23,9,9,10,28,1,8,10,19,10,28,32,70,6.5,6.5,2.0,M2018-07-08D,Race(6),,
5,0,0,0,0,0,0,0,0,0,0,0,0,0,0,0,0,21,21,0.0,M2018-07-08D,Race(6),,
6,0,0,3,3,0,0,0,0,0,0,1,1,0,0,4,4,13,13,0.0,M2018-07-08D,Race(6),,
7,0,0,4,4,0,0,2,2,0,0,1,1,0,0,7,7,13,13,0.0,M2018-07-08D,Race(6),,
8,0,0,3,3,0,0,0,0,0,1,0,1,0,1,3,4,21,21,0.0,M2018-07-08D,Race(6),,
9,2,2,0,4,0,0,8,8,0,0,3,3,2,2,11,15,13,13,3.0,M2018-07-08D,Race(6),,
10,0,0,0,0,0,0,0,0,0,1,1,2,0,1,1,2,17,17,0.0,M2018-07-08D,Race(6),,
11,2,2,2,6,0,7,0,7,0,0,1,1,2,9,3,14,21,21,0.0,M2018-07-08D,Race(6),,
12,0,0,0,0,0,0,0,0,0,0,0,0,0,0,0,0,21,21,0.0,M2018-07-08D,Race(6),,
1,6,0,5,11,8,3,3,14,1,2,3,6,15,5,11,31,6.5,6.5,0.0,M2018-07-08D,Race(7),,
2,4,6,3,13,0,5,9,14,2,7,4,13,6,18,16,40,13,13,0.0,M2018-07-08D,Race(7),,
3,17,3,3,23,20,3,0,23,18,5,2,25,55,11,5,71,3.6,3.6,0.0,M2018-07-08D,Race(7),,
4,0,0,2,2,1,0,8,9,2,1,1,4,3,1,11,15,10,10,3.0,M2018-07-08D,Race(7),,
5,0,0,0,0,0,0,0,0,0,0,1,1,0,0,1,1,26,26,0.0,M2018-07-08D,Race(7),,
6,0,0,0,0,0,0,0,0,0,1,0,1,0,1,0,1,21,21,4.0,M2018-07-08D,Race(7),,
7,0,2,0,2,0,0,0,0,0,0,1,1,0,2,1,3,21,21,0.0,M2018-07-08D,Race(7),,
8,0,8,0,8,0,3,2,5,0,2,3,5,0,13,5,18,13,13,2.0,M2018-07-08D,Race(7),,
9,3,5,5,13,1,4,2,7,1,6,4,11,5,15,11,31,6.5,6.5,0.0,M2018-07-08D,Race(7),,
10,0,6,7,13,0,9,6,15,2,0,6,8,2,15,19,36,6,6,1.0,M2018-07-08D,Race(7),,
11,0,0,0,0,0,0,0,0,0,0,0,0,0,0,0,0,26,26,0.0,M2018-07-08D,Race(7),,
12,0,0,5,5,0,3,0,3,0,2,1,3,0,5,6,11,8.5,8.5,0.0,M2018-07-08D,Race(7),,
1,10,10,4,24,15,4,1,20,16,4,1,21,41,18,6,65,4.4,4.4,0.0,M2018-07-08D,Race(8),,
2,3,9,5,17,6,8,7,21,5,8,8,21,14,25,20,59,7,7,3.0,M2018-07-08D,Race(8),,
3,0,0,0,0,0,0,0,0,0,0,0,0,0,0,0,0,34,35,0.0,M2018-07-08D,Race(8),,
4,10,8,5,23,0,6,8,14,1,8,7,16,11,22,20,53,5,5,1.0,M2018-07-08D,Race(8),,
5,3,0,0,3,0,0,2,2,0,0,2,2,3,0,4,7,9,9,0.0,M2018-07-08D,Race(8),,
6,0,0,0,0,1,0,8,9,1,0,1,2,2,0,9,11,9,9,0.0,M2018-07-08D,Race(8),,
7,0,3,3,6,0,8,0,8,0,2,0,2,0,13,3,16,10,10,2.0,M2018-07-08D,Race(8),,
8,2,0,6,8,0,1,2,3,1,2,4,7,3,3,12,18,11,11,0.0,M2018-07-08D,Race(8),,
9,0,0,0,0,0,0,0,0,1,0,1,2,1,0,1,2,17,17,0.0,M2018-07-08D,Race(8),,
10,0,0,0,0,0,0,0,0,0,0,0,0,0,0,0,0,34,35,0.0,M2018-07-08D,Race(8),,
11,0,0,0,0,0,0,0,0,0,0,0,0,0,0,0,0,51,51,0.0,M2018-07-08D,Race(8),,
12,2,0,7,9,8,3,2,13,1,2,2,5,11,5,11,27,5.5,5.5,0.0,M2018-07-08D,Race(8),,
1,4,9,0,13,0,6,3,9,2,7,4,13,6,22,7,35,11,11,3.0,M2018-07-08D,Race(9),,
2,9,8,0,17,10,4,3,17,10,4,2,16,29,16,5,50,5,5,2.0,M2018-07-08D,Race(9),,
3,4,5,3,12,8,2,4,14,3,2,3,8,15,9,10,34,13,13,0.0,M2018-07-08D,Race(9),,
4,5,2,7,14,3,5,4,12,4,6,5,15,12,13,16,41,7,7,0.0,M2018-07-08D,Race(9),,
5,0,2,0,2,0,0,0,0,0,0,0,0,0,2,0,2,21,21,0.0,M2018-07-08D,Race(9),,
6,0,2,2,4,1,2,9,12,1,2,4,7,2,6,15,23,21,21,0.0,M2018-07-08D,Race(9),,
7,2,0,0,2,0,0,0,0,0,0,0,0,2,0,0,2,12,12,1.0,M2018-07-08D,Race(9),,
8,0,0,0,0,0,0,0,0,0,1,0,1,0,1,0,1,34,34,0.0,M2018-07-08D,Race(9),,
9,6,2,6,14,6,2,7,15,4,2,6,12,16,6,19,41,3.2,3.2,0.0,M2018-07-08D,Race(9),,
10,0,0,0,0,0,0,0,0,0,0,0,0,0,0,0,0,51,51,0.0,M2018-07-08D,Race(9),,
11,0,0,6,6,8,0,0,8,0,0,2,2,8,0,8,16,13,13,0.0,M2018-07-08D,Race(9),,
12,0,0,0,0,0,0,0,0,0,0,0,0,0,0,0,0,81,81,0.0,M2018-07-08D,Race(9),,
13,0,0,6,6,1,2,0,3,2,2,0,4,3,4,6,13,8.5,8.5,0.0,M2018-07-08D,Race(9),,
14,0,0,0,0,0,0,0,0,0,0,0,0,0,0,0,0,26,26,0.0,M2018-07-08D,Race(9),,
1,0,2,0,2,1,1,0,2,0,2,2,4,1,5,2,8,12,12,0.0,M2018-07-11D,Race(1),,
2,8,3,11,22,17,6,4,27,7,8,1,16,32,17,16,65,3.6,3.6,1.0,M2018-07-11D,Race(1),,
3,15,8,5,28,5,9,1,15,9,2,4,15,29,19,10,58,5.5,5.5,0.0,M2018-07-11D,Race(1),,
4,0,0,3,3,1,1,3,5,2,3,1,6,3,4,7,14,12,12,0.0,M2018-07-11D,Race(1),,
5,3,2,2,7,2,4,2,8,1,3,2,6,6,9,6,21,8.5,8.5,0.0,M2018-07-11D,Race(1),,
6,0,0,5,5,1,5,16,22,3,5,2,10,4,10,23,37,7.5,7.5,0.0,M2018-07-11D,Race(1),,
7,0,4,2,6,0,0,1,1,3,0,11,14,3,4,14,21,8,8,3.0,M2018-07-11D,Race(1),,
8,0,0,0,0,2,4,1,7,0,0,1,1,2,4,2,8,15,15,0.0,M2018-07-11D,Race(1),,
9,4,8,2,14,0,0,0,0,1,3,1,5,5,11,3,19,7,7,0.0,M2018-07-11D,Race(1),,
10,0,0,0,0,0,0,0,0,0,0,1,1,0,0,1,1,71,67,0.0,M2018-07-11D,Race(1),,
11,0,3,0,3,0,0,0,0,0,0,0,0,0,3,0,3,26,26,2.0,M2018-07-11D,Race(1),,
12,0,0,0,0,0,0,0,0,0,0,0,0,0,0,0,0,26,26,0.0,M2018-07-11D,Race(1),,
1,7,2,6,15,2,4,2,8,3,4,0,7,12,10,8,30,7.5,7.5,0.0,M2018-07-11D,Race(2),,
2,5,5,3,13,3,1,2,6,4,2,4,10,12,8,9,29,6.5,6.5,2.0,M2018-07-11D,Race(2),,
3,5,2,2,9,1,1,4,6,2,1,5,8,8,4,11,23,7.5,7.5,0.0,M2018-07-11D,Race(2),,
4,0,6,0,6,8,13,5,26,7,3,6,16,15,22,11,48,9.5,9.5,3.0,M2018-07-11D,Race(2),,
5,0,0,0,0,0,0,0,0,0,0,0,0,0,0,0,0,101,101,0.0,M2018-07-11D,Race(2),,
6,0,0,0,0,0,0,0,0,0,2,0,2,0,2,0,2,26,26,0.0,M2018-07-11D,Race(2),,
7,0,0,0,0,0,0,1,1,0,0,1,1,0,0,2,2,21,21,0.0,M2018-07-11D,Race(2),,
8,3,0,8,11,14,5,4,23,9,6,2,17,26,11,14,51,8,8,1.0,M2018-07-11D,Race(2),,
9,3,5,3,11,0,0,0,0,0,0,2,2,3,5,5,13,8,8,0.0,M2018-07-11D,Race(2),,
10,0,2,2,4,0,0,0,0,0,1,1,2,0,3,3,6,26,26,0.0,M2018-07-11D,Race(2),,
11,4,8,6,18,2,5,9,16,1,6,2,9,7,19,17,43,3.8,3.8,0.0,M2018-07-11D,Race(2),,
12,3,0,0,3,0,1,3,4,0,1,3,4,3,2,6,11,8,8,0.0,M2018-07-11D,Race(2),,
1,10,10,10,30,9,13,3,25,9,6,2,17,28,29,15,72,2.5,2.5,0.0,M2018-07-11D,Race(3),,
2,14,10,2,26,16,9,3,28,9,7,6,22,39,26,11,76,6.5,6.5,2.0,M2018-07-11D,Race(3),,
3,0,0,3,3,0,0,1,1,0,1,1,2,0,1,5,6,26,26,0.0,M2018-07-11D,Race(3),,
4,2,0,2,4,2,3,3,8,2,7,3,12,6,10,8,24,7,7,3.0,M2018-07-11D,Race(3),,
5,0,0,5,5,1,0,2,3,1,1,0,2,2,1,7,10,10,10,1.0,M2018-07-11D,Race(3),,
6,0,2,0,2,0,1,3,4,2,2,3,7,2,5,6,13,17,17,0.0,M2018-07-11D,Race(3),,
7,0,0,0,0,0,0,0,0,0,0,0,0,0,0,0,0,71,67,0.0,M2018-07-11D,Race(3),,
8,0,0,0,0,1,0,2,3,0,0,6,6,1,0,8,9,26,26,0.0,M2018-07-11D,Race(3),,
9,0,0,0,0,0,0,0,0,0,0,0,0,0,0,0,0,101,101,0.0,M2018-07-11D,Race(3),,
10,4,8,6,18,1,3,12,16,3,2,2,7,8,13,20,41,8.5,8.5,0.0,M2018-07-11D,Race(3),,
11,0,0,0,0,0,0,0,0,0,0,0,0,0,0,0,0,51,51,0.0,M2018-07-11D,Race(3),,
12,0,0,2,2,0,1,1,2,0,0,3,3,0,1,6,7,4.8,4.8,0.0,M2018-07-11D,Race(3),,
1,7,0,3,10,2,3,2,7,1,3,3,7,10,6,8,24,7,7,0.0,M2018-07-11D,Race(4),,
2,12,9,4,25,18,6,3,27,14,6,2,22,44,21,9,74,2.5,2.5,0.0,M2018-07-11D,Race(4),,
3,2,6,8,16,4,11,3,18,5,3,2,10,11,20,13,44,10,10,0.0,M2018-07-11D,Race(4),,
4,0,2,3,5,0,1,0,1,0,5,3,8,0,8,6,14,9,9,0.0,M2018-07-11D,Race(4),,
5,0,0,0,0,0,1,0,1,0,0,0,0,0,1,0,1,0,0,0.0,M2018-07-11D,Race(4),,
6,0,4,0,4,2,3,4,9,1,1,5,7,3,8,9,20,10,10,0.0,M2018-07-11D,Race(4),,
7,0,0,0,0,0,0,0,0,0,0,0,0,0,0,0,0,15,15,0.0,M2018-07-11D,Race(4),,
8,5,6,5,16,2,1,2,5,2,0,1,3,9,7,8,24,8,8,1.0,M2018-07-11D,Race(4),,
9,2,0,2,4,2,4,16,22,3,7,6,16,7,11,24,42,10,10,2.0,M2018-07-11D,Race(4),,
10,2,3,2,7,0,0,0,0,0,1,2,3,2,4,4,10,19,19,0.0,M2018-07-11D,Race(4),,
11,0,0,3,3,0,0,0,0,0,0,0,0,0,0,3,3,17,17,0.0,M2018-07-11D,Race(4),,
12,0,0,0,0,0,0,0,0,0,0,2,2,0,0,2,2,26,26,3.0,M2018-07-11D,Race(4),,
1,16,11,0,27,21,6,1,28,14,6,1,21,51,23,2,76,4.6,4.5,0.0,M2018-07-11D,Race(5),,
2,0,0,0,0,0,0,0,0,0,0,0,0,0,0,0,0,81,81,0.0,M2018-07-11D,Race(5),,
3,2,0,0,2,0,0,1,1,1,0,1,2,3,0,2,5,19,19,3.0,M2018-07-11D,Race(5),,
4,6,12,4,22,5,12,3,20,8,8,1,17,19,32,8,59,3,3,0.0,M2018-07-11D,Race(5),,
5,0,4,0,4,1,0,0,1,0,0,2,2,1,4,2,7,34,34,0.0,M2018-07-11D,Race(5),,
6,3,0,3,6,0,1,0,1,0,2,1,3,3,3,4,10,12,12,0.0,M2018-07-11D,Race(5),,
7,0,0,5,5,1,2,15,18,0,5,6,11,1,7,26,34,19,19,0.0,M2018-07-11D,Race(5),,
8,0,3,0,3,0,3,5,8,0,1,6,7,0,7,11,18,7,7,0.0,M2018-07-11D,Race(5),,
9,0,0,13,13,1,4,5,10,2,2,4,8,3,6,22,31,7,7,0.0,M2018-07-11D,Race(5),,
10,3,0,5,8,1,2,0,3,1,2,4,7,5,4,9,18,7,7,1.0,M2018-07-11D,Race(5),,
11,0,0,0,0,0,0,0,0,0,0,0,0,0,0,0,0,26,26,0.0,M2018-07-11D,Race(5),,
12,0,0,0,0,0,0,0,0,0,0,0,0,0,0,0,0,26,26,2.0,M2018-07-11D,Race(5),,
1,2,9,0,11,2,13,1,16,4,4,1,9,8,26,2,36,7,7,0.0,M2018-07-11D,Race(6),,
2,13,6,5,24,18,5,4,27,12,7,2,21,43,18,11,72,7,7,0.0,M2018-07-11D,Race(6),,
3,3,2,11,16,1,4,2,7,1,1,3,5,5,7,16,28,3,3,1.0,M2018-07-11D,Race(6),,
4,0,0,0,0,0,0,0,0,0,0,0,0,0,0,0,0,26,26,0.0,M2018-07-11D,Race(6),,
5,5,2,3,10,2,0,4,6,0,2,1,3,7,4,8,19,6,6,2.0,M2018-07-11D,Race(6),,
6,0,0,0,0,0,1,0,1,2,0,1,3,2,1,1,4,34,34,0.0,M2018-07-11D,Race(6),,
7,0,0,0,0,0,0,0,0,0,0,0,0,0,0,0,0,101,101,0.0,M2018-07-11D,Race(6),,
8,0,9,2,11,4,1,12,17,1,1,10,12,5,11,24,40,8,8,0.0,M2018-07-11D,Race(6),,
9,0,0,0,0,0,0,1,1,0,1,0,1,0,1,1,2,9,9,3.0,M2018-07-11D,Race(6),,
10,0,0,0,0,2,0,1,3,2,0,1,3,4,0,2,6,15,15,0.0,M2018-07-11D,Race(6),,
11,0,0,0,0,0,0,0,0,0,1,2,3,0,1,2,3,71,67,0.0,M2018-07-11D,Race(6),,
12,7,2,9,18,1,6,5,12,4,9,5,18,12,17,19,48,8.5,8.5,0.0,M2018-07-11D,Race(6),,
1,0,0,3,3,0,1,0,1,1,2,0,3,1,3,3,7,21,21,0.0,M2018-07-11D,Race(7),,
2,2,0,0,2,0,0,1,1,0,0,1,1,2,0,2,4,13,13,0.0,M2018-07-11D,Race(7),,
3,5,0,8,13,1,0,3,4,2,0,4,6,8,0,15,23,10,10,0.0,M2018-07-11D,Race(7),,
4,0,5,2,7,0,0,0,0,0,0,0,0,0,5,2,7,10,10,0.0,M2018-07-11D,Race(7),,
5,0,6,0,6,0,0,3,3,1,0,3,4,1,6,6,13,4.8,4.8,0.0,M2018-07-11D,Race(7),,
6,6,7,10,23,6,16,5,27,6,12,6,24,18,35,21,74,4.8,4.8,2.0,M2018-07-11D,Race(7),,
7,4,0,5,9,0,1,0,1,0,1,1,2,4,2,6,12,15,15,1.0,M2018-07-11D,Race(7),,
8,11,10,2,23,3,5,16,24,2,3,8,13,16,18,26,60,2.6,2.6,0.0,M2018-07-11D,Race(7),,
9,0,0,0,0,0,0,0,0,0,0,0,0,0,0,0,0,51,51,0.0,M2018-07-11D,Race(7),,
10,2,2,0,4,0,0,0,0,0,0,0,0,2,2,0,4,21,21,3.0,M2018-07-11D,Race(7),,
11,0,0,0,0,0,0,0,0,0,0,0,0,0,0,0,0,71,67,0.0,M2018-07-11D,Race(7),,
12,0,0,0,0,0,0,0,0,0,0,0,0,0,0,0,0,51,51,0.0,M2018-07-11D,Race(7),,
1,0,0,0,0,0,0,0,0,0,0,0,0,0,0,0,0,13,13,0.0,M2018-07-11D,Race(8),,
2,10,0,6,16,2,3,14,19,6,3,9,18,18,6,29,53,3,3,0.0,M2018-07-11D,Race(8),,
3,0,0,2,2,0,1,0,1,0,0,0,0,0,1,2,3,21,21,0.0,M2018-07-11D,Race(8),,
4,3,0,3,6,0,2,2,4,1,2,2,5,4,4,7,15,15,15,2.0,M2018-07-11D,Race(8),,
5,0,2,0,2,1,0,0,1,2,1,0,3,3,3,0,6,17,17,0.0,M2018-07-11D,Race(8),,
6,0,3,4,7,9,8,5,22,7,4,4,15,16,15,13,44,15,15,0.0,M2018-07-11D,Race(8),,
7,12,6,4,22,16,7,1,24,7,7,3,17,35,20,8,63,5,5,0.0,M2018-07-11D,Race(8),,
8,0,6,3,9,1,6,4,11,2,4,4,10,3,16,11,30,7.5,7.5,0.0,M2018-07-11D,Race(8),,
9,2,8,5,15,0,0,3,3,0,2,4,6,2,10,12,24,9,9,0.0,M2018-07-11D,Race(8),,
10,0,0,0,0,0,0,0,0,0,0,0,0,0,0,0,0,21,21,0.0,M2018-07-11D,Race(8),,
11,0,0,0,0,0,0,0,0,0,0,0,0,0,0,0,0,51,51,3.0,M2018-07-11D,Race(8),,
12,3,5,3,11,1,1,1,3,1,2,0,3,5,8,4,17,7,7,1.0,M2018-07-11D,Race(8),,
1,0,0,0,0,0,1,0,1,0,1,0,1,0,2,0,2,26,26,0.0,M2018-07-15D,Race(1),,
2,8,7,13,28,19,2,1,22,17,3,1,21,44,12,15,71,2.5,2.5,0.0,M2018-07-15D,Race(1),,
3,0,0,2,2,0,0,0,0,0,0,0,0,0,0,2,2,51,51,0.0,M2018-07-15D,Race(1),,
4,0,0,0,0,8,3,2,13,1,3,2,6,9,6,4,19,19,19,0.0,M2018-07-15D,Race(1),,
5,2,3,3,8,0,2,1,3,2,5,0,7,4,10,4,18,13,13,0.0,M2018-07-15D,Race(1),,
6,0,0,0,0,0,0,0,0,0,0,0,0,0,0,0,0,101,101,0.0,M2018-07-15D,Race(1),,
7,0,0,0,0,0,0,0,0,0,0,0,0,0,0,0,0,26,26,0.0,M2018-07-15D,Race(1),,
8,0,2,0,2,0,2,8,10,0,0,2,2,0,4,10,14,26,26,3.0,M2018-07-15D,Race(1),,
9,2,0,0,2,0,8,1,9,0,2,2,4,2,10,3,15,19,19,0.0,M2018-07-15D,Race(1),,
10,4,8,3,15,0,0,2,2,2,1,3,6,6,9,8,23,10,10,0.0,M2018-07-15D,Race(1),,
11,0,3,0,3,0,5,8,13,1,3,7,11,1,11,15,27,15,15,0.0,M2018-07-15D,Race(1),,
12,3,5,4,12,1,6,5,12,1,7,6,14,5,18,15,38,9,9,0.0,M2018-07-15D,Race(1),,
13,5,0,2,7,2,1,2,5,2,1,3,6,9,2,7,18,5,5,1.0,M2018-07-15D,Race(1),,
14,6,2,3,11,0,0,0,0,0,0,0,0,6,2,3,11,10,10,2.0,M2018-07-15D,Race(1),,
1,0,0,0,0,0,0,0,0,0,0,0,0,0,0,0,0,26,26,0.0,M2018-07-15D,Race(10),,
2,2,3,0,5,0,8,2,10,3,2,3,8,5,13,5,23,5,5,0.0,M2018-07-15D,Race(10),,
3,0,2,0,2,0,0,0,0,0,0,0,0,0,2,0,2,21,21,0.0,M2018-07-15D,Race(10),,
4,0,0,0,0,0,0,8,8,1,0,2,3,1,0,10,11,34,35,0.0,M2018-07-15D,Race(10),,
5,18,2,0,20,5,8,5,18,5,8,6,19,28,18,11,57,5.5,5.5,3.0,M2018-07-15D,Race(10),,
6,3,2,0,5,0,0,4,4,0,1,2,3,3,3,6,12,21,21,0.0,M2018-07-15D,Race(10),,
7,0,3,8,11,11,5,6,22,3,4,9,16,14,12,23,49,6,6,0.0,M2018-07-15D,Race(10),,
8,0,0,0,0,0,0,0,0,0,0,0,0,0,0,0,0,51,51,0.0,M2018-07-15D,Race(10),,
9,2,7,3,12,0,1,2,3,1,0,2,3,3,8,7,18,21,21,0.0,M2018-07-15D,Race(10),,
10,0,0,0,0,0,0,0,0,0,0,0,0,0,0,0,0,34,35,0.0,M2018-07-15D,Race(10),,
11,0,0,0,0,0,0,0,0,0,0,0,0,0,0,0,0,34,35,0.0,M2018-07-15D,Race(10),,
12,0,0,0,0,0,0,0,0,0,0,0,0,0,0,0,0,41,41,0.0,M2018-07-15D,Race(10),,
13,5,3,16,24,14,5,1,20,10,6,0,16,29,14,17,60,3.5,3.5,1.0,M2018-07-15D,Race(10),,
14,0,8,3,11,0,3,2,5,3,5,2,10,3,16,7,26,6.5,6.5,2.0,M2018-07-15D,Race(10),,
1,2,0,2,4,11,2,3,16,1,0,1,2,14,2,6,22,17,17,0.0,M2018-07-15D,Race(11),,
2,0,0,0,0,0,2,0,2,1,0,0,1,1,2,0,3,15,15,0.0,M2018-07-15D,Race(11),,
3,0,0,0,0,0,0,0,0,0,0,1,1,0,0,1,1,71,67,0.0,M2018-07-15D,Race(11),,
4,0,0,2,2,0,0,0,0,0,2,2,4,0,2,4,6,26,26,0.0,M2018-07-15D,Race(11),,
5,0,0,0,0,0,0,0,0,0,1,0,1,0,1,0,1,26,26,0.0,M2018-07-15D,Race(11),,
6,0,0,0,0,0,8,2,10,4,1,3,8,4,9,5,18,12,12,0.0,M2018-07-15D,Race(11),,
7,16,12,2,30,12,8,2,22,9,10,2,21,37,30,6,73,3,3,3.0,M2018-07-15D,Race(11),,
8,0,2,12,14,0,2,6,8,2,4,6,12,2,8,24,34,10,10,1.0,M2018-07-15D,Race(11),,
9,12,14,4,30,7,8,4,19,9,6,3,18,28,28,11,67,3.5,3.5,2.0,M2018-07-15D,Race(11),,
10,0,0,3,3,0,0,1,1,0,1,1,2,0,1,5,6,17,17,0.0,M2018-07-15D,Race(11),,
11,0,0,3,3,0,0,2,2,0,0,1,1,0,0,6,6,21,21,0.0,M2018-07-15D,Race(11),,
12,0,0,0,0,0,0,2,2,0,0,2,2,0,0,4,4,15,15,0.0,M2018-07-15D,Race(11),,
13,0,0,0,0,0,0,0,0,0,0,0,0,0,0,0,0,81,81,0.0,M2018-07-15D,Race(11),,
14,0,2,2,4,0,0,8,8,0,1,4,5,0,3,14,17,12,12,0.0,M2018-07-15D,Race(11),,
1,3,4,2,9,8,4,1,13,5,6,2,13,16,14,5,35,11,11,0.0,M2018-07-15D,Race(2),,
2,0,0,2,2,2,0,4,6,2,1,3,6,4,1,9,14,21,21,0.0,M2018-07-15D,Race(2),,
3,2,0,0,2,0,0,3,3,0,1,3,4,2,1,6,9,26,26,0.0,M2018-07-15D,Race(2),,
4,10,3,3,16,7,8,1,16,5,5,6,16,22,16,10,48,5,5,0.0,M2018-07-15D,Race(2),,
5,8,12,5,25,1,2,7,10,2,2,5,9,11,16,17,44,3.5,3.5,0.0,M2018-07-15D,Race(2),,
6,0,0,0,0,0,0,0,0,1,1,0,2,1,1,0,2,15,15,0.0,M2018-07-15D,Race(2),,
7,2,0,3,5,0,0,0,0,0,0,0,0,2,0,3,5,15,15,0.0,M2018-07-15D,Race(2),,
8,0,0,2,2,0,3,8,11,1,2,1,4,1,5,11,17,13,13,0.0,M2018-07-15D,Race(2),,
9,0,0,0,0,0,0,0,0,1,0,0,1,1,0,0,1,51,51,0.0,M2018-07-15D,Race(2),,
10,0,0,6,6,1,8,1,10,1,1,3,5,2,9,10,21,8.5,8.5,1.0,M2018-07-15D,Race(2),,
11,5,11,5,21,10,5,5,20,8,7,2,17,23,23,12,58,5,5,2.0,M2018-07-15D,Race(2),,
12,0,0,2,2,0,0,0,0,0,0,1,1,0,0,3,3,21,21,0.0,M2018-07-15D,Race(2),,
13,0,0,0,0,0,0,0,0,0,0,0,0,0,0,0,0,71,67,0.0,M2018-07-15D,Race(2),,
14,0,0,0,0,0,0,0,0,0,0,0,0,0,0,0,0,41,41,3.0,M2018-07-15D,Race(2),,
1,2,7,0,9,9,4,2,15,4,3,3,10,15,14,5,34,9.5,9.5,0.0,M2018-07-15D,Race(3),,
2,11,5,2,18,2,2,3,7,4,0,2,6,17,7,7,31,5.5,5.5,0.0,M2018-07-15D,Race(3),,
3,0,5,7,12,8,2,0,10,3,3,1,7,11,10,8,29,13,13,2.0,M2018-07-15D,Race(3),,
4,0,3,3,6,3,3,4,10,1,1,1,3,4,7,8,19,7.5,7.5,0.0,M2018-07-15D,Race(3),,
5,2,0,2,4,1,3,3,7,0,3,2,5,3,6,7,16,8.5,8.5,0.0,M2018-07-15D,Race(3),,
6,2,0,2,4,0,9,1,10,6,1,1,8,8,10,4,22,13,13,0.0,M2018-07-15D,Race(3),,
7,0,0,0,0,0,0,0,0,0,0,0,0,0,0,0,0,34,34,1.0,M2018-07-15D,Race(3),,
8,2,2,2,6,2,4,2,8,2,7,4,13,6,13,8,27,5.5,5.5,0.0,M2018-07-15D,Race(3),,
9,0,0,0,0,0,0,8,8,0,0,0,0,0,0,8,8,0,0,0.0,M2018-07-15D,Race(3),,
10,3,0,6,9,0,0,0,0,0,1,1,2,3,1,7,11,21,21,0.0,M2018-07-15D,Race(3),,
11,2,0,0,2,0,0,0,0,0,1,1,2,2,1,1,4,15,15,0.0,M2018-07-15D,Race(3),,
12,6,5,0,11,5,4,7,16,6,6,7,19,17,15,14,46,6,6,0.0,M2018-07-15D,Race(3),,
13,0,3,6,9,0,0,0,0,0,0,1,1,0,3,7,10,11,11,3.0,M2018-07-15D,Race(3),,
14,0,0,0,0,0,0,0,0,0,0,0,0,0,0,0,0,71,67,0.0,M2018-07-15D,Race(3),,
1,5,7,2,14,3,3,3,9,7,5,3,15,15,15,8,38,6,6,3.0,M2018-07-15D,Race(4),,
2,0,0,9,9,2,2,4,8,4,4,3,11,6,6,16,28,9.5,9.5,0.0,M2018-07-15D,Race(4),,
3,2,5,2,9,8,2,6,16,4,1,6,11,14,8,14,36,6,6,2.0,M2018-07-15D,Race(4),,
4,5,3,2,10,2,2,1,5,2,7,2,11,9,12,5,26,12,12,0.0,M2018-07-15D,Race(4),,
5,10,8,2,20,6,5,4,15,7,1,7,15,23,14,13,50,3.4,3.4,0.0,M2018-07-15D,Race(4),,
6,8,2,0,10,0,7,3,10,2,5,3,10,10,14,6,30,9,9,0.0,M2018-07-15D,Race(4),,
7,0,0,0,0,1,9,1,11,0,3,0,3,1,12,1,14,26,26,0.0,M2018-07-15D,Race(4),,
8,0,0,0,0,0,0,0,0,0,0,0,0,0,0,0,0,34,35,0.0,M2018-07-15D,Race(4),,
9,0,3,3,6,8,0,0,8,0,0,1,1,8,3,4,15,6.5,6.5,0.0,M2018-07-15D,Race(4),,
10,0,0,0,0,0,0,0,0,0,0,0,0,0,0,0,0,151,151,0.0,M2018-07-15D,Race(4),,
11,0,0,0,0,0,0,0,0,0,0,0,0,0,0,0,0,71,67,0.0,M2018-07-15D,Race(4),,
12,0,0,0,0,0,0,0,0,0,0,0,0,0,0,0,0,51,51,0.0,M2018-07-15D,Race(4),,
13,0,2,10,12,0,0,8,8,0,0,0,0,0,2,18,20,10,10,1.0,M2018-07-15D,Race(4),,
14,0,0,0,0,0,0,0,0,0,0,0,0,0,0,0,0,81,81,0.0,M2018-07-15D,Race(4),,
1,0,3,5,8,0,8,3,11,1,0,3,4,1,11,11,23,10,10,0.0,M2018-07-15D,Race(5),,
2,0,2,0,2,0,0,2,2,0,0,1,1,0,2,3,5,15,15,3.0,M2018-07-15D,Race(5),,
3,26,0,2,28,15,2,3,20,12,4,4,20,53,6,9,68,2.5,2.5,0.0,M2018-07-15D,Race(5),,
4,0,0,3,3,0,2,2,4,0,0,0,0,0,2,5,7,15,15,0.0,M2018-07-15D,Race(5),,
5,0,0,0,0,8,0,0,8,0,0,0,0,8,0,0,8,26,26,0.0,M2018-07-15D,Race(5),,
6,0,15,8,23,5,12,3,20,9,10,2,21,14,37,13,64,7.5,7.5,0.0,M2018-07-15D,Race(5),,
7,0,0,0,0,0,0,0,0,0,0,1,1,0,0,1,1,34,34,0.0,M2018-07-15D,Race(5),,
8,2,0,7,9,0,1,3,4,2,2,4,8,4,3,14,21,9,9,0.0,M2018-07-15D,Race(5),,
9,0,0,0,0,0,0,8,8,0,0,0,0,0,0,8,8,21,21,1.0,M2018-07-15D,Race(5),,
10,0,5,5,10,0,1,1,2,0,1,3,4,0,7,9,16,9,9,0.0,M2018-07-15D,Race(5),,
11,0,0,0,0,0,0,0,0,0,1,1,2,0,1,1,2,41,41,0.0,M2018-07-15D,Race(5),,
12,0,5,0,5,2,4,5,11,2,8,7,17,4,17,12,33,7,7,0.0,M2018-07-15D,Race(5),,
13,0,0,0,0,0,0,0,0,0,0,0,0,0,0,0,0,81,81,2.0,M2018-07-15D,Race(5),,
14,2,0,0,2,0,0,0,0,0,0,0,0,2,0,0,2,81,81,0.0,M2018-07-15D,Race(5),,
1,0,0,0,0,8,0,1,9,1,1,1,3,9,1,2,12,17,17,0.0,M2018-07-15D,Race(6),,
2,9,7,7,23,11,3,3,17,12,2,4,18,32,12,14,58,3,3,3.0,M2018-07-15D,Race(6),,
3,0,0,0,0,0,0,0,0,0,1,0,1,0,1,0,1,41,41,0.0,M2018-07-15D,Race(6),,
4,3,11,3,17,0,5,7,12,3,3,6,12,6,19,16,41,10,10,0.0,M2018-07-15D,Race(6),,
5,11,6,6,23,9,11,3,23,7,12,1,20,27,29,10,66,2.9,2.9,0.0,M2018-07-15D,Race(6),,
6,0,0,0,0,0,0,0,0,1,1,1,3,1,1,1,3,34,35,1.0,M2018-07-15D,Race(6),,
7,0,2,0,2,0,0,0,0,0,0,0,0,0,2,0,2,34,35,0.0,M2018-07-15D,Race(6),,
8,0,2,0,2,0,0,0,0,0,0,0,0,0,2,0,2,41,41,0.0,M2018-07-15D,Race(6),,
9,3,0,6,9,1,10,6,17,1,3,6,10,5,13,18,36,5.5,5.5,2.0,M2018-07-15D,Race(6),,
10,0,0,0,0,0,0,0,0,0,0,0,0,0,0,0,0,34,35,0.0,M2018-07-15D,Race(6),,
11,0,0,0,0,0,0,0,0,0,0,0,0,0,0,0,0,81,81,0.0,M2018-07-15D,Race(6),,
12,0,2,0,2,0,0,2,2,0,1,2,3,0,3,4,7,21,21,0.0,M2018-07-15D,Race(6),,
13,2,0,8,10,1,1,8,10,1,2,5,8,4,3,21,28,21,21,0.0,M2018-07-15D,Race(6),,
14,2,0,0,2,0,0,0,0,0,0,0,0,2,0,0,2,26,26,0.0,M2018-07-15D,Race(6),,
1,0,3,0,3,0,0,0,0,0,0,0,0,0,3,0,3,11,11,0.0,M2018-07-15D,Race(7),,
2,3,0,5,8,2,2,8,12,1,1,3,5,6,3,16,25,12,12,2.0,M2018-07-15D,Race(7),,
3,3,0,12,15,2,4,4,10,2,4,3,9,7,8,19,34,5,5,0.0,M2018-07-15D,Race(7),,
4,11,5,0,16,15,4,2,21,16,5,1,22,42,14,3,59,6.5,6.5,3.0,M2018-07-15D,Race(7),,
5,0,0,5,5,0,0,0,0,1,1,0,2,1,1,5,7,13,13,0.0,M2018-07-15D,Race(7),,
6,8,5,6,19,2,4,4,10,4,6,6,16,14,15,16,45,6,6,0.0,M2018-07-15D,Race(7),,
7,2,0,0,2,8,0,0,8,1,0,0,1,11,0,0,11,15,15,0.0,M2018-07-15D,Race(7),,
8,0,0,0,0,0,8,0,8,0,1,1,2,0,9,1,10,34,34,0.0,M2018-07-15D,Race(7),,
9,3,7,0,10,0,3,2,5,0,2,2,4,3,12,4,19,6,6,0.0,M2018-07-15D,Race(7),,
10,0,0,0,0,0,0,0,0,0,0,0,0,0,0,0,0,34,34,1.0,M2018-07-15D,Race(7),,
11,0,0,0,0,0,0,0,0,0,0,1,1,0,0,1,1,41,41,0.0,M2018-07-15D,Race(7),,
12,0,0,0,0,0,0,0,0,0,0,0,0,0,0,0,0,21,21,0.0,M2018-07-15D,Race(7),,
13,0,10,2,12,1,5,10,16,1,6,9,16,2,21,21,44,8,8,0.0,M2018-07-15D,Race(7),,
14,0,0,0,0,0,0,0,0,0,0,0,0,0,0,0,0,34,34,0.0,M2018-07-15D,Race(7),,
1,2,0,0,2,0,3,10,13,0,3,5,8,2,6,15,23,8,8,0.0,M2018-07-15D,Race(8),,
2,0,2,8,10,0,8,3,11,0,0,2,2,0,10,13,23,15,15,0.0,M2018-07-15D,Race(8),,
3,0,2,2,4,0,1,8,9,2,2,5,9,2,5,15,22,13,13,3.0,M2018-07-15D,Race(8),,
4,0,0,0,0,0,0,0,0,1,0,0,1,1,0,0,1,34,35,0.0,M2018-07-15D,Race(8),,
5,0,0,12,12,0,2,1,3,0,2,3,5,0,4,16,20,15,15,0.0,M2018-07-15D,Race(8),,
6,0,0,0,0,0,0,2,2,0,0,1,1,0,0,3,3,21,21,0.0,M2018-07-15D,Race(8),,
7,13,13,2,28,11,12,4,27,11,10,2,23,35,35,8,78,3.2,3.2,0.0,M2018-07-15D,Race(8),,
8,15,13,2,30,19,4,0,23,12,9,2,23,46,26,4,76,2.5,2.5,1.0,M2018-07-15D,Race(8),,
9,0,0,0,0,0,0,0,0,0,0,0,0,0,0,0,0,41,41,0.0,M2018-07-15D,Race(8),,
10,0,0,4,4,0,0,2,2,0,0,6,6,0,0,12,12,7.5,7.5,2.0,M2018-07-15D,Race(8),,
1,0,0,0,0,8,0,0,8,0,0,0,0,8,0,0,8,51,51,0.0,M2018-07-15D,Race(9),,
2,3,0,0,3,1,1,2,4,1,1,2,4,5,2,4,11,8,8,3.0,M2018-07-15D,Race(9),,
3,7,14,2,23,7,8,4,19,9,4,5,18,23,26,11,60,3.2,3.2,1.0,M2018-07-15D,Race(9),,
4,0,2,0,2,0,0,0,0,0,0,0,0,0,2,0,2,34,35,0.0,M2018-07-15D,Race(9),,
5,0,0,0,0,0,8,0,8,0,2,0,2,0,10,0,10,41,41,0.0,M2018-07-15D,Race(9),,
6,0,0,3,3,0,0,0,0,0,0,0,0,0,0,3,3,41,41,0.0,M2018-07-15D,Race(9),,
7,2,2,0,4,1,2,0,3,2,2,0,4,5,6,0,11,13,13,0.0,M2018-07-15D,Race(9),,
8,0,0,5,5,4,2,8,14,5,3,3,11,9,5,16,30,13,13,0.0,M2018-07-15D,Race(9),,
9,0,0,0,0,0,0,0,0,0,0,1,1,0,0,1,1,51,51,0.0,M2018-07-15D,Race(9),,
10,3,9,3,15,4,4,9,17,4,6,6,16,11,19,18,48,9,9,0.0,M2018-07-15D,Race(9),,
11,2,0,3,5,1,3,0,4,0,3,1,4,3,6,4,13,4.6,4.6,0.0,M2018-07-15D,Race(9),,
12,0,3,4,7,3,0,4,7,3,2,4,9,6,5,12,23,9,9,0.0,M2018-07-15D,Race(9),,
13,13,0,10,23,1,2,3,6,2,3,4,9,16,5,17,38,7.5,7.5,2.0,M2018-07-15D,Race(9),,
14,0,0,0,0,0,0,0,0,0,0,0,0,0,0,0,0,81,81,0.0,M2018-07-15D,Race(9),,
1,6,0,0,6,1,4,4,9,0,5,3,8,7,9,7,23,5,5,0.0,M2018-09-02D,Race(1),,
2,11,7,4,22,19,6,1,26,13,5,2,20,43,18,7,68,5,5,3.0,M2018-09-02D,Race(1),,
3,5,2,16,23,5,12,9,26,5,6,9,20,15,20,34,69,3,3,2.0,M2018-09-02D,Race(1),,
4,8,11,4,23,4,3,11,18,4,6,3,13,16,20,18,54,5.5,5.5,1.0,M2018-09-02D,Race(1),,
5,0,8,6,14,0,2,4,6,1,4,5,10,1,14,15,30,8.5,8.5,0.0,M2018-09-02D,Race(1),,
6,0,0,0,0,1,3,1,5,3,0,3,6,4,3,4,11,7.5,7.5,0.0,M2018-09-02D,Race(1),,
7,0,2,0,2,0,0,0,0,0,0,1,1,0,2,1,3,26,26,0.0,M2018-09-02D,Race(1),,
8,0,0,0,0,0,0,0,0,0,0,0,0,0,0,0,0,31,31,0.0,M2018-09-02D,Race(1),,
9,0,0,0,0,0,0,0,0,0,0,0,0,0,0,0,0,26,26,0.0,M2018-09-02D,Race(1),,
10,0,0,0,0,0,0,0,0,0,0,0,0,0,0,0,0,67,67,0.0,M2018-09-02D,Race(1),,
1,12,0,8,20,25,2,2,29,20,5,1,26,57,7,11,75,2.3,2.3,2.0,M2018-09-02D,Race(10),,
2,3,5,0,8,2,4,5,11,1,7,8,16,6,16,13,35,6,6,3.0,M2018-09-02D,Race(10),,
3,8,5,10,23,1,17,3,21,1,7,3,11,10,29,16,55,7.5,7.5,0.0,M2018-09-02D,Race(10),,
4,0,0,0,0,0,0,0,0,0,1,0,1,0,1,0,1,31,31,0.0,M2018-09-02D,Race(10),,
5,2,5,2,9,0,0,1,1,0,0,2,2,2,5,5,12,17,17,0.0,M2018-09-02D,Race(10),,
6,0,0,0,0,0,0,0,0,0,0,0,0,0,0,0,0,14,14,0.0,M2018-09-02D,Race(10),,
7,0,0,3,3,0,2,1,3,0,1,3,4,0,3,7,10,21,21,0.0,M2018-09-02D,Race(10),,
8,0,2,2,4,0,3,2,5,0,1,2,3,0,6,6,12,15,15,0.0,M2018-09-02D,Race(10),,
9,0,0,0,0,0,0,1,1,0,0,0,0,0,0,1,1,26,26,0.0,M2018-09-02D,Race(10),,
10,2,5,2,9,0,0,0,0,0,0,0,0,2,5,2,9,14,14,1.0,M2018-09-02D,Race(10),,
11,0,0,0,0,0,0,0,0,0,0,0,0,0,0,0,0,51,51,0.0,M2018-09-02D,Race(10),,
12,0,0,0,0,0,0,0,0,0,0,0,0,0,0,0,0,61,61,0.0,M2018-09-02D,Race(10),,
13,3,8,3,14,2,2,15,19,4,4,7,15,9,14,25,48,7,7,0.0,M2018-09-02D,Race(10),,
1,0,0,0,0,1,2,1,4,0,3,1,4,1,5,2,8,11,11,0.0,M2018-09-02D,Race(2),,
2,0,0,2,2,0,2,2,4,0,2,3,5,0,4,7,11,8,8,0.0,M2018-09-02D,Race(2),,
3,0,4,0,4,1,0,1,2,1,1,0,2,2,5,1,8,17,17,0.0,M2018-09-02D,Race(2),,
4,5,9,7,21,6,11,6,23,9,3,5,17,20,23,18,61,5.5,5.5,0.0,M2018-09-02D,Race(2),,
5,0,3,0,3,0,0,1,1,1,0,4,5,1,3,5,9,9,9,0.0,M2018-09-02D,Race(2),,
6,4,4,6,14,1,3,11,15,4,2,3,9,9,9,20,38,10,10,1.0,M2018-09-02D,Race(2),,
7,0,0,0,0,2,4,1,7,0,5,0,5,2,9,1,12,17,17,0.0,M2018-09-02D,Race(2),,
8,14,4,10,28,16,6,4,26,7,9,3,19,37,19,17,73,3.3,3.3,2.0,M2018-09-02D,Race(2),,
9,7,3,5,15,3,0,3,6,4,0,6,10,14,3,14,31,8,8,0.0,M2018-09-02D,Race(2),,
10,0,3,0,3,0,2,0,2,0,1,1,2,0,6,1,7,7,7,3.0,M2018-09-02D,Race(2),,
1,0,5,0,5,17,3,1,21,10,4,1,15,27,12,2,41,6.5,6.5,0.0,M2018-09-02D,Race(3),,
2,7,3,6,16,5,14,5,24,7,5,5,17,19,22,16,57,3.8,3.8,1.0,M2018-09-02D,Race(3),,
3,3,0,8,11,0,1,6,7,0,0,6,6,3,1,20,24,12,12,2.0,M2018-09-02D,Race(3),,
4,5,9,2,16,1,5,14,20,3,7,6,16,9,21,22,52,5,5,0.0,M2018-09-02D,Race(3),,
5,3,13,6,22,4,5,1,10,5,7,3,15,12,25,10,47,6,6,0.0,M2018-09-02D,Race(3),,
6,0,0,0,0,0,0,1,1,0,0,1,1,0,0,2,2,15,15,0.0,M2018-09-02D,Race(3),,
7,12,0,8,20,3,2,2,7,1,3,4,8,16,5,14,35,3,3,3.0,M2018-09-02D,Race(3),,
1,0,0,0,0,0,0,0,0,1,0,0,1,1,0,0,1,67,67,0.0,M2018-09-02D,Race(4),,
2,2,0,2,4,0,0,0,0,0,0,0,0,2,0,2,4,17,17,3.0,M2018-09-02D,Race(4),,
3,0,0,0,0,0,0,0,0,0,0,0,0,0,0,0,0,34,34,0.0,M2018-09-02D,Race(4),,
4,0,9,6,15,2,3,2,7,4,2,1,7,6,14,9,29,10,10,0.0,M2018-09-02D,Race(4),,
5,5,7,2,14,7,9,6,22,6,5,3,14,18,21,11,50,9,9,0.0,M2018-09-02D,Race(4),,
6,0,0,0,0,0,0,0,0,1,1,0,2,1,1,0,2,21,21,0.0,M2018-09-02D,Race(4),,
7,2,2,0,4,1,1,0,2,1,0,0,1,4,3,0,7,19,19,0.0,M2018-09-02D,Race(4),,
8,8,4,6,18,14,6,9,29,2,12,7,21,24,22,22,68,3,3,0.0,M2018-09-02D,Race(4),,
9,3,2,3,8,1,0,1,2,1,0,5,6,5,2,9,16,17,17,0.0,M2018-09-02D,Race(4),,
10,10,6,4,20,5,10,12,27,9,5,9,23,24,21,25,70,4,4,0.0,M2018-09-02D,Race(4),,
11,0,0,0,0,0,0,0,0,0,0,0,0,0,0,0,0,19,19,2.0,M2018-09-02D,Race(4),,
12,0,0,0,0,0,0,0,0,0,1,0,1,0,1,0,1,19,19,0.0,M2018-09-02D,Race(4),,
13,0,0,7,7,0,1,0,1,1,0,1,2,1,1,8,10,7.5,7.5,1.0,M2018-09-02D,Race(4),,
14,0,0,0,0,0,0,0,0,0,0,0,0,0,0,0,0,101,101,0.0,M2018-09-02D,Race(4),,
1,8,9,6,23,4,18,2,24,8,7,1,16,20,34,9,63,8.5,8.5,0.0,M2018-09-02D,Race(5),,
2,0,0,0,0,0,0,1,1,0,0,2,2,0,0,3,3,13,13,0.0,M2018-09-02D,Race(5),,
3,0,5,0,5,0,3,2,5,1,4,3,8,1,12,5,18,10,10,0.0,M2018-09-02D,Race(5),,
4,17,5,6,28,21,5,2,28,15,9,2,26,53,19,10,82,1.95,1.95,1.0,M2018-09-02D,Race(5),,
5,0,0,3,3,0,0,0,0,0,0,1,1,0,0,4,4,21,21,2.0,M2018-09-02D,Race(5),,
6,0,0,0,0,0,0,1,1,0,0,0,0,0,0,1,1,26,26,0.0,M2018-09-02D,Race(5),,
7,0,0,0,0,0,0,0,0,0,0,0,0,0,0,0,0,13,13,0.0,M2018-09-02D,Race(5),,
8,0,0,2,2,0,0,0,0,0,0,0,0,0,0,2,2,35,35,0.0,M2018-09-02D,Race(5),,
9,3,3,4,10,0,0,1,1,0,0,2,2,3,3,7,13,41,41,0.0,M2018-09-02D,Race(5),,
10,0,5,3,8,2,0,6,8,0,2,6,8,2,7,15,24,19,19,0.0,M2018-09-02D,Race(5),,
11,0,3,2,5,3,3,12,18,2,2,4,8,5,8,18,31,7,7,3.0,M2018-09-02D,Race(5),,
12,0,0,0,0,0,0,0,0,0,0,0,0,0,0,0,0,71,71,0.0,M2018-09-02D,Race(5),,
13,2,0,4,6,0,1,3,4,0,2,5,7,2,3,12,17,15,15,0.0,M2018-09-02D,Race(5),,
1,3,2,2,7,1,1,0,2,1,2,1,4,5,5,3,13,5.5,5.5,0.0,M2018-09-02D,Race(6),,
2,5,4,9,18,2,14,2,18,4,3,1,8,11,21,12,44,9,9,2.0,M2018-09-02D,Race(6),,
3,6,3,3,12,3,2,4,9,4,2,5,11,13,7,12,32,7,7,0.0,M2018-09-02D,Race(6),,
4,0,0,0,0,0,0,0,0,1,0,0,1,1,0,0,1,31,31,0.0,M2018-09-02D,Race(6),,
5,0,0,0,0,0,0,0,0,0,0,0,0,0,0,0,0,51,51,0.0,M2018-09-02D,Race(6),,
6,6,8,6,20,3,3,12,18,5,3,1,9,14,14,19,47,5,5,0.0,M2018-09-02D,Race(6),,
7,2,5,2,9,4,1,2,7,5,2,0,7,11,8,4,23,4.5,4.5,0.0,M2018-09-02D,Race(6),,
8,2,0,4,6,2,0,3,5,1,1,6,8,5,1,13,19,13,13,0.0,M2018-09-02D,Race(6),,
9,0,8,0,8,2,3,6,11,2,8,7,17,4,19,13,36,8,8,1.0,M2018-09-02D,Race(6),,
10,6,0,4,10,13,6,1,20,3,4,5,12,22,10,10,42,11,11,0.0,M2018-09-02D,Race(6),,
11,0,0,0,0,0,0,0,0,0,1,0,1,0,1,0,1,13,13,3.0,M2018-09-02D,Race(6),,
12,0,0,0,0,0,0,0,0,0,0,0,0,0,0,0,0,61,61,0.0,M2018-09-02D,Race(6),,
1,0,0,0,0,1,1,13,15,0,2,2,4,1,3,15,19,10,10,0.0,M2018-09-02D,Race(7),,
2,6,11,9,26,9,16,2,27,8,11,6,25,23,38,17,78,3,3,3.0,M2018-09-02D,Race(7),,
3,0,0,7,7,0,1,3,4,1,0,4,5,1,1,14,16,14,14,0.0,M2018-09-02D,Race(7),,
4,0,0,0,0,0,0,0,0,0,0,1,1,0,0,1,1,14,14,0.0,M2018-09-02D,Race(7),,
5,14,8,5,27,20,8,1,29,17,5,3,25,51,21,9,81,2.4,2.4,2.0,M2018-09-02D,Race(7),,
6,10,6,7,23,0,4,8,12,0,8,8,16,10,18,23,51,6.5,6.5,1.0,M2018-09-02D,Race(7),,
7,0,0,0,0,0,0,0,0,0,0,0,0,0,0,0,0,31,31,0.0,M2018-09-02D,Race(7),,
8,0,5,2,7,0,0,3,3,0,0,2,2,0,5,7,12,8.5,8.5,0.0,M2018-09-02D,Race(7),,
1,0,0,0,0,0,0,0,0,0,0,0,0,0,0,0,0,26,26,2.0,M2018-09-02D,Race(8),,
2,0,2,3,5,1,0,2,3,2,0,4,6,3,2,9,14,6.5,6.5,0.0,M2018-09-02D,Race(8),,
3,0,0,5,5,2,1,3,6,3,1,4,8,5,2,12,19,12,12,0.0,M2018-09-02D,Race(8),,
4,8,8,10,26,8,11,6,25,7,6,6,19,23,25,22,70,3,3,0.0,M2018-09-02D,Race(8),,
5,0,0,0,0,0,2,1,3,0,3,1,4,0,5,2,7,9,9,1.0,M2018-09-02D,Race(8),,
6,0,0,0,0,0,0,0,0,0,0,0,0,0,0,0,0,0,0,0.0,M2018-09-02D,Race(8),,
7,0,3,2,5,1,1,1,3,0,0,2,2,1,4,5,10,13,13,3.0,M2018-09-02D,Race(8),,
8,15,9,0,24,2,8,12,22,5,7,3,15,22,24,15,61,7,7,0.0,M2018-09-02D,Race(8),,
9,7,8,10,25,16,7,5,28,9,9,6,24,32,24,21,77,2.8,2.8,0.0,M2018-09-02D,Race(8),,
1,6,4,0,10,0,3,5,8,0,4,4,8,6,11,9,26,5,5,0.0,M2018-09-02D,Race(9),,
2,0,0,0,0,2,2,3,7,3,3,1,7,5,5,4,14,15,15,0.0,M2018-09-02D,Race(9),,
3,2,0,0,2,2,1,1,4,0,2,5,7,4,3,6,13,10,10,1.0,M2018-09-02D,Race(9),,
4,0,0,0,0,0,0,0,0,0,0,0,0,0,0,0,0,35,35,0.0,M2018-09-02D,Race(9),,
5,3,5,12,20,1,3,13,17,2,3,7,12,6,11,32,49,4.4,4.4,3.0,M2018-09-02D,Race(9),,
6,5,8,8,21,2,17,4,23,7,6,3,16,14,31,15,60,10,10,0.0,M2018-09-02D,Race(9),,
7,0,0,0,0,0,0,0,0,0,0,1,1,0,0,1,1,51,51,0.0,M2018-09-02D,Race(9),,
8,2,0,0,2,0,0,0,0,0,0,0,0,2,0,0,2,26,26,0.0,M2018-09-02D,Race(9),,
9,0,0,5,5,0,1,1,2,0,0,0,0,0,1,6,7,16,16,0.0,M2018-09-02D,Race(9),,
10,12,8,3,23,23,3,2,28,14,7,1,22,49,18,6,73,3.1,3.1,0.0,M2018-09-02D,Race(9),,
11,0,5,2,7,0,0,1,1,0,1,4,5,0,6,7,13,7.5,7.5,2.0,M2018-09-02D,Race(9),,
1,9,7,10,26,10,6,4,20,11,9,2,22,30,22,16,68,3,3,3.0,M2018-09-05D,Race(1),,
2,2,11,4,17,4,9,2,15,4,8,1,13,10,28,7,45,4.6,4.6,2.0,M2018-09-05D,Race(1),,
3,0,0,0,0,8,0,3,11,1,0,4,5,9,0,7,16,7.5,7.5,0.0,M2018-09-05D,Race(1),,
4,0,0,6,6,1,0,8,9,0,0,1,1,1,0,15,16,12,12,0.0,M2018-09-05D,Race(1),,
5,0,0,0,0,0,0,0,0,0,1,0,1,0,1,0,1,12,12,0.0,M2018-09-05D,Race(1),,
6,7,5,7,19,3,11,6,20,3,3,10,16,13,19,23,55,5,5,0.0,M2018-09-05D,Race(1),,
7,0,0,0,0,0,0,0,0,1,0,1,2,1,0,1,2,0,0,0.0,M2018-09-05D,Race(1),,
8,7,0,0,7,2,0,1,3,1,1,4,6,10,1,5,16,12,12,0.0,M2018-09-05D,Race(1),,
9,5,7,3,15,1,4,5,10,5,4,3,12,11,15,11,37,6,6,1.0,M2018-09-05D,Race(1),,
1,2,0,0,2,0,1,0,1,0,1,0,1,2,2,0,4,61,61,0.0,M2018-09-05D,Race(2),,
2,5,9,2,16,3,2,5,10,6,2,2,10,14,13,9,36,8,8,0.0,M2018-09-05D,Race(2),,
3,0,5,10,15,3,8,4,15,4,7,5,16,7,20,19,46,6,6,0.0,M2018-09-05D,Race(2),,
4,5,7,8,20,3,4,1,8,5,6,2,13,13,17,11,41,5.5,5.5,0.0,M2018-09-05D,Race(2),,
5,0,3,3,6,2,8,4,14,1,3,9,13,3,14,16,33,5,5,3.0,M2018-09-05D,Race(2),,
6,0,0,0,0,0,0,0,0,0,1,0,1,0,1,0,1,31,21,1.0,M2018-09-05D,Race(2),,
7,2,0,0,2,8,0,1,9,1,0,0,1,11,0,1,12,9,14,0.0,M2018-09-05D,Race(2),,
8,13,2,5,20,10,5,4,19,8,6,4,18,31,13,13,57,2.6,2.8,2.0,M2018-09-05D,Race(2),,
9,0,2,0,2,0,1,8,9,0,0,0,0,0,3,8,11,26,27,0.0,M2018-09-05D,Race(2),,
10,3,2,2,7,0,0,2,2,1,0,4,5,4,2,8,14,16,16,0.0,M2018-09-05D,Race(2),,
1,5,0,8,13,4,10,2,16,6,8,5,19,15,18,15,48,6.5,6.5,0.0,M2018-09-05D,Race(3),,
2,0,13,7,20,9,5,5,19,11,4,4,19,20,22,16,58,6.5,6.5,2.0,M2018-09-05D,Race(3),,
3,2,3,0,5,1,9,8,18,1,3,1,5,4,15,9,28,15,15,1.0,M2018-09-05D,Race(3),,
4,0,0,0,0,0,0,0,0,0,0,0,0,0,0,0,0,41,41,0.0,M2018-09-05D,Race(3),,
5,13,7,3,23,4,2,4,10,4,4,5,13,21,13,12,46,2.4,2.4,0.0,M2018-09-05D,Race(3),,
6,2,0,3,5,0,0,0,0,1,0,1,2,3,0,4,7,41,41,0.0,M2018-09-05D,Race(3),,
7,3,0,3,6,1,0,3,4,0,2,1,3,4,2,7,13,8.5,8.5,0.0,M2018-09-05D,Race(3),,
8,2,5,4,11,2,3,5,10,2,5,6,13,6,13,15,34,4.4,4.4,0.0,M2018-09-05D,Race(3),,
9,3,2,2,7,8,0,2,10,1,0,3,4,12,2,7,21,13,13,0.0,M2018-09-05D,Race(3),,
10,0,0,0,0,0,0,0,0,0,0,0,0,0,0,0,0,31,31,3.0,M2018-09-05D,Race(3),,
1,5,3,7,15,9,0,4,13,3,1,2,6,17,4,13,34,6,6,3.0,M2018-09-05D,Race(4),,
2,0,7,0,7,2,5,3,10,1,6,4,11,3,18,7,28,9,9,0.0,M2018-09-05D,Race(4),,
3,0,3,10,13,2,5,6,13,2,3,8,13,4,11,24,39,7.5,7.5,2.0,M2018-09-05D,Race(4),,
4,13,7,5,25,8,4,6,18,7,7,5,19,28,18,16,62,2.7,2.7,0.0,M2018-09-05D,Race(4),,
5,2,0,3,5,1,8,1,10,1,1,1,3,4,9,5,18,12,12,0.0,M2018-09-05D,Race(4),,
6,0,0,0,0,0,0,8,8,0,1,3,4,0,1,11,12,21,21,0.0,M2018-09-05D,Race(4),,
7,2,0,0,2,0,0,0,0,0,0,1,1,2,0,1,3,14,14,0.0,M2018-09-05D,Race(4),,
8,8,7,5,20,7,7,1,15,11,7,1,19,26,21,7,54,4.4,4.4,0.0,M2018-09-05D,Race(4),,
9,0,0,0,0,0,0,0,0,0,0,0,0,0,0,0,0,81,81,0.0,M2018-09-05D,Race(4),,
10,0,3,0,3,0,0,0,0,1,0,1,2,1,3,1,5,14,14,1.0,M2018-09-05D,Race(4),,
1,0,2,11,13,0,0,0,0,0,1,0,1,0,3,11,14,7,7,0.0,M2018-09-05D,Race(5),,
2,8,8,5,21,9,4,4,17,8,4,4,16,25,16,13,54,6,6,0.0,M2018-09-05D,Race(5),,
3,0,0,0,0,0,0,8,8,0,0,1,1,0,0,9,9,12,12,0.0,M2018-09-05D,Race(5),,
4,9,6,2,17,6,8,5,19,9,5,5,19,24,19,12,55,4.4,4.4,0.0,M2018-09-05D,Race(5),,
5,2,6,2,10,5,5,9,19,3,6,10,19,10,17,21,48,4.8,4.8,0.0,M2018-09-05D,Race(5),,
6,0,0,0,0,0,0,0,0,0,0,0,0,0,0,0,0,41,41,0.0,M2018-09-05D,Race(5),,
7,9,6,0,15,9,2,3,14,3,6,2,11,21,14,5,40,4.2,4.2,2.0,M2018-09-05D,Race(5),,
8,2,0,0,2,0,8,0,8,2,2,1,5,4,10,1,15,16,21,0.0,M2018-09-05D,Race(5),,
9,0,0,0,0,0,0,0,0,0,0,0,0,0,0,0,0,21,21,1.0,M2018-09-05D,Race(5),,
10,0,2,10,12,0,2,0,2,1,2,3,6,1,6,13,20,9,9,3.0,M2018-09-05D,Race(5),,
1,5,0,0,5,0,0,0,0,0,0,0,0,5,0,0,5,19,19,0.0,M2018-09-05D,Race(6),,
2,2,3,3,8,5,3,6,14,11,1,3,15,18,7,12,37,4.6,4.6,2.0,M2018-09-05D,Race(6),,
3,13,5,3,21,4,9,1,14,3,4,2,9,20,18,6,44,5,5,3.0,M2018-09-05D,Race(6),,
4,0,0,4,4,0,0,0,0,1,0,0,1,1,0,4,5,11,10,0.0,M2018-09-05D,Race(6),,
5,0,0,0,0,0,0,2,2,0,2,3,5,0,2,5,7,11,11,0.0,M2018-09-05D,Race(6),,
6,2,5,0,7,3,4,3,10,6,8,3,17,11,17,6,34,7,7,0.0,M2018-09-05D,Race(6),,
7,0,0,0,0,0,0,8,8,0,0,0,0,0,0,8,8,41,41,0.0,M2018-09-05D,Race(6),,
8,8,15,5,28,10,3,3,16,0,2,7,9,18,20,15,53,4.4,4.5,1.0,M2018-09-05D,Race(6),,
9,0,0,0,0,3,7,4,14,1,8,4,13,4,15,8,27,0,0,0.0,M2018-09-05D,Race(6),,
10,0,0,0,0,0,0,0,0,0,0,0,0,0,0,0,0,41,41,0.0,M2018-09-05D,Race(6),,
11,0,2,13,15,4,3,2,9,4,1,4,9,8,6,19,33,5,5,0.0,M2018-09-05D,Race(6),,
12,0,0,2,2,0,0,0,0,0,0,0,0,0,0,2,2,18,51,0.0,M2018-09-05D,Race(6),,
1,5,9,4,18,3,10,4,17,5,11,2,18,13,30,10,53,5.5,5.5,0.0,M2018-09-05D,Race(7),,
2,5,11,6,22,3,10,8,21,6,3,7,16,14,24,21,59,5,5,3.0,M2018-09-05D,Race(7),,
3,0,2,8,10,1,0,1,2,1,0,1,2,2,2,10,14,10,10,0.0,M2018-09-05D,Race(7),,
4,0,0,0,0,0,0,0,0,1,1,1,3,1,1,1,3,18,18,0.0,M2018-09-05D,Race(7),,
5,0,2,3,5,8,0,1,9,0,2,4,6,8,4,8,20,12,12,0.0,M2018-09-05D,Race(7),,
6,0,0,2,2,0,0,8,8,0,0,1,1,0,0,11,11,13,13,0.0,M2018-09-05D,Race(7),,
7,0,4,0,4,13,3,3,19,2,4,5,11,15,11,8,34,8,8,0.0,M2018-09-05D,Race(7),,
8,18,2,2,22,0,0,0,0,11,5,5,21,29,7,7,43,2.7,2.7,1.0,M2018-09-05D,Race(7),,
9,2,0,3,5,0,0,0,0,0,0,0,0,2,0,3,5,31,31,2.0,M2018-09-05D,Race(7),,
10,0,0,2,2,0,0,0,0,0,0,0,0,0,0,2,2,26,26,0.0,M2018-09-05D,Race(7),,
11,0,0,0,0,0,0,0,0,0,0,0,0,0,0,0,0,31,31,0.0,M2018-09-05D,Race(7),,
1,0,0,2,2,0,0,9,9,0,0,1,1,0,0,12,12,15,15,0.0,M2018-09-05D,Race(8),,
2,5,0,0,5,1,0,3,4,3,0,4,7,9,0,7,16,10,10,0.0,M2018-09-05D,Race(8),,
3,19,11,0,30,10,9,2,21,14,7,3,24,43,27,5,75,2.4,2.4,2.0,M2018-09-05D,Race(8),,
4,4,8,13,25,9,4,4,17,6,8,6,20,19,20,23,62,7.5,7.5,0.0,M2018-09-05D,Race(8),,
5,0,0,3,3,1,1,3,5,0,2,7,9,1,3,13,17,5,5,0.0,M2018-09-05D,Race(8),,
6,0,0,0,0,0,0,0,0,0,0,0,0,0,0,0,0,31,31,0.0,M2018-09-05D,Race(8),,
7,0,0,0,0,0,8,0,8,0,1,0,1,0,9,0,9,21,21,3.0,M2018-09-05D,Race(8),,
8,2,0,2,4,0,0,0,0,0,0,0,0,2,0,2,4,34,34,0.0,M2018-09-05D,Race(8),,
9,0,0,3,3,0,2,0,2,0,1,0,1,0,3,3,6,18,18,0.0,M2018-09-05D,Race(8),,
10,0,0,0,0,0,0,0,0,0,0,0,0,0,0,0,0,21,21,0.0,M2018-09-05D,Race(8),,
11,0,11,7,18,8,5,8,21,3,7,5,15,11,23,20,54,6,6,1.0,M2018-09-05D,Race(8),,
1,5,5,3,13,16,4,6,26,5,2,10,17,26,11,19,56,6.5,6.5,0.0,M2018-09-09D,Race(1),,
2,3,7,3,13,0,2,1,3,0,1,2,3,3,10,6,19,9,9,0.0,M2018-09-09D,Race(1),,
3,2,0,0,2,0,1,1,2,0,3,1,4,2,4,2,8,6.5,6.5,0.0,M2018-09-09D,Race(1),,
4,2,8,10,20,3,3,2,8,6,4,2,12,11,15,14,40,12,12,2.0,M2018-09-09D,Race(1),,
5,0,0,0,0,0,0,0,0,0,1,2,3,0,1,2,3,17,17,0.0,M2018-09-09D,Race(1),,
6,2,0,0,2,0,0,0,0,0,0,0,0,2,0,0,2,16,16,0.0,M2018-09-09D,Race(1),,
7,16,7,2,25,5,5,13,23,7,6,3,16,28,18,18,64,2.8,2.8,0.0,M2018-09-09D,Race(1),,
8,0,3,8,11,6,14,5,25,7,8,3,18,13,25,16,54,9,10,1.0,M2018-09-09D,Race(1),,
9,0,0,0,0,0,0,0,0,1,1,0,2,1,1,0,2,9,9,0.0,M2018-09-09D,Race(1),,
10,0,0,4,4,0,1,2,3,0,0,3,3,0,1,9,10,15,15,3.0,M2018-09-09D,Race(1),,
11,0,0,0,0,0,0,0,0,0,0,0,0,0,0,0,0,51,51,0.0,M2018-09-09D,Race(1),,
12,0,0,0,0,0,0,0,0,0,0,0,0,0,0,0,0,51,51,0.0,M2018-09-09D,Race(1),,
1,6,18,2,26,10,16,5,31,7,11,4,22,23,45,11,79,3.5,3.5,0.0,M2018-09-09D,Race(10),,
2,0,0,0,0,0,0,0,0,0,0,1,1,0,0,1,1,51,51,0.0,M2018-09-09D,Race(10),,
3,0,0,0,0,0,0,0,0,1,0,0,1,1,0,0,1,34,34,0.0,M2018-09-09D,Race(10),,
4,0,3,2,5,0,2,5,7,1,1,5,7,1,6,12,19,13,13,0.0,M2018-09-09D,Race(10),,
5,0,0,0,0,0,0,0,0,0,1,0,1,0,1,0,1,26,26,0.0,M2018-09-09D,Race(10),,
6,2,0,14,16,1,3,15,19,2,5,7,14,5,8,36,49,8.5,8.5,0.0,M2018-09-09D,Race(10),,
7,0,0,0,0,0,0,0,0,0,0,0,0,0,0,0,0,41,41,0.0,M2018-09-09D,Race(10),,
8,0,0,0,0,0,0,0,0,0,0,0,0,0,0,0,0,71,67,0.0,M2018-09-09D,Race(10),,
9,2,0,0,2,0,0,0,0,0,1,0,1,2,1,0,3,13,13,1.0,M2018-09-09D,Race(10),,
10,0,5,2,7,0,0,1,1,0,0,2,2,0,5,5,10,17,17,0.0,M2018-09-09D,Race(10),,
11,20,0,8,28,19,9,2,30,15,7,1,23,54,16,11,81,2.25,2.2,3.0,M2018-09-09D,Race(10),,
12,0,4,2,6,0,0,2,2,0,0,6,6,0,4,10,14,10,10,2.0,M2018-09-09D,Race(10),,
1,0,0,9,9,0,1,4,5,0,0,7,7,0,1,20,21,12,12,0.0,M2018-09-09D,Race(2),,
2,12,11,5,28,9,20,1,30,5,18,3,26,26,49,9,84,3.5,3.5,0.0,M2018-09-09D,Race(2),,
3,0,7,16,23,0,0,4,4,0,4,15,19,0,11,35,46,5,5,1.0,M2018-09-09D,Race(2),,
4,0,0,0,0,0,0,0,0,1,0,0,1,1,0,0,1,31,31,0.0,M2018-09-09D,Race(2),,
5,18,12,0,30,21,5,3,29,20,4,1,25,59,21,4,84,1.65,1.65,2.0,M2018-09-09D,Race(2),,
1,14,7,2,23,24,6,0,30,22,4,0,26,60,17,2,79,2.4,2.4,1.0,M2018-09-09D,Race(3),,
2,6,9,9,24,2,18,4,24,3,10,6,19,11,37,19,67,3.8,3.8,2.0,M2018-09-09D,Race(3),,
3,6,0,8,14,0,4,14,18,0,6,6,12,6,10,28,44,6,6,0.0,M2018-09-09D,Race(3),,
4,0,2,2,4,0,0,2,2,0,2,2,4,0,4,6,10,17,15,0.0,M2018-09-09D,Race(3),,
5,2,3,6,11,1,2,3,6,0,2,4,6,3,7,13,23,6,5.5,0.0,M2018-09-09D,Race(3),,
6,0,7,3,10,3,0,5,8,1,2,3,6,4,9,11,24,15,15,3.0,M2018-09-09D,Race(3),,
7,0,0,0,0,0,0,2,2,0,0,5,5,0,0,7,7,21,21,0.0,M2018-09-09D,Race(3),,
8,2,2,0,4,0,0,0,0,0,0,0,0,2,2,0,4,11,11,0.0,M2018-09-09D,Race(3),,
1,0,0,2,2,1,0,2,3,2,0,1,3,3,0,5,8,18,18,0.0,M2018-09-09D,Race(4),,
2,9,7,5,21,16,9,4,29,9,6,3,18,34,22,12,68,4,4,1.0,M2018-09-09D,Race(4),,
3,0,0,0,0,0,0,0,0,0,1,1,2,0,1,1,2,41,41,0.0,M2018-09-09D,Race(4),,
4,0,3,0,3,2,3,2,7,1,4,2,7,3,10,4,17,13,13,0.0,M2018-09-09D,Race(4),,
5,5,5,7,17,1,3,2,6,0,5,5,10,6,13,14,33,6.5,6.5,2.0,M2018-09-09D,Race(4),,
6,7,8,2,17,7,12,5,24,8,8,4,20,22,28,11,61,5,5,3.0,M2018-09-09D,Race(4),,
7,0,0,0,0,0,0,0,0,0,0,0,0,0,0,0,0,21,21,0.0,M2018-09-09D,Race(4),,
8,3,5,14,22,2,2,13,17,6,2,3,11,11,9,30,50,4.2,4.2,0.0,M2018-09-09D,Race(4),,
9,0,0,0,0,0,0,0,0,0,0,0,0,0,0,0,0,15,15,0.0,M2018-09-09D,Race(4),,
10,6,0,0,6,0,0,2,2,0,0,7,7,6,0,9,15,9,9,0.0,M2018-09-09D,Race(4),,
11,0,2,0,2,0,0,0,0,0,0,0,0,0,2,0,2,14,14,0.0,M2018-09-09D,Race(4),,
1,16,10,2,28,22,6,1,29,11,8,2,21,49,24,5,78,3.5,3.5,1.0,M2018-09-09D,Race(5),,
2,0,0,0,0,0,1,1,2,0,0,2,2,0,1,3,4,19,19,0.0,M2018-09-09D,Race(5),,
3,0,0,6,6,1,3,6,10,3,5,3,11,4,8,15,27,10,10,3.0,M2018-09-09D,Race(5),,
4,2,3,11,16,0,1,2,3,0,2,1,3,2,6,14,22,15,15,0.0,M2018-09-09D,Race(5),,
5,7,10,6,23,6,17,2,25,9,8,5,22,22,35,13,70,2.9,2.9,0.0,M2018-09-09D,Race(5),,
6,0,3,5,8,1,2,18,21,2,3,13,18,3,8,36,47,5.5,5.5,0.0,M2018-09-09D,Race(5),,
7,0,0,0,0,0,0,0,0,0,0,0,0,0,0,0,0,15,15,0.0,M2018-09-09D,Race(5),,
8,0,0,0,0,0,0,0,0,0,0,0,0,0,0,0,0,51,51,0.0,M2018-09-09D,Race(5),,
9,3,4,0,7,0,0,0,0,1,0,0,1,4,4,0,8,8,8,2.0,M2018-09-09D,Race(5),,
10,2,0,0,2,0,0,0,0,0,0,0,0,2,0,0,2,18,18,0.0,M2018-09-09D,Race(5),,
1,0,8,6,14,2,0,1,3,2,0,2,4,4,8,9,21,5.5,5.5,0.0,M2018-09-09D,Race(6),,
2,15,7,3,25,1,1,4,6,1,6,6,13,17,14,13,44,3.6,3.6,0.0,M2018-09-09D,Race(6),,
3,3,3,2,8,0,2,1,3,0,1,2,3,3,6,5,14,13,13,0.0,M2018-09-09D,Race(6),,
4,0,0,0,0,7,14,3,24,0,0,0,0,7,14,3,24,0,0,0.0,M2018-09-09D,Race(6),,
5,0,3,5,8,0,1,2,3,0,1,0,1,0,5,7,12,7,7,0.0,M2018-09-09D,Race(6),,
6,5,0,3,8,4,1,11,16,3,2,4,9,12,3,18,33,8.5,8.5,0.0,M2018-09-09D,Race(6),,
7,0,0,2,2,0,0,0,0,0,0,0,0,0,0,2,2,14,14,0.0,M2018-09-09D,Race(6),,
8,0,2,2,4,2,1,4,7,2,4,4,10,4,7,10,21,13,13,2.0,M2018-09-09D,Race(6),,
9,0,4,0,4,0,1,4,5,0,2,4,6,0,7,8,15,11,11,1.0,M2018-09-09D,Race(6),,
10,7,3,7,17,14,7,0,21,8,6,2,16,29,16,9,54,3.8,3.8,3.0,M2018-09-09D,Race(6),,
1,0,5,9,14,1,0,3,4,0,0,5,5,1,5,17,23,9.5,9,0.0,M2018-09-09D,Race(7),,
2,0,0,2,2,16,9,4,29,2,3,0,5,18,12,6,36,9.5,11,1.0,M2018-09-09D,Race(7),,
3,7,6,5,18,0,0,0,0,5,10,1,16,12,16,6,34,4.8,5.5,0.0,M2018-09-09D,Race(7),,
4,0,2,3,5,2,3,2,7,0,1,0,1,2,6,5,13,31,31,0.0,M2018-09-09D,Race(7),,
5,17,7,4,28,1,3,2,6,18,4,4,26,36,14,10,60,2.35,2.7,0.0,M2018-09-09D,Race(7),,
6,0,5,3,8,7,12,5,24,0,0,2,2,7,17,10,34,13,15,3.0,M2018-09-09D,Race(7),,
7,0,0,4,4,0,0,0,0,0,3,4,7,0,3,8,11,9.5,9,0.0,M2018-09-09D,Race(7),,
8,2,2,0,4,2,2,13,17,1,5,5,11,5,9,18,32,6.5,6.5,0.0,M2018-09-09D,Race(7),,
9,4,3,0,7,0,0,0,0,0,0,3,3,4,3,3,10,16,18,0.0,M2018-09-09D,Race(7),,
10,0,0,0,0,0,0,2,2,0,0,1,1,0,0,3,3,11,12,2.0,M2018-09-09D,Race(7),,
11,0,0,0,0,0,0,0,0,0,0,1,1,0,0,1,1,23,26,0.0,M2018-09-09D,Race(7),,
1,8,13,2,23,5,19,5,29,5,15,3,23,18,47,10,75,4,4,0.0,M2018-09-09D,Race(8),,
2,15,5,5,25,23,7,0,30,18,7,1,26,56,19,6,81,2.1,2.1,3.0,M2018-09-09D,Race(8),,
3,0,0,0,0,0,0,0,0,0,1,0,1,0,1,0,1,61,61,0.0,M2018-09-09D,Race(8),,
4,0,2,6,8,1,3,6,10,2,2,6,10,3,7,18,28,7.5,7.5,0.0,M2018-09-09D,Race(8),,
5,4,6,11,21,1,1,17,19,1,1,12,14,6,8,40,54,7.5,7.5,2.0,M2018-09-09D,Race(8),,
6,0,0,0,0,0,0,0,0,0,0,0,0,0,0,0,0,21,21,0.0,M2018-09-09D,Race(8),,
7,0,0,3,3,0,0,1,1,0,0,0,0,0,0,4,4,19,19,0.0,M2018-09-09D,Race(8),,
8,0,0,0,0,0,0,0,0,0,0,0,0,0,0,0,0,41,41,0.0,M2018-09-09D,Race(8),,
9,0,0,0,0,0,0,0,0,0,0,0,0,0,0,0,0,26,26,0.0,M2018-09-09D,Race(8),,
10,0,0,0,0,0,0,0,0,0,0,0,0,0,0,0,0,61,61,0.0,M2018-09-09D,Race(8),,
11,3,4,3,10,0,0,1,1,0,0,4,4,3,4,8,15,9,9,1.0,M2018-09-09D,Race(8),,
1,9,6,5,20,14,6,3,23,8,5,2,15,31,17,10,58,4.8,4.8,2.0,M2018-09-09D,Race(9),,
2,0,2,5,7,0,4,1,5,0,4,5,9,0,10,11,21,20,19,0.0,M2018-09-09D,Race(9),,
3,0,0,0,0,0,0,0,0,0,0,0,0,0,0,0,0,26,26,0.0,M2018-09-09D,Race(9),,
4,4,3,5,12,2,4,3,9,3,3,2,8,9,10,10,29,7,7,0.0,M2018-09-09D,Race(9),,
5,3,8,2,13,5,9,4,18,5,5,4,14,13,22,10,45,9,9,0.0,M2018-09-09D,Race(9),,
6,0,4,3,7,0,2,1,3,0,1,1,2,0,7,5,12,7,6.5,0.0,M2018-09-09D,Race(9),,
7,5,0,2,7,0,0,3,3,1,0,3,4,6,0,8,14,13,13,1.0,M2018-09-09D,Race(9),,
8,0,2,2,4,3,1,2,6,1,2,4,7,4,5,8,17,9,9,0.0,M2018-09-09D,Race(9),,
9,0,0,0,0,0,0,0,0,0,0,0,0,0,0,0,0,17,17,0.0,M2018-09-09D,Race(9),,
10,9,5,6,20,6,4,13,23,8,6,5,19,23,15,24,62,3.5,3.4,3.0,M2018-09-09D,Race(9),,
11,0,0,0,0,0,0,0,0,0,0,0,0,0,0,0,0,51,51,0.0,M2018-09-09D,Race(9),,
12,0,0,0,0,0,0,0,0,0,0,0,0,0,0,0,0,34,34,0.0,M2018-09-09D,Race(9),,
1,4,3,3,10,2,0,0,2,3,0,0,3,9,3,3,15,9,9,0.0,M2018-09-12D,Race(1),,
2,0,8,7,15,5,6,4,15,7,9,2,18,12,23,13,48,3.6,3.8,0.0,M2018-09-12D,Race(1),,
3,0,8,6,14,9,1,5,15,3,3,5,11,12,12,16,40,12,12,3.0,M2018-09-12D,Race(1),,
4,0,0,2,2,0,0,10,10,0,0,2,2,0,0,14,14,17,17,2.0,M2018-09-12D,Race(1),,
5,11,5,5,21,6,9,6,21,5,8,9,22,22,22,20,64,4.4,4.5,0.0,M2018-09-12D,Race(1),,
6,0,3,3,6,0,8,1,9,0,1,0,1,0,12,4,16,8.5,8.5,0.0,M2018-09-12D,Race(1),,
7,0,0,0,0,0,0,0,0,0,0,1,1,0,0,1,1,12,12,0.0,M2018-09-12D,Race(1),,
8,15,3,4,22,8,6,4,18,8,5,7,20,31,14,15,60,2.9,2.8,1.0,M2018-09-12D,Race(1),,
1,10,5,5,20,2,1,3,6,4,1,2,7,16,7,10,33,5,5,0.0,M2018-09-12D,Race(2),,
2,3,0,7,10,0,2,1,3,0,4,0,4,3,6,8,17,8,7,0.0,M2018-09-12D,Race(2),,
3,0,8,3,11,0,1,6,7,1,1,7,9,1,10,16,27,9,9,0.0,M2018-09-12D,Race(2),,
4,0,0,0,0,8,3,3,14,0,3,3,6,8,6,6,20,11,11,1.0,M2018-09-12D,Race(2),,
5,0,0,0,0,0,0,8,8,0,1,1,2,0,1,9,10,51,51,0.0,M2018-09-12D,Race(2),,
6,7,6,5,18,6,8,7,21,4,11,9,24,17,25,21,63,4.2,4.2,0.0,M2018-09-12D,Race(2),,
7,0,4,0,4,0,8,0,8,0,0,0,0,0,12,0,12,16,16,0.0,M2018-09-12D,Race(2),,
8,7,5,8,20,13,5,1,19,17,3,0,20,37,13,9,59,4.4,4.4,0.0,M2018-09-12D,Race(2),,
9,0,0,0,0,0,0,0,0,0,1,0,1,0,1,0,1,34,34,3.0,M2018-09-12D,Race(2),,
10,0,0,2,2,0,0,0,0,0,0,1,1,0,0,3,3,21,21,0.0,M2018-09-12D,Race(2),,
11,3,2,0,5,0,2,2,4,0,1,3,4,3,5,5,13,9,9,2.0,M2018-09-12D,Race(2),,
12,0,0,0,0,0,0,0,0,0,0,0,0,0,0,0,0,26,26,0.0,M2018-09-12D,Race(2),,
1,11,2,8,21,3,9,5,17,3,3,5,11,17,14,18,49,6.5,6.5,0.0,M2018-09-12D,Race(3),,
2,8,2,5,15,1,7,5,13,3,3,7,13,12,12,17,41,3.8,3.8,2.0,M2018-09-12D,Race(3),,
3,0,2,8,10,8,5,4,17,2,8,2,12,10,15,14,39,8,8,0.0,M2018-09-12D,Race(3),,
4,5,7,3,15,16,2,4,22,15,3,4,22,36,12,11,59,3.8,3.8,0.0,M2018-09-12D,Race(3),,
5,0,3,0,3,0,1,8,9,0,3,2,5,0,7,10,17,8,8,0.0,M2018-09-12D,Race(3),,
6,6,12,4,22,2,6,4,12,3,6,5,14,11,24,13,48,5.5,5.5,3.0,M2018-09-12D,Race(3),,
7,0,0,2,2,0,0,0,0,0,0,1,1,0,0,3,3,26,26,0.0,M2018-09-12D,Race(3),,
8,0,0,0,0,0,0,0,0,0,0,0,0,0,0,0,0,19,19,0.0,M2018-09-12D,Race(3),,
9,0,2,0,2,0,0,0,0,0,0,0,0,0,2,0,2,12,11,1.0,M2018-09-12D,Race(3),,
1,11,13,0,24,7,6,4,17,4,9,7,20,22,28,11,61,3.9,4,0.0,M2018-09-12D,Race(4),,
2,15,12,3,30,12,8,0,20,16,5,1,22,43,25,4,72,2.5,2.4,0.0,M2018-09-12D,Race(4),,
3,0,0,0,0,1,0,8,9,1,1,0,2,2,1,8,11,19,19,0.0,M2018-09-12D,Race(4),,
4,0,0,2,2,0,0,2,2,0,1,1,2,0,1,5,6,19,19,1.0,M2018-09-12D,Race(4),,
5,0,0,3,3,0,0,0,0,0,0,1,1,0,0,4,4,19,19,0.0,M2018-09-12D,Race(4),,
6,2,3,6,11,2,6,7,15,2,5,4,11,6,14,17,37,6.5,6.5,0.0,M2018-09-12D,Race(4),,
7,0,0,0,0,0,0,0,0,1,0,0,1,1,0,0,1,31,31,0.0,M2018-09-12D,Race(4),,
8,0,0,13,13,0,1,6,7,1,2,6,9,1,3,25,29,10,10,2.0,M2018-09-12D,Race(4),,
9,0,0,0,0,0,1,0,1,0,1,0,1,0,2,0,2,26,26,0.0,M2018-09-12D,Race(4),,
10,0,0,0,0,0,8,0,8,0,1,1,2,0,9,1,10,34,34,0.0,M2018-09-12D,Race(4),,
11,2,2,3,7,8,0,3,11,1,1,5,7,11,3,11,25,9,9,3.0,M2018-09-12D,Race(4),,
12,0,0,0,0,0,0,0,0,0,0,0,0,0,0,0,0,51,51,0.0,M2018-09-12D,Race(4),,
1,2,14,0,16,2,4,4,10,5,5,2,12,9,23,6,38,5.5,5,0.0,M2018-09-12D,Race(5),,
2,3,4,5,12,6,4,3,13,6,4,4,14,15,12,12,39,4.8,5,0.0,M2018-09-12D,Race(5),,
3,0,0,0,0,0,0,0,0,0,0,1,1,0,0,1,1,31,31,0.0,M2018-09-12D,Race(5),,
4,11,7,4,22,10,7,9,26,11,5,3,19,32,19,16,67,3.1,3.2,1.0,M2018-09-12D,Race(5),,
5,0,0,0,0,0,0,0,0,0,0,0,0,0,0,0,0,26,26,0.0,M2018-09-12D,Race(5),,
6,0,2,0,2,0,0,0,0,0,1,0,1,0,3,0,3,14,14,0.0,M2018-09-12D,Race(5),,
7,4,0,6,10,3,2,4,9,1,5,4,10,8,7,14,29,13,13,3.0,M2018-09-12D,Race(5),,
8,0,0,0,0,0,0,0,0,0,0,1,1,0,0,1,1,21,21,0.0,M2018-09-12D,Race(5),,
9,0,0,4,4,0,8,4,12,1,0,4,5,1,8,12,21,8,7.5,0.0,M2018-09-12D,Race(5),,
10,3,0,6,9,8,0,0,8,1,0,1,2,12,0,7,19,23,26,0.0,M2018-09-12D,Race(5),,
11,7,3,5,15,1,5,6,12,1,6,6,13,9,14,17,40,9,9,2.0,M2018-09-12D,Race(5),,
12,0,0,0,0,0,0,0,0,0,0,0,0,0,0,0,0,34,34,0.0,M2018-09-12D,Race(5),,
1,0,0,0,0,1,6,10,17,5,6,12,23,6,12,22,40,6.5,6.5,0.0,M2018-09-12D,Race(6),,
2,5,3,18,26,2,3,0,5,2,4,0,6,9,10,18,37,7,6.5,1.0,M2018-09-12D,Race(6),,
3,21,5,2,28,6,8,4,18,5,7,5,17,32,20,11,63,3.7,3.8,0.0,M2018-09-12D,Race(6),,
4,2,3,0,5,0,0,1,1,0,0,2,2,2,3,3,8,15,14,0.0,M2018-09-12D,Race(6),,
5,0,2,3,5,8,3,2,13,1,4,1,6,9,9,6,24,14,15,0.0,M2018-09-12D,Race(6),,
6,0,0,0,0,0,0,0,0,0,0,0,0,0,0,0,0,13,13,0.0,M2018-09-12D,Race(6),,
7,0,7,0,7,1,0,8,9,0,1,0,1,1,8,8,17,6.5,6,3.0,M2018-09-12D,Race(6),,
8,2,5,7,14,12,2,5,19,13,2,3,18,27,9,15,51,6,6,0.0,M2018-09-12D,Race(6),,
9,0,0,0,0,0,8,0,8,0,0,1,1,0,8,1,9,16,17,0.0,M2018-09-12D,Race(6),,
10,0,5,0,5,0,0,0,0,0,2,1,3,0,7,1,8,17,17,0.0,M2018-09-12D,Race(6),,
11,0,0,0,0,0,0,0,0,0,0,1,1,0,0,1,1,17,18,2.0,M2018-09-12D,Race(6),,
1,0,0,0,0,0,1,2,3,0,0,4,4,0,1,6,7,18,18,0.0,M2018-09-12D,Race(7),,
2,0,0,0,0,0,0,0,0,0,0,1,1,0,0,1,1,21,21,0.0,M2018-09-12D,Race(7),,
3,4,12,8,24,2,6,8,16,5,4,4,13,11,22,20,53,7,7,0.0,M2018-09-12D,Race(7),,
4,0,0,0,0,0,0,0,0,0,0,1,1,0,0,1,1,15,15,0.0,M2018-09-12D,Race(7),,
5,5,3,7,15,3,8,6,17,5,6,6,17,13,17,19,49,5.5,5.5,0.0,M2018-09-12D,Race(7),,
6,5,5,7,17,8,2,3,13,3,6,4,13,16,13,14,43,7.5,7.5,0.0,M2018-09-12D,Race(7),,
7,0,0,3,3,0,2,1,3,0,0,2,2,0,2,6,8,13,12,2.0,M2018-09-12D,Race(7),,
8,16,10,2,28,17,3,2,22,13,8,3,24,46,21,7,74,2.5,2.5,1.0,M2018-09-12D,Race(7),,
9,0,0,0,0,0,0,8,8,0,0,1,1,0,0,9,9,14,14,0.0,M2018-09-12D,Race(7),,
10,0,0,0,0,0,0,0,0,0,0,0,0,0,0,0,0,41,41,0.0,M2018-09-12D,Race(7),,
11,0,0,0,0,0,0,0,0,0,0,0,0,0,0,0,0,51,51,0.0,M2018-09-12D,Race(7),,
12,0,0,3,3,0,8,0,8,0,2,0,2,0,10,3,13,15,15,3.0,M2018-09-12D,Race(7),,
1,2,0,0,2,5,8,1,14,6,4,2,12,13,12,3,28,10,10,0.0,M2018-09-12D,Race(8),,
2,7,7,0,14,3,4,4,11,4,6,7,17,14,17,11,42,5.5,5.5,0.0,M2018-09-12D,Race(8),,
3,0,6,8,14,0,4,3,7,2,0,5,7,2,10,16,28,6.5,6.5,0.0,M2018-09-12D,Race(8),,
4,6,5,0,11,5,3,7,15,7,1,4,12,18,9,11,38,7.5,7,2.0,M2018-09-12D,Race(8),,
5,5,10,8,23,4,6,7,17,4,9,6,19,13,25,21,59,3.6,3.6,0.0,M2018-09-12D,Race(8),,
6,0,0,2,2,0,0,0,0,0,0,0,0,0,0,2,2,16,16,0.0,M2018-09-12D,Race(8),,
7,0,2,2,4,0,0,0,0,0,0,1,1,0,2,3,5,15,15,3.0,M2018-09-12D,Race(8),,
8,0,0,2,2,8,0,0,8,1,1,0,2,9,1,2,12,14,14,0.0,M2018-09-12D,Race(8),,
9,10,0,8,18,5,5,8,18,2,5,1,8,17,10,17,44,8.5,8.5,1.0,M2018-09-12D,Race(8),,
10,0,0,0,0,0,0,0,0,0,0,0,0,0,0,0,0,21,21,0.0,M2018-09-12D,Race(8),,
11,0,0,0,0,0,0,0,0,0,0,0,0,0,0,0,0,34,34,0.0,M2018-09-12D,Race(8),,
12,0,0,0,0,0,0,0,0,0,0,0,0,0,0,0,0,26,26,0.0,M2018-09-12D,Race(8),,
1,0,15,6,21,7,13,6,26,10,6,4,20,17,34,16,67,4.8,4.8,3.0,M2018-09-22D,Race(1),,
2,0,0,0,0,0,0,1,1,0,0,1,1,0,0,2,2,34,34,2.0,M2018-09-22D,Race(1),,
3,6,2,13,21,0,2,2,4,0,3,6,9,6,7,21,34,9,9,0.0,M2018-09-22D,Race(1),,
4,4,2,5,11,0,0,1,1,0,0,2,2,4,2,8,14,15,15,0.0,M2018-09-22D,Race(1),,
5,5,0,2,7,0,4,15,19,1,2,7,10,6,6,24,36,8,8,1.0,M2018-09-22D,Race(1),,
6,15,8,2,25,20,7,2,29,12,9,3,24,47,24,7,78,2.2,2.2,0.0,M2018-09-22D,Race(1),,
7,0,3,0,3,1,3,2,6,1,5,1,7,2,11,3,16,8,8,0.0,M2018-09-22D,Race(1),,
8,0,0,0,0,2,0,1,3,2,1,2,5,4,1,3,8,17,17,0.0,M2018-09-22D,Race(1),,
9,0,0,2,2,0,0,0,0,0,0,0,0,0,0,2,2,31,31,0.0,M2018-09-22D,Race(1),,
10,0,0,0,0,0,0,0,0,0,0,0,0,0,0,0,0,51,51,0.0,M2018-09-22D,Race(1),,
11,0,0,0,0,0,1,0,1,0,0,0,0,0,1,0,1,17,17,0.0,M2018-09-22D,Race(1),,
12,0,0,0,0,0,0,0,0,0,0,0,0,0,0,0,0,101,101,0.0,M2018-09-22D,Race(1),,
1,7,5,2,14,4,16,4,24,4,7,2,13,15,28,8,51,8,8,0.0,M2018-09-22D,Race(10),,
2,8,4,13,25,7,7,14,28,9,7,6,22,24,18,33,75,4.6,4.6,0.0,M2018-09-22D,Race(10),,
3,0,3,3,6,0,0,0,0,0,0,0,0,0,3,3,6,21,21,0.0,M2018-09-22D,Race(10),,
4,6,8,7,21,15,5,3,23,7,4,2,13,28,17,12,57,4.6,4.6,2.0,M2018-09-22D,Race(10),,
5,5,3,3,11,3,0,0,3,3,3,3,9,11,6,6,23,9,9,3.0,M2018-09-22D,Race(10),,
6,2,0,0,2,0,0,1,1,0,0,2,2,2,0,3,5,21,21,0.0,M2018-09-22D,Race(10),,
7,0,0,0,0,0,0,0,0,0,0,0,0,0,0,0,0,26,26,0.0,M2018-09-22D,Race(10),,
8,0,2,0,2,0,0,0,0,0,0,0,0,0,2,0,2,13,13,0.0,M2018-09-22D,Race(10),,
9,0,0,0,0,0,0,0,0,1,0,0,1,1,0,0,1,41,41,0.0,M2018-09-22D,Race(10),,
10,2,3,0,5,1,0,2,3,0,1,3,4,3,4,5,12,8,8,1.0,M2018-09-22D,Race(10),,
11,0,2,0,2,0,1,1,2,0,1,0,1,0,4,1,5,26,26,0.0,M2018-09-22D,Race(10),,
12,0,0,2,2,0,0,0,0,0,0,0,0,0,0,2,2,41,41,0.0,M2018-09-22D,Race(10),,
13,0,0,0,0,0,0,5,5,1,2,8,11,1,2,13,16,13,13,0.0,M2018-09-22D,Race(10),,
14,0,0,0,0,0,1,0,1,1,1,0,2,1,2,0,3,8,8,0.0,M2018-09-22D,Race(10),,
1,4,0,2,6,4,3,5,12,4,2,4,10,12,5,11,28,7,7,0.0,M2018-09-22D,Race(2),,
2,0,0,3,3,0,0,1,1,0,0,2,2,0,0,6,6,34,34,0.0,M2018-09-22D,Race(2),,
3,3,9,5,17,6,10,1,17,7,2,0,9,16,21,6,43,10,10,0.0,M2018-09-22D,Race(2),,
4,0,2,0,2,1,1,2,4,1,2,2,5,2,5,4,11,14,14,1.0,M2018-09-22D,Race(2),,
5,8,5,0,13,1,1,2,4,4,2,3,9,13,8,5,26,4.8,4.8,0.0,M2018-09-22D,Race(2),,
6,6,6,0,12,0,1,2,3,1,2,4,7,7,9,6,22,8,8,2.0,M2018-09-22D,Race(2),,
7,2,0,6,8,2,6,14,22,1,4,4,9,5,10,24,39,10,10,0.0,M2018-09-22D,Race(2),,
8,0,5,5,10,15,4,1,20,6,7,3,16,21,16,9,46,5,5,0.0,M2018-09-22D,Race(2),,
9,0,0,3,3,0,1,0,1,0,0,0,0,0,1,3,4,14,14,0.0,M2018-09-22D,Race(2),,
10,3,0,2,5,1,2,1,4,0,2,2,4,4,4,5,13,9,9,0.0,M2018-09-22D,Race(2),,
11,0,0,0,0,0,0,0,0,0,0,0,0,0,0,0,0,34,34,0.0,M2018-09-22D,Race(2),,
12,4,3,4,11,0,1,1,2,2,3,2,7,6,7,7,20,9,9,3.0,M2018-09-22D,Race(2),,
1,5,13,4,22,18,6,4,28,12,4,4,20,35,23,12,70,5,5,3.0,M2018-09-22D,Race(3),,
2,0,0,0,0,0,1,0,1,0,0,0,0,0,1,0,1,51,51,0.0,M2018-09-22D,Race(3),,
3,14,4,7,25,6,16,3,25,7,8,3,18,27,28,13,68,4,4,0.0,M2018-09-22D,Race(3),,
4,0,0,3,3,0,2,1,3,2,2,3,7,2,4,7,13,13,13,0.0,M2018-09-22D,Race(3),,
5,0,2,0,2,0,0,1,1,0,2,0,2,0,4,1,5,11,11,0.0,M2018-09-22D,Race(3),,
6,4,3,0,7,0,0,0,0,0,1,0,1,4,4,0,8,10,10,0.0,M2018-09-22D,Race(3),,
7,2,2,11,15,1,1,1,3,1,2,6,9,4,5,18,27,6,6,0.0,M2018-09-22D,Race(3),,
8,0,0,3,3,3,3,14,20,1,4,3,8,4,7,20,31,12,12,0.0,M2018-09-22D,Race(3),,
9,0,0,0,0,0,0,0,0,1,0,0,1,1,0,0,1,51,51,0.0,M2018-09-22D,Race(3),,
10,2,3,0,5,2,0,4,6,2,2,4,8,6,5,8,19,7,7,0.0,M2018-09-22D,Race(3),,
11,3,3,2,8,0,1,2,3,0,0,2,2,3,4,6,13,15,15,1.0,M2018-09-22D,Race(3),,
12,0,0,0,0,0,0,0,0,0,0,0,0,0,0,0,0,31,31,0.0,M2018-09-22D,Race(3),,
13,0,0,0,0,0,0,0,0,0,0,0,0,0,0,0,0,71,81,0.0,M2018-09-22D,Race(3),,
14,0,0,0,0,0,0,0,0,0,1,1,2,0,1,1,2,26,26,2.0,M2018-09-22D,Race(3),,
1,9,7,0,16,6,13,3,22,8,4,3,15,23,24,6,53,5,5,2.0,M2018-09-22D,Race(4),,
2,0,3,0,3,1,3,4,8,5,3,6,14,6,9,10,25,10,10,0.0,M2018-09-22D,Race(4),,
3,2,0,11,13,2,1,1,4,3,4,1,8,7,5,13,25,10,10,0.0,M2018-09-22D,Race(4),,
4,0,2,2,4,2,6,10,18,1,7,1,9,3,15,13,31,31,31,1.0,M2018-09-22D,Race(4),,
5,5,3,10,18,0,3,3,6,0,1,3,4,5,7,16,28,5.5,5.5,0.0,M2018-09-22D,Race(4),,
6,6,3,2,11,1,1,3,5,0,0,3,3,7,4,8,19,13,13,0.0,M2018-09-22D,Race(4),,
7,0,3,0,3,1,0,1,2,2,1,1,4,3,4,2,9,15,15,0.0,M2018-09-22D,Race(4),,
8,0,0,0,0,0,0,0,0,0,1,0,1,0,1,0,1,51,51,0.0,M2018-09-22D,Race(4),,
9,0,2,0,2,1,0,1,2,1,0,2,3,2,2,3,7,7,7,0.0,M2018-09-22D,Race(4),,
10,0,0,0,0,0,0,0,0,0,0,0,0,0,0,0,0,51,51,0.0,M2018-09-22D,Race(4),,
11,8,5,5,18,16,3,3,22,6,4,3,13,30,12,11,53,4,4,3.0,M2018-09-22D,Race(4),,
12,0,0,0,0,0,0,0,0,0,0,0,0,0,0,0,0,71,67,0.0,M2018-09-22D,Race(4),,
13,0,2,0,2,0,0,1,1,0,1,3,4,0,3,4,7,12,12,0.0,M2018-09-22D,Race(4),,
14,0,0,0,0,0,0,0,0,0,0,0,0,0,0,0,0,81,81,0.0,M2018-09-22D,Race(4),,
1,2,4,11,17,6,3,14,23,5,4,7,16,13,11,32,56,6.5,6.5,0.0,M2018-09-22D,Race(5),,
2,2,0,0,2,1,0,0,1,0,1,3,4,3,1,3,7,31,31,0.0,M2018-09-22D,Race(5),,
3,21,5,0,26,3,17,7,27,6,9,4,19,30,31,11,72,2.5,2.5,0.0,M2018-09-22D,Race(5),,
4,0,3,0,3,0,0,0,0,0,0,0,0,0,3,0,3,26,26,0.0,M2018-09-22D,Race(5),,
5,5,15,5,25,14,8,3,25,11,8,1,20,30,31,9,70,3.5,3.5,2.0,M2018-09-22D,Race(5),,
6,0,0,0,0,2,2,2,6,1,2,3,6,3,4,5,12,34,34,0.0,M2018-09-22D,Race(5),,
7,0,0,0,0,3,0,0,3,3,0,0,3,6,0,0,6,9,9,3.0,M2018-09-22D,Race(5),,
8,0,0,9,9,1,0,4,5,0,0,4,4,1,0,17,18,13,13,1.0,M2018-09-22D,Race(5),,
9,0,0,3,3,0,0,0,0,0,1,1,2,0,1,4,5,26,26,0.0,M2018-09-22D,Race(5),,
10,0,3,0,3,0,0,0,0,0,1,2,3,0,4,2,6,19,19,0.0,M2018-09-22D,Race(5),,
11,0,0,2,2,0,0,0,0,0,0,1,1,0,0,3,3,31,31,0.0,M2018-09-22D,Race(5),,
12,0,0,0,0,0,0,0,0,0,0,0,0,0,0,0,0,51,51,0.0,M2018-09-22D,Race(5),,
13,0,0,0,0,0,0,0,0,0,0,0,0,0,0,0,0,81,81,0.0,M2018-09-22D,Race(5),,
14,0,0,0,0,0,0,0,0,0,0,0,0,0,0,0,0,71,67,0.0,M2018-09-22D,Race(5),,
1,0,0,0,0,0,1,1,2,0,1,1,2,0,2,2,4,26,26,0.0,M2018-09-22D,Race(6),,
2,19,7,4,30,24,5,1,30,20,3,0,23,63,15,5,83,2.7,2.7,2.0,M2018-09-22D,Race(6),,
3,2,0,0,2,1,0,0,1,1,1,0,2,4,1,0,5,17,17,0.0,M2018-09-22D,Race(6),,
4,0,0,0,0,0,0,0,0,1,0,1,2,1,0,1,2,34,34,0.0,M2018-09-22D,Race(6),,
5,0,9,8,17,3,14,5,22,1,7,7,15,4,30,20,54,7.5,7.5,3.0,M2018-09-22D,Race(6),,
6,0,0,0,0,0,0,0,0,1,1,1,3,1,1,1,3,19,19,0.0,M2018-09-22D,Race(6),,
7,0,3,2,5,1,4,13,18,1,7,5,13,2,14,20,36,6,6,1.0,M2018-09-22D,Race(6),,
8,7,7,8,22,1,5,4,10,0,3,9,12,8,15,21,44,6.5,6.5,0.0,M2018-09-22D,Race(6),,
9,0,0,3,3,0,0,1,1,0,0,0,0,0,0,4,4,17,17,0.0,M2018-09-22D,Race(6),,
10,0,0,0,0,0,0,0,0,0,0,0,0,0,0,0,0,71,67,0.0,M2018-09-22D,Race(6),,
11,2,4,5,11,0,1,5,6,1,3,2,6,3,8,12,23,6.5,6.5,0.0,M2018-09-22D,Race(6),,
12,0,0,0,0,0,0,0,0,0,0,0,0,0,0,0,0,16,16,0.0,M2018-09-22D,Race(6),,
1,8,5,9,22,2,15,3,20,4,8,5,17,14,28,17,59,5,5,0.0,M2018-09-22D,Race(7),,
2,0,0,0,0,1,0,0,1,2,0,0,2,3,0,0,3,26,26,0.0,M2018-09-22D,Race(7),,
3,0,2,3,5,2,2,3,7,1,3,2,6,3,7,8,18,6,6,1.0,M2018-09-22D,Race(7),,
4,10,7,0,17,7,3,13,23,5,3,6,14,22,13,19,54,4.2,4.2,0.0,M2018-09-22D,Race(7),,
5,5,7,12,24,15,9,4,28,12,7,3,22,32,23,19,74,4,4,0.0,M2018-09-22D,Race(7),,
6,7,3,3,13,3,1,5,9,1,2,4,7,11,6,12,29,5.5,5.5,0.0,M2018-09-22D,Race(7),,
7,0,0,0,0,0,0,0,0,0,0,0,0,0,0,0,0,26,26,0.0,M2018-09-22D,Race(7),,
8,0,3,0,3,0,0,0,0,0,1,0,1,0,4,0,4,13,13,3.0,M2018-09-22D,Race(7),,
9,0,3,3,6,0,0,2,2,1,2,6,9,1,5,11,17,13,13,2.0,M2018-09-22D,Race(7),,
10,0,0,0,0,0,0,0,0,0,0,0,0,0,0,0,0,41,41,0.0,M2018-09-22D,Race(7),,
1,3,2,0,5,0,0,1,1,0,0,1,1,3,2,2,7,15,15,3.0,M2018-09-22D,Race(8),,
2,7,10,5,22,6,18,4,28,8,6,5,19,21,34,14,69,6,6,2.0,M2018-09-22D,Race(8),,
3,0,0,0,0,0,0,0,0,1,0,0,1,1,0,0,1,26,26,0.0,M2018-09-22D,Race(8),,
4,0,0,0,0,0,0,0,0,0,1,0,1,0,1,0,1,41,41,0.0,M2018-09-22D,Race(8),,
5,10,9,8,27,19,6,2,27,10,11,1,22,39,26,11,76,4,4,0.0,M2018-09-22D,Race(8),,
6,0,0,5,5,1,0,3,4,2,1,7,10,3,1,15,19,7,7,0.0,M2018-09-22D,Race(8),,
7,0,2,0,2,1,0,0,1,0,0,0,0,1,2,0,3,12,12,0.0,M2018-09-22D,Race(8),,
8,0,0,3,3,1,0,1,2,0,1,3,4,1,1,7,9,11,11,0.0,M2018-09-22D,Race(8),,
9,0,0,0,0,0,0,0,0,0,0,0,0,0,0,0,0,61,61,0.0,M2018-09-22D,Race(8),,
10,5,0,3,8,1,5,16,22,3,5,3,11,9,10,22,41,5.5,5.5,0.0,M2018-09-22D,Race(8),,
11,0,4,0,4,0,0,0,0,0,0,0,0,0,4,0,4,15,15,0.0,M2018-09-22D,Race(8),,
12,5,3,6,14,1,1,3,5,2,1,6,9,8,5,15,28,6,6,1.0,M2018-09-22D,Race(8),,
1,5,2,0,7,3,4,3,10,2,2,3,7,10,8,6,24,8.5,8.5,0.0,M2018-09-22D,Race(9),,
2,2,5,0,7,1,1,1,3,2,4,1,7,5,10,2,17,15,15,0.0,M2018-09-22D,Race(9),,
3,0,0,0,0,0,0,0,0,0,0,2,2,0,0,2,2,31,31,0.0,M2018-09-22D,Race(9),,
4,8,2,10,20,17,6,1,24,17,5,2,24,42,13,13,68,4.8,4.8,0.0,M2018-09-22D,Race(9),,
5,0,0,3,3,0,0,1,1,0,0,1,1,0,0,5,5,15,15,0.0,M2018-09-22D,Race(9),,
6,9,13,2,24,6,14,5,25,2,11,6,19,17,38,13,68,4.6,4.6,3.0,M2018-09-22D,Race(9),,
7,0,0,0,0,0,0,0,0,0,0,0,0,0,0,0,0,41,41,0.0,M2018-09-22D,Race(9),,
8,0,2,0,2,0,0,2,2,0,0,2,2,0,2,4,6,8.5,8.5,0.0,M2018-09-22D,Race(9),,
9,0,0,0,0,0,0,0,0,0,0,0,0,0,0,0,0,81,81,0.0,M2018-09-22D,Race(9),,
10,0,3,6,9,0,0,1,1,0,0,2,2,0,3,9,12,12,12,1.0,M2018-09-22D,Race(9),,
11,6,3,6,15,2,4,15,21,1,3,7,11,9,10,28,47,6,6,0.0,M2018-09-22D,Race(9),,
12,0,0,0,0,1,1,0,2,1,0,0,1,2,1,0,3,15,15,0.0,M2018-09-22D,Race(9),,
13,0,0,3,3,0,0,1,1,0,0,0,0,0,0,4,4,15,15,2.0,M2018-09-22D,Race(9),,
14,0,0,0,0,0,0,0,0,1,1,0,2,1,1,0,2,19,19,0.0,M2018-09-22D,Race(9),,
1,0,0,0,0,0,0,8,8,0,0,0,0,0,0,8,8,0,0,0.0,M2018-09-26D,Race(1),,
2,0,2,3,5,0,8,1,9,0,1,0,1,0,11,4,15,15,15,0.0,M2018-09-26D,Race(1),,
3,2,5,0,7,1,2,5,8,0,4,4,8,3,11,9,23,7.5,7.5,2.0,M2018-09-26D,Race(1),,
4,0,5,10,15,1,1,5,7,1,3,8,12,2,9,23,34,7.5,7.5,0.0,M2018-09-26D,Race(1),,
5,0,0,0,0,0,0,0,0,0,0,0,0,0,0,0,0,34,34,0.0,M2018-09-26D,Race(1),,
6,3,6,3,12,2,0,3,5,2,0,2,4,7,6,8,21,13,13,1.0,M2018-09-26D,Race(1),,
7,2,0,0,2,8,1,2,11,0,0,1,1,10,1,3,14,34,34,0.0,M2018-09-26D,Race(1),,
8,0,0,5,5,0,1,1,2,0,1,1,2,0,2,7,9,11,11,0.0,M2018-09-26D,Race(1),,
9,0,4,2,6,0,0,0,0,2,2,0,4,2,6,2,10,18,17,0.0,M2018-09-26D,Race(1),,
10,21,2,2,25,11,9,0,20,13,6,4,23,45,17,6,68,1.95,2,3.0,M2018-09-26D,Race(1),,
11,2,6,5,13,7,8,4,19,9,8,6,23,18,22,15,55,6,6,0.0,M2018-09-26D,Race(1),,
12,0,0,0,0,0,0,0,0,0,1,0,1,0,1,0,1,51,51,0.0,M2018-09-26D,Race(1),,
1,11,5,9,25,9,4,2,15,8,2,1,11,28,11,12,51,3.5,3.5,2.0,M2018-09-26D,Race(2),,
2,0,2,3,5,0,8,0,8,0,0,0,0,0,10,3,13,26,26,0.0,M2018-09-26D,Race(2),,
3,3,8,2,13,4,2,1,7,4,0,0,4,11,10,3,24,5.5,5.5,0.0,M2018-09-26D,Race(2),,
4,0,0,0,0,0,1,8,9,1,2,3,6,1,3,11,15,13,13,0.0,M2018-09-26D,Race(2),,
5,0,0,0,0,0,1,2,3,0,4,3,7,0,5,5,10,21,21,0.0,M2018-09-26D,Race(2),,
6,0,6,0,6,2,0,2,4,2,0,4,6,4,6,6,16,4.4,4.5,0.0,M2018-09-26D,Race(2),,
7,4,0,8,12,8,3,6,17,4,3,4,11,16,6,18,40,11,11,3.0,M2018-09-26D,Race(2),,
8,6,4,0,10,3,7,3,13,2,7,3,12,11,18,6,35,8,8,0.0,M2018-09-26D,Race(2),,
9,2,0,0,2,0,0,0,0,0,0,1,1,2,0,1,3,26,26,0.0,M2018-09-26D,Race(2),,
10,0,2,5,7,2,2,3,7,2,6,4,12,4,10,12,26,21,21,0.0,M2018-09-26D,Race(2),,
11,4,3,3,10,2,2,3,7,3,2,3,8,9,7,9,25,7.5,7,1.0,M2018-09-26D,Race(2),,
12,0,0,0,0,0,0,0,0,0,0,0,0,0,0,0,0,71,71,0.0,M2018-09-26D,Race(2),,
1,7,6,4,17,8,4,2,14,6,4,1,11,21,14,7,42,4.2,4,0.0,M2018-09-26D,Race(3),,
2,5,0,2,7,3,4,2,9,0,4,2,6,8,8,6,22,6.5,6,2.0,M2018-09-26D,Race(3),,
3,0,0,2,2,0,0,2,2,0,0,2,2,0,0,6,6,13,11,0.0,M2018-09-26D,Race(3),,
4,5,4,3,12,0,1,5,6,0,1,6,7,5,6,14,25,13,11,0.0,M2018-09-26D,Race(3),,
5,6,10,3,19,4,5,5,14,7,6,3,16,17,21,11,49,3.2,3.5,0.0,M2018-09-26D,Race(3),,
6,5,3,10,18,4,4,3,11,11,4,2,17,20,11,15,46,7.5,7,0.0,M2018-09-26D,Race(3),,
7,0,7,0,7,1,1,3,5,1,0,6,7,2,8,9,19,21,21,1.0,M2018-09-26D,Race(3),,
8,0,0,0,0,0,0,0,0,0,1,0,1,0,1,0,1,71,61,0.0,M2018-09-26D,Race(3),,
9,2,0,3,5,8,3,0,11,0,2,0,2,10,5,3,18,11,11,0.0,M2018-09-26D,Race(3),,
10,0,0,0,0,2,0,8,10,1,0,3,4,3,0,11,14,26,26,0.0,M2018-09-26D,Race(3),,
11,0,0,0,0,0,8,0,8,0,1,0,1,0,9,0,9,26,21,0.0,M2018-09-26D,Race(3),,
12,0,0,3,3,0,0,0,0,0,3,1,4,0,3,4,7,15,15,3.0,M2018-09-26D,Race(3),,
1,0,0,0,0,0,1,1,2,0,6,4,10,0,7,5,12,15,15,0.0,M2018-09-26D,Race(4),,
2,5,3,6,14,3,4,5,12,2,2,3,7,10,9,14,33,7.5,7,0.0,M2018-09-26D,Race(4),,
3,3,4,2,9,0,8,1,9,0,0,0,0,3,12,3,18,21,21,0.0,M2018-09-26D,Race(4),,
4,7,0,2,9,8,3,1,12,0,2,2,4,15,5,5,25,9,8,0.0,M2018-09-26D,Race(4),,
5,12,7,11,30,16,4,3,23,22,2,2,26,50,13,16,79,2.2,2,1.0,M2018-09-26D,Race(4),,
6,3,6,2,11,2,4,5,11,1,6,2,9,6,16,9,31,4.8,5,0.0,M2018-09-26D,Race(4),,
7,0,0,2,2,1,5,4,10,1,5,7,13,2,10,13,25,7,7,0.0,M2018-09-26D,Race(4),,
8,0,3,3,6,0,1,2,3,0,2,2,4,0,6,7,13,15,15,3.0,M2018-09-26D,Race(4),,
9,0,7,0,7,0,0,0,0,0,1,3,4,0,8,3,11,26,26,2.0,M2018-09-26D,Race(4),,
10,0,0,0,0,0,0,8,8,0,0,0,0,0,0,8,8,101,101,0.0,M2018-09-26D,Race(4),,
11,0,0,0,0,0,0,0,0,0,0,0,0,0,0,0,0,101,101,0.0,M2018-09-26D,Race(4),,
12,0,0,2,2,0,0,0,0,0,0,1,1,0,0,3,3,51,51,0.0,M2018-09-26D,Race(4),,
1,3,4,7,14,4,2,5,11,6,2,2,10,13,8,14,35,11,13,0.0,M2018-09-26D,Race(5),,
2,0,3,0,3,1,1,2,4,2,1,3,6,3,5,5,13,17,26,0.0,M2018-09-26D,Race(5),,
3,11,2,0,13,0,3,1,4,3,3,2,8,14,8,3,25,6,7,0.0,M2018-09-26D,Race(5),,
4,8,6,11,25,10,5,6,21,12,5,5,22,30,16,22,68,2.45,2,1.0,M2018-09-26D,Race(5),,
5,0,4,2,6,0,8,0,8,0,1,2,3,0,13,4,17,7.5,9,0.0,M2018-09-26D,Race(5),,
6,0,0,2,2,8,0,3,11,1,3,3,7,9,3,8,20,7.5,7,0.0,M2018-09-26D,Race(5),,
7,0,0,0,0,0,0,0,0,0,0,0,0,0,0,0,0,26,34,0.0,M2018-09-26D,Race(5),,
8,0,0,3,3,0,0,8,8,0,0,1,1,0,0,12,12,18,17,3.0,M2018-09-26D,Race(5),,
9,0,3,0,3,0,2,0,2,0,0,4,4,0,5,4,9,18,26,0.0,M2018-09-26D,Race(5),,
10,8,8,5,21,7,9,5,21,2,11,4,17,17,28,14,59,7.5,6,2.0,M2018-09-26D,Race(5),,
1,9,6,0,15,3,9,3,15,4,5,2,11,16,20,5,41,5,5,0.0,M2018-09-26D,Race(6),,
2,0,2,0,2,0,8,1,9,0,0,1,1,0,10,2,12,17,17,0.0,M2018-09-26D,Race(6),,
3,0,2,6,8,2,0,3,5,3,2,2,7,5,4,11,20,11,11,2.0,M2018-09-26D,Race(6),,
4,6,2,5,13,2,1,4,7,3,4,6,13,11,7,15,33,7,7,1.0,M2018-09-26D,Race(6),,
5,3,0,0,3,8,1,2,11,0,2,1,3,11,3,3,17,7,7,0.0,M2018-09-26D,Race(6),,
6,5,9,0,14,4,1,4,9,4,5,2,11,13,15,6,34,7.5,7,0.0,M2018-09-26D,Race(6),,
7,0,0,0,0,1,0,1,2,3,0,0,3,4,0,1,5,26,26,0.0,M2018-09-26D,Race(6),,
8,0,0,2,2,0,0,8,8,0,0,0,0,0,0,10,10,17,17,0.0,M2018-09-26D,Race(6),,
9,0,9,14,23,8,8,2,18,7,6,4,17,15,23,20,58,5,5,0.0,M2018-09-26D,Race(6),,
10,0,0,0,0,0,0,0,0,0,0,0,0,0,0,0,0,41,41,0.0,M2018-09-26D,Race(6),,
11,7,0,3,10,0,1,1,2,0,1,6,7,7,2,10,19,7,7,0.0,M2018-09-26D,Race(6),,
12,0,0,0,0,2,1,1,4,2,1,2,5,4,2,3,9,14,15,3.0,M2018-09-26D,Race(6),,
1,2,0,3,5,0,8,0,8,0,5,1,6,2,13,4,19,11,11,0.0,M2018-09-26D,Race(7),,
2,0,2,0,2,1,2,0,3,1,1,0,2,2,5,0,7,14,15,0.0,M2018-09-26D,Race(7),,
3,0,3,9,12,4,2,2,8,9,2,3,14,13,7,14,34,5,5,0.0,M2018-09-26D,Race(7),,
4,3,2,3,8,6,4,4,14,4,6,4,14,13,12,11,36,6,5,3.0,M2018-09-26D,Race(7),,
5,5,11,5,21,5,6,6,17,3,4,2,9,13,21,13,47,5.5,5,2.0,M2018-09-26D,Race(7),,
6,3,0,5,8,1,1,8,10,1,1,1,3,5,2,14,21,11,13,0.0,M2018-09-26D,Race(7),,
7,0,3,2,5,3,4,1,8,5,0,3,8,8,7,6,21,13,15,0.0,M2018-09-26D,Race(7),,
8,8,5,0,13,2,1,6,9,2,3,4,9,12,9,10,31,6,7,0.0,M2018-09-26D,Race(7),,
9,0,0,0,0,0,0,0,0,0,0,0,0,0,0,0,0,81,71,0.0,M2018-09-26D,Race(7),,
10,7,4,3,14,8,1,3,12,0,3,5,8,15,8,11,34,6,7,1.0,M2018-09-26D,Race(7),,
11,2,0,0,2,0,1,0,1,0,1,3,4,2,2,3,7,11,11,0.0,M2018-09-26D,Race(7),,
12,0,0,0,0,0,0,0,0,1,0,0,1,1,0,0,1,81,101,0.0,M2018-09-26D,Race(7),,
1,5,0,0,5,0,2,2,4,0,1,1,2,5,3,3,11,7.5,7,0.0,M2018-09-26D,Race(8),,
2,2,0,0,2,8,0,0,8,0,0,1,1,10,0,1,11,17,21,0.0,M2018-09-26D,Race(8),,
3,5,10,10,25,10,9,2,21,15,6,3,24,30,25,15,70,4.2,4,0.0,M2018-09-26D,Race(8),,
4,2,3,2,7,0,0,0,0,0,0,4,4,2,3,6,11,15,15,0.0,M2018-09-26D,Race(8),,
5,14,5,2,21,9,8,5,22,7,12,2,21,30,25,9,64,3.5,4,0.0,M2018-09-26D,Race(8),,
6,0,0,0,0,0,0,0,0,0,0,0,0,0,0,0,0,19,21,0.0,M2018-09-26D,Race(8),,
7,0,5,3,8,0,0,3,3,0,2,1,3,0,7,7,14,12,11,2.0,M2018-09-26D,Race(8),,
8,0,0,0,0,0,2,5,7,0,1,4,5,0,3,9,12,12,11,3.0,M2018-09-26D,Race(8),,
9,0,0,3,3,0,0,0,0,0,1,2,3,0,1,5,6,19,21,0.0,M2018-09-26D,Race(8),,
10,0,0,0,0,0,0,0,0,0,0,0,0,0,0,0,0,51,51,0.0,M2018-09-26D,Race(8),,
11,2,0,0,2,0,1,8,9,0,0,2,2,2,1,10,13,12,11,1.0,M2018-09-26D,Race(8),,
12,0,7,10,17,3,8,5,16,4,3,6,13,7,18,21,46,7,7,0.0,M2018-09-26D,Race(8),,
1,0,0,0,0,0,0,0,0,0,1,1,2,0,1,1,2,34,34,0.0,M2018-10-01D,Race(1),,
2,0,0,0,0,0,0,2,2,0,0,2,2,0,0,4,4,26,26,0.0,M2018-10-01D,Race(1),,
3,6,9,3,18,5,3,15,23,6,2,8,16,17,14,26,57,4,4,3.0,M2018-10-01D,Race(1),,
4,0,0,0,0,0,0,0,0,1,0,0,1,1,0,0,1,41,41,0.0,M2018-10-01D,Race(1),,
5,0,0,0,0,0,0,0,0,0,0,1,1,0,0,1,1,17,17,0.0,M2018-10-01D,Race(1),,
6,0,11,15,26,5,14,4,23,4,6,4,14,9,31,23,63,3.7,3.7,0.0,M2018-10-01D,Race(1),,
7,8,5,4,17,1,3,6,10,1,7,3,11,10,15,13,38,6,6,0.0,M2018-10-01D,Race(1),,
8,0,0,2,2,0,0,0,0,0,0,0,0,0,0,2,2,51,51,0.0,M2018-10-01D,Race(1),,
9,12,5,6,23,15,8,2,25,11,8,2,21,38,21,10,69,3.2,3.2,1.0,M2018-10-01D,Race(1),,
10,0,0,0,0,0,0,0,0,0,0,0,0,0,0,0,0,81,81,0.0,M2018-10-01D,Race(1),,
11,0,0,0,0,0,0,0,0,0,0,0,0,0,0,0,0,41,41,0.0,M2018-10-01D,Race(1),,
12,4,0,0,4,4,2,1,7,3,2,5,10,11,4,6,21,10,10,2.0,M2018-10-01D,Race(1),,
1,0,2,0,2,0,0,1,1,0,0,0,0,0,2,1,3,26,26,0.0,M2018-10-01D,Race(10),,
2,3,6,8,17,3,4,13,20,2,6,10,18,8,16,31,55,10,10,2.0,M2018-10-01D,Race(10),,
3,13,3,7,23,4,5,6,15,7,7,5,19,24,15,18,57,3.5,3.5,0.0,M2018-10-01D,Race(10),,
4,5,12,5,22,14,8,2,24,13,6,1,20,32,26,8,66,3.2,3.2,1.0,M2018-10-01D,Race(10),,
5,0,0,0,0,0,0,2,2,0,0,2,2,0,0,4,4,17,17,0.0,M2018-10-01D,Race(10),,
6,0,0,3,3,0,0,0,0,0,1,0,1,0,1,3,4,21,21,3.0,M2018-10-01D,Race(10),,
7,0,0,0,0,0,0,0,0,0,0,0,0,0,0,0,0,81,81,0.0,M2018-10-01D,Race(10),,
8,2,0,0,2,5,11,0,16,1,1,1,3,8,12,1,21,12,12,0.0,M2018-10-01D,Race(10),,
9,0,0,0,0,0,0,0,0,0,0,0,0,0,0,0,0,51,51,0.0,M2018-10-01D,Race(10),,
10,7,2,2,11,2,2,2,6,1,2,2,5,10,6,6,22,9,9,0.0,M2018-10-01D,Race(10),,
11,0,2,0,2,0,0,0,0,0,0,0,0,0,2,0,2,61,61,0.0,M2018-10-01D,Race(10),,
12,0,3,2,5,2,0,4,6,2,3,4,9,4,6,10,20,9,9,0.0,M2018-10-01D,Race(10),,
13,0,0,0,0,0,0,0,0,0,0,0,0,0,0,0,0,21,21,0.0,M2018-10-01D,Race(10),,
14,0,0,3,3,0,0,0,0,0,0,1,1,0,0,4,4,17,17,0.0,M2018-10-01D,Race(10),,
1,3,7,3,13,6,2,13,21,8,3,6,17,17,12,22,51,7,7,0.0,M2018-10-01D,Race(2),,
2,6,0,2,8,3,1,1,5,1,2,2,5,10,3,5,18,12,12,0.0,M2018-10-01D,Race(2),,
3,5,0,3,8,0,1,2,3,1,3,3,7,6,4,8,18,7.5,7.5,2.0,M2018-10-01D,Race(2),,
4,2,0,5,7,0,1,1,2,2,0,2,4,4,1,8,13,12,12,0.0,M2018-10-01D,Race(2),,
5,0,0,9,9,1,1,2,4,1,1,3,5,2,2,14,18,7,7,0.0,M2018-10-01D,Race(2),,
6,0,2,2,4,1,3,1,5,2,5,1,8,3,10,4,17,17,17,0.0,M2018-10-01D,Race(2),,
7,0,0,0,0,0,0,0,0,0,0,0,0,0,0,0,0,26,26,0.0,M2018-10-01D,Race(2),,
8,8,5,3,16,16,6,5,27,7,7,3,17,31,18,11,60,3.8,3.8,1.0,M2018-10-01D,Race(2),,
9,2,9,3,14,2,15,4,21,4,5,3,12,8,29,10,47,7,7,3.0,M2018-10-01D,Race(2),,
10,0,0,0,0,1,0,0,1,0,0,0,0,1,0,0,1,19,19,0.0,M2018-10-01D,Race(2),,
11,2,5,0,7,0,0,0,0,0,0,0,0,2,5,0,7,18,18,0.0,M2018-10-01D,Race(2),,
12,2,2,0,4,0,0,1,1,0,0,3,3,2,2,4,8,10,10,0.0,M2018-10-01D,Race(2),,
1,3,6,5,14,1,3,15,19,3,3,10,16,7,12,30,49,6.5,6.5,0.0,M2018-10-01D,Race(3),,
2,2,0,2,4,1,1,2,4,0,1,4,5,3,2,8,13,13,13,0.0,M2018-10-01D,Race(3),,
3,14,0,2,16,14,7,2,23,8,7,1,16,36,14,5,55,3.1,3.1,0.0,M2018-10-01D,Race(3),,
4,0,5,8,13,4,3,6,13,5,4,4,13,9,12,18,39,6.5,6.5,0.0,M2018-10-01D,Race(3),,
5,0,0,0,0,0,0,0,0,1,0,0,1,1,0,0,1,126,101,0.0,M2018-10-01D,Race(3),,
6,3,13,3,19,4,3,2,9,4,6,0,10,11,22,5,38,6,6,2.0,M2018-10-01D,Race(3),,
7,2,3,7,12,6,13,2,21,4,5,5,14,12,21,14,47,6,6,1.0,M2018-10-01D,Race(3),,
8,0,0,0,0,0,0,0,0,0,0,0,0,0,0,0,0,26,26,0.0,M2018-10-01D,Race(3),,
9,2,0,0,2,0,0,1,1,0,0,1,1,2,0,2,4,12,12,3.0,M2018-10-01D,Race(3),,
10,4,3,3,10,0,0,0,0,1,0,1,2,5,3,4,12,10,10,0.0,M2018-10-01D,Race(3),,
11,0,0,0,0,0,0,0,0,0,0,0,0,0,0,0,0,81,81,0.0,M2018-10-01D,Race(3),,
12,0,0,0,0,0,0,0,0,0,0,0,0,0,0,0,0,101,101,0.0,M2018-10-01D,Race(3),,
13,0,0,0,0,0,0,0,0,0,0,0,0,0,0,0,0,126,101,0.0,M2018-10-01D,Race(3),,
1,0,0,0,0,0,0,0,0,0,0,0,0,0,0,0,0,26,26,0.0,M2018-10-01D,Race(4),,
2,6,3,6,15,2,1,4,7,1,0,4,5,9,4,14,27,14,14,0.0,M2018-10-01D,Race(4),,
3,0,0,0,0,0,0,0,0,0,0,0,0,0,0,0,0,26,26,0.0,M2018-10-01D,Race(4),,
4,10,5,6,21,15,7,4,26,12,4,6,22,37,16,16,69,4.8,4.8,2.0,M2018-10-01D,Race(4),,
5,0,0,0,0,0,0,0,0,0,1,0,1,0,1,0,1,81,81,0.0,M2018-10-01D,Race(4),,
6,2,0,2,4,1,1,2,4,2,0,2,4,5,1,6,12,10,10,1.0,M2018-10-01D,Race(4),,
7,4,5,6,15,7,12,1,20,6,11,2,19,17,28,9,54,6,6,0.0,M2018-10-01D,Race(4),,
8,0,5,5,10,0,3,4,7,2,3,5,10,2,11,14,27,9.5,9,0.0,M2018-10-01D,Race(4),,
9,0,0,0,0,0,0,0,0,0,1,0,1,0,1,0,1,16,16,0.0,M2018-10-01D,Race(4),,
10,0,0,0,0,0,0,0,0,0,0,1,1,0,0,1,1,11,11,3.0,M2018-10-01D,Race(4),,
11,0,0,0,0,0,0,2,2,0,0,2,2,0,0,4,4,31,31,0.0,M2018-10-01D,Race(4),,
12,5,5,2,12,1,4,1,6,0,3,1,4,6,12,4,22,5.5,5.5,0.0,M2018-10-01D,Race(4),,
13,3,7,3,13,4,2,12,18,3,3,3,9,10,12,18,40,5.5,5.5,0.0,M2018-10-01D,Race(4),,
14,0,0,0,0,0,0,0,0,0,0,0,0,0,0,0,0,126,101,0.0,M2018-10-01D,Race(4),,
1,0,0,0,0,0,0,0,0,0,0,1,1,0,0,1,1,34,31,0.0,M2018-10-01D,Race(5),,
2,0,0,0,0,0,1,0,1,0,3,0,3,0,4,0,4,15,14,0.0,M2018-10-01D,Race(5),,
3,0,0,0,0,0,0,0,0,0,0,0,0,0,0,0,0,51,41,0.0,M2018-10-01D,Race(5),,
4,2,7,5,14,1,5,15,21,8,8,3,19,11,20,23,54,7,7,0.0,M2018-10-01D,Race(5),,
5,2,9,6,17,0,0,1,1,1,1,1,3,3,10,8,21,15,15,0.0,M2018-10-01D,Race(5),,
6,3,0,3,6,1,0,3,4,0,0,4,4,4,0,10,14,9,9,1.0,M2018-10-01D,Race(5),,
7,0,0,0,0,0,0,0,0,0,0,1,1,0,0,1,1,71,67,0.0,M2018-10-01D,Race(5),,
8,0,0,2,2,1,2,0,3,0,2,0,2,1,4,2,7,26,26,0.0,M2018-10-01D,Race(5),,
9,6,4,8,18,3,17,2,22,3,8,4,15,12,29,14,55,7,7,0.0,M2018-10-01D,Race(5),,
10,0,2,0,2,0,1,1,2,0,0,1,1,0,3,2,5,10,9,3.0,M2018-10-01D,Race(5),,
11,0,0,0,0,0,0,0,0,0,0,0,0,0,0,0,0,26,26,0.0,M2018-10-01D,Race(5),,
12,3,0,3,6,0,3,6,9,2,2,7,11,5,5,16,26,9,9,0.0,M2018-10-01D,Race(5),,
13,0,0,0,0,0,0,0,0,0,0,0,0,0,0,0,0,101,101,2.0,M2018-10-01D,Race(5),,
14,14,8,3,25,24,1,2,27,12,2,4,18,50,11,9,70,2.4,2.5,0.0,M2018-10-01D,Race(5),,
1,5,0,2,7,3,4,12,19,5,5,4,14,13,9,18,40,6,6,0.0,M2018-10-01D,Race(6),,
2,2,0,0,2,0,0,0,0,1,0,0,1,3,0,0,3,26,26,0.0,M2018-10-01D,Race(6),,
3,0,0,0,0,1,0,0,1,0,0,1,1,1,0,1,2,81,81,0.0,M2018-10-01D,Race(6),,
4,7,5,11,23,6,14,4,24,10,7,3,20,23,26,18,67,4.4,4.4,1.0,M2018-10-01D,Race(6),,
5,3,2,2,7,0,2,2,4,1,2,2,5,4,6,6,16,12,12,0.0,M2018-10-01D,Race(6),,
6,0,0,2,2,3,0,4,7,3,1,4,8,6,1,10,17,7,7,2.0,M2018-10-01D,Race(6),,
7,11,4,6,21,13,4,3,20,2,4,6,12,26,12,15,53,7,7,0.0,M2018-10-01D,Race(6),,
8,0,0,0,0,0,0,0,0,0,1,0,1,0,1,0,1,81,81,0.0,M2018-10-01D,Race(6),,
9,0,0,0,0,0,0,0,0,0,0,0,0,0,0,0,0,21,21,0.0,M2018-10-01D,Race(6),,
10,0,0,2,2,3,0,1,4,1,1,3,5,4,1,6,11,7,7,3.0,M2018-10-01D,Race(6),,
11,0,0,0,0,0,1,0,1,0,1,0,1,0,2,0,2,31,31,0.0,M2018-10-01D,Race(6),,
12,0,14,2,16,0,2,1,3,0,2,1,3,0,18,4,22,12,12,0.0,M2018-10-01D,Race(6),,
13,2,5,3,10,1,3,3,7,3,2,2,7,6,10,8,24,7.5,7,0.0,M2018-10-01D,Race(6),,
14,0,0,0,0,0,0,0,0,0,0,0,0,0,0,0,0,34,34,0.0,M2018-10-01D,Race(6),,
1,5,21,2,28,19,10,1,30,13,8,4,25,37,39,7,83,2.25,2,2.0,M2018-10-01D,Race(7),,
2,0,3,14,17,1,0,21,22,0,2,9,11,1,5,44,50,11,12,0.0,M2018-10-01D,Race(7),,
3,23,4,3,30,10,19,0,29,12,14,0,26,45,37,3,85,2.1,2.1,1.0,M2018-10-01D,Race(7),,
4,0,0,8,8,0,1,5,6,0,1,5,6,0,2,18,20,9,10,0.0,M2018-10-01D,Race(7),,
5,0,2,0,2,0,0,2,2,0,0,3,3,0,2,5,7,26,26,0.0,M2018-10-01D,Race(7),,
6,2,0,3,5,0,0,0,0,0,0,0,0,2,0,3,5,21,26,0.0,M2018-10-01D,Race(7),,
7,0,0,0,0,0,0,1,1,1,1,5,7,1,1,6,8,17,18,3.0,M2018-10-01D,Race(7),,
1,5,5,7,17,18,7,3,28,12,7,2,21,35,19,12,66,5,5,1.0,M2018-10-01D,Race(8),,
2,2,6,8,16,2,2,3,7,4,5,3,12,8,13,14,35,9,8.5,0.0,M2018-10-01D,Race(8),,
3,0,0,0,0,0,0,0,0,0,0,0,0,0,0,0,0,31,31,0.0,M2018-10-01D,Race(8),,
4,0,0,0,0,0,1,2,3,0,1,1,2,0,2,3,5,17,17,0.0,M2018-10-01D,Race(8),,
5,8,4,7,19,2,15,5,22,6,4,6,16,16,23,18,57,4.6,4.6,0.0,M2018-10-01D,Race(8),,
6,0,4,0,4,4,0,1,5,1,3,0,4,5,7,1,13,15,19,0.0,M2018-10-01D,Race(8),,
7,0,0,0,0,0,0,0,0,0,0,0,0,0,0,0,0,41,41,0.0,M2018-10-01D,Race(8),,
8,2,0,0,2,1,2,12,15,0,1,7,8,3,3,19,25,4.6,4.6,2.0,M2018-10-01D,Race(8),,
9,2,6,3,11,0,1,2,3,0,1,3,4,2,8,8,18,23,21,3.0,M2018-10-01D,Race(8),,
10,0,0,0,0,0,0,0,0,0,0,0,0,0,0,0,0,51,51,0.0,M2018-10-01D,Race(8),,
11,8,2,2,12,2,2,1,5,2,3,3,8,12,7,6,25,4.8,4.8,0.0,M2018-10-01D,Race(8),,
12,0,0,0,0,0,0,0,0,0,0,0,0,0,0,0,0,81,81,0.0,M2018-10-01D,Race(8),,
13,3,3,0,6,1,0,1,2,1,1,1,3,5,4,2,11,15,15,0.0,M2018-10-01D,Race(8),,
14,0,0,3,3,0,0,0,0,0,0,0,0,0,0,3,3,34,34,0.0,M2018-10-01D,Race(8),,
1,0,3,0,3,0,2,4,6,1,2,3,6,1,7,7,15,23,21,0.0,M2018-10-01D,Race(9),,
2,0,2,0,2,2,0,2,4,2,2,2,6,4,4,4,12,21,21,2.0,M2018-10-01D,Race(9),,
3,0,2,0,2,1,2,1,4,0,4,1,5,1,8,2,11,17,17,0.0,M2018-10-01D,Race(9),,
4,0,0,0,0,0,1,2,3,1,3,3,7,1,4,5,10,11,11,0.0,M2018-10-01D,Race(9),,
5,25,2,0,27,23,5,1,29,18,5,1,24,66,12,2,80,2,2,1.0,M2018-10-01D,Race(9),,
6,0,0,3,3,0,0,0,0,0,0,0,0,0,0,3,3,34,34,0.0,M2018-10-01D,Race(9),,
7,3,3,5,11,1,2,2,5,1,4,3,8,5,9,10,24,7.5,7.5,0.0,M2018-10-01D,Race(9),,
8,0,0,0,0,0,0,0,0,0,0,1,1,0,0,1,1,17,17,3.0,M2018-10-01D,Race(9),,
9,0,0,0,0,0,0,0,0,0,0,0,0,0,0,0,0,51,51,0.0,M2018-10-01D,Race(9),,
10,2,5,15,22,3,13,6,22,3,4,6,13,8,22,27,57,6,6,0.0,M2018-10-01D,Race(9),,
11,0,8,5,13,0,5,12,17,0,4,5,9,0,17,22,39,9,9,0.0,M2018-10-01D,Race(9),,
12,0,3,0,3,0,0,0,0,0,0,1,1,0,3,1,4,101,101,0.0,M2018-10-01D,Race(9),,
13,0,2,0,2,0,0,0,0,0,0,0,0,0,2,0,2,71,67,0.0,M2018-10-01D,Race(9),,
14,0,0,2,2,0,0,0,0,0,0,0,0,0,0,2,2,41,41,0.0,M2018-10-01D,Race(9),,
1,0,0,0,0,0,0,0,0,0,0,0,0,0,0,0,0,31,34,0.0,M2018-10-03D,Race(1),,
2,0,0,0,0,0,0,1,1,0,0,1,1,0,0,2,2,19,17,0.0,M2018-10-03D,Race(1),,
3,2,0,3,5,0,0,0,0,0,0,1,1,2,0,4,6,31,34,2.0,M2018-10-03D,Race(1),,
4,4,0,0,4,0,0,1,1,0,0,2,2,4,0,3,7,31,34,0.0,M2018-10-03D,Race(1),,
5,2,6,3,11,2,7,14,23,4,11,5,20,8,24,22,54,6,6.5,0.0,M2018-10-03D,Race(1),,
6,0,7,10,17,1,5,5,11,2,3,5,10,3,15,20,38,6,5.5,0.0,M2018-10-03D,Race(1),,
7,0,2,3,5,1,0,0,1,2,2,2,6,3,4,5,12,13,14,3.0,M2018-10-03D,Race(1),,
8,8,8,3,19,2,15,4,21,0,7,6,13,10,30,13,53,5.5,6,0.0,M2018-10-03D,Race(1),,
9,14,7,6,27,24,3,3,30,18,3,3,24,56,13,12,81,2.7,2.6,1.0,M2018-10-03D,Race(1),,
10,0,0,0,0,0,0,0,0,0,0,0,0,0,0,0,0,15,16,0.0,M2018-10-03D,Race(1),,
11,0,0,2,2,0,0,2,2,0,0,1,1,0,0,5,5,18,19,0.0,M2018-10-03D,Race(1),,
12,0,0,0,0,0,0,0,0,0,0,0,0,0,0,0,0,16,17,0.0,M2018-10-03D,Race(1),,
1,0,0,10,10,1,1,13,15,0,0,5,5,1,1,28,30,8.5,8.5,0.0,M2018-10-03D,Race(2),,
2,0,0,0,0,0,0,0,0,0,0,0,0,0,0,0,0,26,26,0.0,M2018-10-03D,Race(2),,
3,3,0,2,5,1,1,0,2,3,0,1,4,7,1,3,11,5,5,3.0,M2018-10-03D,Race(2),,
4,0,0,0,0,19,7,2,28,0,0,0,0,19,7,2,28,0,0,0.0,M2018-10-03D,Race(2),,
5,15,5,5,25,7,20,2,29,4,14,5,23,26,39,12,77,3.1,3.1,1.0,M2018-10-03D,Race(2),,
6,7,10,5,22,0,0,9,9,1,4,9,14,8,14,23,45,3.8,3.75,0.0,M2018-10-03D,Race(2),,
7,2,12,8,22,2,0,4,6,1,1,6,8,5,13,18,36,5,5,0.0,M2018-10-03D,Race(2),,
8,3,3,0,6,0,1,0,1,0,1,0,1,3,5,0,8,9,9,2.0,M2018-10-03D,Race(2),,
1,5,8,9,22,14,7,3,24,5,5,2,12,24,20,14,58,7,7,3.0,M2018-10-03D,Race(3),,
2,4,9,5,18,1,6,4,11,3,7,6,16,8,22,15,45,5,5,1.0,M2018-10-03D,Race(3),,
3,0,0,0,0,0,0,0,0,0,2,0,2,0,2,0,2,31,31,0.0,M2018-10-03D,Race(3),,
4,9,5,7,21,5,3,11,19,4,4,6,14,18,12,24,54,5,4.6,0.0,M2018-10-03D,Race(3),,
5,0,0,3,3,1,1,2,4,0,2,2,4,1,3,7,11,26,26,0.0,M2018-10-03D,Race(3),,
6,3,0,0,3,2,1,2,5,2,0,1,3,7,1,3,11,6.5,6.5,0.0,M2018-10-03D,Race(3),,
7,0,0,0,0,0,1,1,2,1,1,1,3,1,2,2,5,16,16,0.0,M2018-10-03D,Race(3),,
8,5,6,6,17,6,9,6,21,8,2,6,16,19,17,18,54,4.2,4.2,2.0,M2018-10-03D,Race(3),,
9,4,0,0,4,1,1,0,2,2,3,0,5,7,4,0,11,7,7,0.0,M2018-10-03D,Race(3),,
10,0,2,0,2,0,1,0,1,0,0,2,2,0,3,2,5,21,21,0.0,M2018-10-03D,Race(3),,
11,0,0,0,0,0,0,1,1,1,0,0,1,1,0,1,2,34,34,0.0,M2018-10-03D,Race(3),,
12,0,0,0,0,0,0,0,0,0,0,0,0,0,0,0,0,41,41,0.0,M2018-10-03D,Race(3),,
1,13,8,4,25,6,4,11,21,6,3,6,15,25,15,21,61,8,8,0.0,M2018-10-03D,Race(4),,
2,10,6,3,19,20,3,4,27,13,5,4,22,43,14,11,68,2.75,2.7,2.0,M2018-10-03D,Race(4),,
3,0,0,0,0,1,0,0,1,0,0,0,0,1,0,0,1,15,15,0.0,M2018-10-03D,Race(4),,
4,0,0,0,0,0,1,0,1,0,1,0,1,0,2,0,2,21,21,0.0,M2018-10-03D,Race(4),,
5,3,8,6,17,2,16,3,21,3,7,1,11,8,31,10,49,5.5,5.5,3.0,M2018-10-03D,Race(4),,
6,2,3,3,8,1,4,4,9,1,5,4,10,4,12,11,27,7.5,7.5,1.0,M2018-10-03D,Race(4),,
7,0,3,3,6,0,0,1,1,0,0,2,2,0,3,6,9,19,19,0.0,M2018-10-03D,Race(4),,
8,0,0,0,0,0,0,0,0,0,0,0,0,0,0,0,0,31,31,0.0,M2018-10-03D,Race(4),,
9,0,2,2,4,0,0,1,1,1,0,1,2,1,2,4,7,9,9,0.0,M2018-10-03D,Race(4),,
10,2,0,9,11,0,1,6,7,2,5,8,15,4,6,23,33,8,8,0.0,M2018-10-03D,Race(4),,
11,0,0,0,0,0,0,0,0,0,0,0,0,0,0,0,0,41,41,0.0,M2018-10-03D,Race(4),,
12,0,0,0,0,0,1,0,1,0,0,0,0,0,1,0,1,51,51,0.0,M2018-10-03D,Race(4),,
1,2,5,0,7,0,1,0,1,0,1,0,1,2,7,0,9,21,21,0.0,M2018-10-03D,Race(5),,
2,9,7,3,19,17,4,5,26,4,2,6,12,30,13,14,57,4.2,4,1.0,M2018-10-03D,Race(5),,
3,2,0,0,2,0,5,6,11,2,6,5,13,4,11,11,26,9.5,9.5,0.0,M2018-10-03D,Race(5),,
4,0,0,0,0,0,0,0,0,0,0,0,0,0,0,0,0,41,41,0.0,M2018-10-03D,Race(5),,
5,2,5,2,9,1,1,3,5,3,3,3,9,6,9,8,23,11,11,0.0,M2018-10-03D,Race(5),,
6,0,2,9,11,0,1,0,1,0,1,1,2,0,4,10,14,13,13,2.0,M2018-10-03D,Race(5),,
7,2,0,2,4,5,3,12,20,6,6,4,16,13,9,18,40,8,8,0.0,M2018-10-03D,Race(5),,
8,3,0,4,7,0,1,0,1,1,0,1,2,4,1,5,10,9,9,0.0,M2018-10-03D,Race(5),,
9,0,3,0,3,0,0,0,0,1,1,1,3,1,4,1,6,14,14,0.0,M2018-10-03D,Race(5),,
10,2,2,3,7,0,1,0,1,0,0,0,0,2,3,3,8,19,19,0.0,M2018-10-03D,Race(5),,
11,8,6,7,21,7,13,4,24,9,6,5,20,24,25,16,65,3.5,3.5,0.0,M2018-10-03D,Race(5),,
12,0,0,0,0,0,0,0,0,0,0,0,0,0,0,0,0,17,17,3.0,M2018-10-03D,Race(5),,
1,4,0,0,4,0,0,1,1,0,0,2,2,4,0,3,7,7,7,0.0,M2018-10-03D,Race(6),,
2,8,2,0,10,1,16,6,23,5,4,0,9,14,22,6,42,6.5,6.5,1.0,M2018-10-03D,Race(6),,
3,0,3,0,3,0,0,0,0,1,0,1,2,1,3,1,5,41,41,0.0,M2018-10-03D,Race(6),,
4,0,5,3,8,3,3,5,11,1,6,3,10,4,14,11,29,7.5,7.5,3.0,M2018-10-03D,Race(6),,
5,0,3,10,13,5,3,10,18,9,4,3,16,14,10,23,47,6,6,0.0,M2018-10-03D,Race(6),,
6,0,4,0,4,0,1,1,2,0,1,2,3,0,6,3,9,18,18,0.0,M2018-10-03D,Race(6),,
7,2,0,0,2,0,0,1,1,1,0,1,2,3,0,2,5,26,26,0.0,M2018-10-03D,Race(6),,
8,5,2,13,20,18,6,2,26,7,3,6,16,30,11,21,62,4.6,4.4,0.0,M2018-10-03D,Race(6),,
9,0,3,0,3,0,0,0,0,0,6,0,6,0,9,0,9,14,14,0.0,M2018-10-03D,Race(6),,
10,0,0,0,0,0,0,0,0,0,0,0,0,0,0,0,0,61,61,0.0,M2018-10-03D,Race(6),,
11,0,5,0,5,0,0,1,1,1,0,2,3,1,5,3,9,7.5,7.5,0.0,M2018-10-03D,Race(6),,
12,11,3,4,18,3,1,3,7,1,2,6,9,15,6,13,34,6.5,6.5,2.0,M2018-10-03D,Race(6),,
1,7,3,2,12,5,17,2,24,6,5,3,14,18,25,7,50,7,7,3.0,M2018-10-03D,Race(7),,
2,5,5,0,10,0,2,2,4,1,1,0,2,6,8,2,16,21,21,0.0,M2018-10-03D,Race(7),,
3,2,0,3,5,0,0,2,2,0,0,2,2,2,0,7,9,21,21,0.0,M2018-10-03D,Race(7),,
4,0,6,0,6,0,0,3,3,1,0,3,4,1,6,6,13,16,16,0.0,M2018-10-03D,Race(7),,
5,13,2,7,22,22,6,1,29,14,8,2,24,49,16,10,75,2.1,2,1.0,M2018-10-03D,Race(7),,
6,0,5,0,5,1,1,1,3,0,1,1,2,1,7,2,10,18,18,0.0,M2018-10-03D,Race(7),,
7,0,0,3,3,0,0,2,2,2,2,0,4,2,2,5,9,14,14,0.0,M2018-10-03D,Race(7),,
8,0,3,3,6,1,3,12,16,1,6,2,9,2,12,17,31,10,10,2.0,M2018-10-03D,Race(7),,
9,0,2,0,2,1,0,0,1,1,1,1,3,2,3,1,6,15,15,0.0,M2018-10-03D,Race(7),,
10,3,0,6,9,0,0,2,2,0,1,7,8,3,1,15,19,9.5,9.5,0.0,M2018-10-03D,Race(7),,
11,0,4,6,10,0,1,3,4,0,1,5,6,0,6,14,20,12,12,0.0,M2018-10-03D,Race(7),,
12,0,0,0,0,0,0,0,0,0,0,0,0,0,0,0,0,26,26,0.0,M2018-10-03D,Race(7),,
1,3,0,4,7,1,1,0,2,1,0,0,1,5,1,4,10,14,14,0.0,M2018-10-03D,Race(8),,
2,0,0,6,6,0,0,3,3,0,0,2,2,0,0,11,11,11,11,0.0,M2018-10-03D,Race(8),,
3,13,5,7,25,6,13,7,26,5,2,11,18,24,20,25,69,3.4,3.3,0.0,M2018-10-03D,Race(8),,
4,0,5,5,10,16,6,5,27,14,8,1,23,30,19,11,60,5,5,0.0,M2018-10-03D,Race(8),,
5,12,8,5,25,4,7,10,21,5,12,4,21,21,27,19,67,5.5,5.5,0.0,M2018-10-03D,Race(8),,
6,0,2,3,5,1,0,1,2,0,0,3,3,1,2,7,10,14,14,3.0,M2018-10-03D,Race(8),,
7,0,5,0,5,0,1,0,1,0,1,0,1,0,7,0,7,13,13,0.0,M2018-10-03D,Race(8),,
8,0,3,0,3,1,2,3,6,1,2,1,4,2,7,4,13,13,13,1.0,M2018-10-03D,Race(8),,
9,2,0,0,2,1,0,1,2,0,0,1,1,3,0,2,5,14,14,2.0,M2018-10-03D,Race(8),,
10,0,0,0,0,0,0,0,0,0,0,0,0,0,0,0,0,18,18,0.0,M2018-10-03D,Race(8),,
11,0,0,0,0,0,0,0,0,0,0,1,1,0,0,1,1,21,21,0.0,M2018-10-03D,Race(8),,
12,0,2,0,2,0,0,0,0,0,1,2,3,0,3,2,5,31,31,0.0,M2018-10-03D,Race(8),,
1,2,10,0,12,10,5,11,26,12,3,4,19,24,18,15,57,5.5,5.5,0.0,M2018-10-10D,Race(1),,
2,3,3,0,6,0,0,3,3,1,2,4,7,4,5,7,16,12,12,0.0,M2018-10-10D,Race(1),,
3,13,0,5,18,18,8,2,28,7,8,5,20,38,16,12,66,2.7,2.7,0.0,M2018-10-10D,Race(1),,
4,5,2,3,10,0,15,6,21,0,7,4,11,5,24,13,42,6.5,6.5,0.0,M2018-10-10D,Race(1),,
5,0,5,7,12,0,1,3,4,2,2,2,6,2,8,12,22,9,9,0.0,M2018-10-10D,Race(1),,
6,2,0,0,2,0,0,1,1,0,0,2,2,2,0,3,5,11,11,0.0,M2018-10-10D,Race(1),,
7,0,0,3,3,0,0,0,0,0,0,0,0,0,0,3,3,21,21,3.0,M2018-10-10D,Race(1),,
8,0,0,0,0,0,0,0,0,0,0,0,0,0,0,0,0,34,34,0.0,M2018-10-10D,Race(1),,
9,0,0,2,2,1,0,2,3,3,1,0,4,4,1,4,9,13,13,2.0,M2018-10-10D,Race(1),,
10,5,10,10,25,1,1,2,4,1,3,5,9,7,14,17,38,6.5,6.5,1.0,M2018-10-10D,Race(1),,
1,3,10,0,13,3,4,4,11,2,6,2,10,8,20,6,34,7,7,0.0,M2018-10-10D,Race(2),,
2,10,8,5,23,4,16,2,22,7,6,4,17,21,30,11,62,5.5,5.5,0.0,M2018-10-10D,Race(2),,
3,10,6,0,16,14,6,4,24,7,6,3,16,31,18,7,56,4.8,4.8,0.0,M2018-10-10D,Race(2),,
4,2,2,2,6,1,0,0,1,1,0,1,2,4,2,3,9,11,11,0.0,M2018-10-10D,Race(2),,
5,0,0,3,3,1,0,3,4,2,1,2,5,3,1,8,12,13,13,0.0,M2018-10-10D,Race(2),,
6,0,2,0,2,0,0,1,1,0,0,3,3,0,2,4,6,21,21,0.0,M2018-10-10D,Race(2),,
7,5,2,10,17,2,2,13,17,2,1,4,7,9,5,27,41,7,7,1.0,M2018-10-10D,Race(2),,
8,0,0,0,0,0,0,0,0,0,0,0,0,0,0,0,0,26,26,0.0,M2018-10-10D,Race(2),,
9,0,0,0,0,0,0,0,0,0,0,0,0,0,0,0,0,31,31,0.0,M2018-10-10D,Race(2),,
10,0,0,0,0,0,1,0,1,0,3,1,4,0,4,1,5,8.5,8,3.0,M2018-10-10D,Race(2),,
11,0,0,3,3,0,0,1,1,1,1,2,4,1,1,6,8,19,19,0.0,M2018-10-10D,Race(2),,
12,0,0,7,7,0,0,0,0,0,0,0,0,0,0,7,7,6,6,2.0,M2018-10-10D,Race(2),,
1,7,7,2,16,3,4,15,22,4,3,5,12,14,14,22,50,10,10,0.0,M2018-10-10D,Race(3),,
2,0,0,0,0,0,0,0,0,0,0,0,0,0,0,0,0,34,34,0.0,M2018-10-10D,Race(3),,
3,8,8,2,18,6,11,5,22,8,5,4,17,22,24,11,57,4,4,3.0,M2018-10-10D,Race(3),,
4,8,3,7,18,4,5,0,9,5,6,3,14,17,14,10,41,4,4,2.0,M2018-10-10D,Race(3),,
5,2,5,3,10,0,1,1,2,0,3,0,3,2,9,4,15,6,6,0.0,M2018-10-10D,Race(3),,
6,0,2,2,4,2,1,1,4,1,1,1,3,3,4,4,11,11,11,0.0,M2018-10-10D,Race(3),,
7,0,0,3,3,0,1,0,1,1,1,1,3,1,2,4,7,19,19,0.0,M2018-10-10D,Race(3),,
8,0,3,0,3,0,1,3,4,1,1,4,6,1,5,7,13,8,8,1.0,M2018-10-10D,Race(3),,
9,5,2,11,18,15,6,5,26,6,6,8,20,26,14,24,64,4.8,5,0.0,M2018-10-10D,Race(3),,
10,0,0,0,0,0,0,0,0,0,0,0,0,0,0,0,0,101,101,0.0,M2018-10-10D,Race(3),,
11,0,0,0,0,0,0,0,0,0,0,0,0,0,0,0,0,51,51,0.0,M2018-10-10D,Race(3),,
1,2,7,7,16,6,4,10,20,1,2,5,8,9,13,22,44,12,12,0.0,M2018-10-10D,Race(4),,
2,13,8,2,23,18,4,4,26,12,7,3,22,43,19,9,71,2.9,3,0.0,M2018-10-10D,Race(4),,
3,0,0,5,5,0,4,4,8,0,4,2,6,0,8,11,19,14,14,0.0,M2018-10-10D,Race(4),,
4,0,0,0,0,0,1,0,1,0,1,1,2,0,2,1,3,21,21,3.0,M2018-10-10D,Race(4),,
5,8,7,5,20,4,15,5,24,7,8,4,19,19,30,14,63,2.9,2.75,2.0,M2018-10-10D,Race(4),,
6,0,0,0,0,1,2,1,4,2,3,1,6,3,5,2,10,31,31,0.0,M2018-10-10D,Race(4),,
7,0,0,0,0,0,0,0,0,0,1,0,1,0,1,0,1,31,31,0.0,M2018-10-10D,Race(4),,
8,0,0,0,0,0,0,0,0,1,0,1,2,1,0,1,2,26,26,0.0,M2018-10-10D,Race(4),,
9,2,3,3,8,1,0,1,2,1,0,2,3,4,3,6,13,18,18,1.0,M2018-10-10D,Race(4),,
10,0,0,2,2,0,0,0,0,0,0,0,0,0,0,2,2,17,17,0.0,M2018-10-10D,Race(4),,
11,0,3,0,3,0,0,4,4,1,0,7,8,1,3,11,15,15,15,0.0,M2018-10-10D,Race(4),,
12,5,2,6,13,0,0,1,1,1,0,0,1,6,2,7,15,7.5,8,0.0,M2018-10-10D,Race(4),,
1,0,0,3,3,2,2,3,7,1,3,3,7,3,5,9,17,15,15,0.0,M2018-10-10D,Race(5),,
2,0,2,3,5,0,2,1,3,2,0,1,3,2,4,5,11,17,17,3.0,M2018-10-10D,Race(5),,
3,3,0,0,3,0,2,0,2,0,1,2,3,3,3,2,8,21,21,0.0,M2018-10-10D,Race(5),,
4,2,3,0,5,2,0,0,2,1,0,1,2,5,3,1,9,13,13,0.0,M2018-10-10D,Race(5),,
5,3,3,9,15,0,13,3,16,1,4,3,8,4,20,15,39,7.5,8,0.0,M2018-10-10D,Race(5),,
6,0,0,0,0,0,0,0,0,0,0,0,0,0,0,0,0,51,51,0.0,M2018-10-10D,Race(5),,
7,9,7,3,19,17,4,6,27,8,9,5,22,34,20,14,68,3.4,3.3,0.0,M2018-10-10D,Race(5),,
8,3,5,7,15,6,4,3,13,8,5,2,15,17,14,12,43,7.5,8,1.0,M2018-10-10D,Race(5),,
9,0,0,0,0,0,0,1,1,0,0,1,1,0,0,2,2,13,13,0.0,M2018-10-10D,Race(5),,
10,0,5,3,8,0,0,0,0,0,0,0,0,0,5,3,8,12,12,0.0,M2018-10-10D,Race(5),,
11,0,0,0,0,0,0,0,0,0,0,0,0,0,0,0,0,26,26,0.0,M2018-10-10D,Race(5),,
12,10,5,2,17,3,3,13,19,5,4,8,17,18,12,23,53,3.7,3.8,2.0,M2018-10-10D,Race(5),,
1,0,0,0,0,0,0,0,0,0,0,0,0,0,0,0,0,18,18,0.0,M2018-10-10D,Race(6),,
2,7,9,2,18,4,5,11,20,3,3,5,11,14,17,18,49,5,5,3.0,M2018-10-10D,Race(6),,
3,0,0,5,5,0,1,1,2,0,1,2,3,0,2,8,10,21,21,0.0,M2018-10-10D,Race(6),,
4,0,0,3,3,0,0,0,0,1,0,0,1,1,0,3,4,10,10,0.0,M2018-10-10D,Race(6),,
5,8,4,9,21,16,5,2,23,11,4,4,19,35,13,15,63,3.4,3.4,2.0,M2018-10-10D,Race(6),,
6,0,0,0,0,0,0,0,0,0,0,1,1,0,0,1,1,16,16,1.0,M2018-10-10D,Race(6),,
7,0,0,0,0,0,0,0,0,0,0,0,0,0,0,0,0,101,101,0.0,M2018-10-10D,Race(6),,
8,11,9,5,25,6,13,7,26,8,6,3,17,25,28,15,68,4,4,0.0,M2018-10-10D,Race(6),,
9,0,2,4,6,1,0,0,1,0,2,1,3,1,4,5,10,12,12,0.0,M2018-10-10D,Race(6),,
10,2,3,2,7,1,3,6,10,1,7,8,16,4,13,16,33,10,10,0.0,M2018-10-10D,Race(6),,
11,0,0,0,0,0,0,0,0,0,0,0,0,0,0,0,0,81,81,0.0,M2018-10-10D,Race(6),,
12,2,3,0,5,0,0,3,3,0,0,1,1,2,3,4,9,12,12,0.0,M2018-10-10D,Race(6),,
1,2,3,5,10,2,0,2,4,1,1,2,4,5,4,9,18,12,12,0.0,M2018-10-10D,Race(7),,
2,0,3,2,5,2,0,1,3,3,0,3,6,5,3,6,14,8.5,8.5,0.0,M2018-10-10D,Race(7),,
3,8,8,7,23,5,3,11,19,7,3,5,15,20,14,23,57,4,4,0.0,M2018-10-10D,Race(7),,
4,5,4,3,12,6,11,4,21,10,5,3,18,21,20,10,51,5,5,1.0,M2018-10-10D,Race(7),,
5,0,0,0,0,0,0,0,0,0,0,0,0,0,0,0,0,19,19,0.0,M2018-10-10D,Race(7),,
6,7,5,5,17,12,10,3,25,1,12,5,18,20,27,13,60,7.5,7,0.0,M2018-10-10D,Race(7),,
7,5,2,0,7,2,4,3,9,2,4,1,7,9,10,4,23,7.5,7,0.0,M2018-10-10D,Race(7),,
8,0,0,0,0,0,1,3,4,0,0,4,4,0,1,7,8,15,15,2.0,M2018-10-10D,Race(7),,
9,3,5,8,16,1,1,3,5,2,1,3,6,6,7,14,27,5,5,0.0,M2018-10-10D,Race(7),,
10,0,0,0,0,0,0,0,0,0,0,0,0,0,0,0,0,26,26,3.0,M2018-10-10D,Race(7),,
11,0,0,0,0,0,0,0,0,0,0,0,0,0,0,0,0,41,41,0.0,M2018-10-10D,Race(7),,
1,0,15,9,24,18,3,3,24,15,3,0,18,33,21,12,66,5,5,0.0,M2018-10-10D,Race(8),,
2,0,0,0,0,0,0,0,0,0,1,0,1,0,1,0,1,26,26,0.0,M2018-10-10D,Race(8),,
3,0,0,0,0,0,0,0,0,0,0,0,0,0,0,0,0,14,14,0.0,M2018-10-10D,Race(8),,
4,0,5,7,12,1,3,12,16,1,3,6,10,2,11,25,38,12,12,0.0,M2018-10-10D,Race(8),,
5,0,0,0,0,0,0,0,0,0,0,0,0,0,0,0,0,41,41,0.0,M2018-10-10D,Race(8),,
6,2,0,0,2,2,2,1,5,1,1,2,4,5,3,3,11,11,11,0.0,M2018-10-10D,Race(8),,
7,4,0,6,10,4,3,1,8,3,2,1,6,11,5,8,24,6,6,0.0,M2018-10-10D,Race(8),,
8,0,0,0,0,0,0,0,0,0,0,0,0,0,0,0,0,21,21,0.0,M2018-10-10D,Race(8),,
9,22,2,2,26,4,13,5,22,3,5,8,16,29,20,15,64,3.8,3.7,3.0,M2018-10-10D,Race(8),,
10,2,8,6,16,1,3,4,8,3,5,4,12,6,16,14,36,6,6,1.0,M2018-10-10D,Race(8),,
11,0,0,0,0,0,0,1,1,0,0,0,0,0,0,1,1,21,21,0.0,M2018-10-10D,Race(8),,
12,0,0,0,0,0,3,3,6,0,6,5,11,0,9,8,17,10,10,2.0,M2018-10-10D,Race(8),,
1,0,0,0,0,0,0,0,0,0,0,0,0,0,0,0,0,61,61,0.0,M2018-10-13D,Race(1),,
2,0,0,0,0,0,0,0,0,0,0,0,0,0,0,0,0,21,21,0.0,M2018-10-13D,Race(1),,
3,3,15,7,25,6,15,5,26,13,7,1,21,22,37,13,72,3.7,3.7,1.0,M2018-10-13D,Race(1),,
4,18,0,7,25,6,6,17,29,5,5,8,18,29,11,32,72,2.8,2.8,0.0,M2018-10-13D,Race(1),,
5,0,0,0,0,0,0,0,0,0,0,0,0,0,0,0,0,34,34,0.0,M2018-10-13D,Race(1),,
6,0,0,0,0,0,0,2,2,0,0,3,3,0,0,5,5,17,17,0.0,M2018-10-13D,Race(1),,
7,0,2,0,2,0,0,1,1,0,0,1,1,0,2,2,4,16,16,2.0,M2018-10-13D,Race(1),,
8,0,3,2,5,0,3,0,3,1,4,3,8,1,10,5,16,21,21,3.0,M2018-10-13D,Race(1),,
9,9,10,11,30,18,5,5,28,7,10,7,24,34,25,23,82,3.5,3.5,0.0,M2018-10-13D,Race(1),,
10,0,0,0,0,0,0,0,0,0,0,0,0,0,0,0,0,81,81,0.0,M2018-10-13D,Race(1),,
11,0,0,0,0,0,1,0,1,0,0,1,1,0,1,1,2,21,21,0.0,M2018-10-13D,Race(1),,
12,0,0,3,3,0,0,0,0,0,0,2,2,0,0,5,5,16,16,0.0,M2018-10-13D,Race(1),,
1,0,0,0,0,0,0,0,0,0,0,0,0,0,0,0,0,41,41,0.0,M2018-10-13D,Race(10),,
2,0,0,0,0,0,1,1,2,1,0,0,1,1,1,1,3,18,18,0.0,M2018-10-13D,Race(10),,
3,3,3,12,18,0,2,3,5,2,3,2,7,5,8,17,30,15,15,3.0,M2018-10-13D,Race(10),,
4,10,2,5,17,14,7,4,25,5,6,7,18,29,15,16,60,5.5,5,0.0,M2018-10-13D,Race(10),,
5,0,0,2,2,0,1,0,1,1,0,0,1,1,1,2,4,21,21,0.0,M2018-10-13D,Race(10),,
6,0,2,0,2,0,1,0,1,0,1,0,1,0,4,0,4,21,21,0.0,M2018-10-13D,Race(10),,
7,0,0,3,3,1,0,5,6,2,2,5,9,3,2,13,18,16,16,1.0,M2018-10-13D,Race(10),,
8,0,0,0,0,0,0,0,0,1,0,0,1,1,0,0,1,71,67,0.0,M2018-10-13D,Race(10),,
9,0,0,0,0,0,0,0,0,0,0,0,0,0,0,0,0,15,15,0.0,M2018-10-13D,Race(10),,
10,0,0,0,0,0,2,0,2,0,0,0,0,0,2,0,2,19,19,0.0,M2018-10-13D,Race(10),,
11,12,14,0,26,6,13,5,24,8,5,6,19,26,32,11,69,5.5,5.5,0.0,M2018-10-13D,Race(10),,
12,5,4,0,9,7,2,12,21,5,6,3,14,17,12,15,44,4.4,4.4,0.0,M2018-10-13D,Race(10),,
13,0,5,3,8,0,1,0,1,0,3,1,4,0,9,4,13,7.5,7.5,2.0,M2018-10-13D,Race(10),,
14,0,0,5,5,2,0,0,2,1,0,2,3,3,0,7,10,9.5,9,0.0,M2018-10-13D,Race(10),,
1,5,5,7,17,7,17,4,28,8,8,6,22,20,30,17,67,4.4,4.4,0.0,M2018-10-13D,Race(2),,
2,6,4,9,19,5,1,15,21,5,3,9,17,16,8,33,57,4.2,4.2,0.0,M2018-10-13D,Race(2),,
3,2,2,2,6,0,3,5,8,2,1,1,4,4,6,8,18,8,8,1.0,M2018-10-13D,Race(2),,
4,0,0,0,0,0,0,1,1,0,0,1,1,0,0,2,2,19,19,0.0,M2018-10-13D,Race(2),,
5,3,3,10,16,0,3,1,4,2,3,3,8,5,9,14,28,7,7,2.0,M2018-10-13D,Race(2),,
6,14,12,2,28,18,6,4,28,7,11,3,21,39,29,9,77,2.5,2.5,0.0,M2018-10-13D,Race(2),,
7,0,4,0,4,0,0,0,0,2,0,3,5,2,4,3,9,12,12,3.0,M2018-10-13D,Race(2),,
1,6,8,8,22,2,4,13,19,4,5,5,14,12,17,26,55,5.5,5.5,0.0,M2018-10-13D,Race(3),,
2,8,7,3,18,1,16,6,23,2,6,5,13,11,29,14,54,6,6,0.0,M2018-10-13D,Race(3),,
3,2,0,0,2,1,3,2,6,0,5,3,8,3,8,5,16,7,7,3.0,M2018-10-13D,Race(3),,
4,2,0,0,2,1,1,1,3,2,1,1,4,5,2,2,9,18,18,1.0,M2018-10-13D,Race(3),,
5,0,0,3,3,1,0,1,2,0,1,3,4,1,1,7,9,17,17,0.0,M2018-10-13D,Race(3),,
6,0,0,0,0,0,1,2,3,0,3,3,6,0,4,5,9,26,26,0.0,M2018-10-13D,Race(3),,
7,0,2,3,5,0,0,0,0,0,0,0,0,0,2,3,5,10,10,0.0,M2018-10-13D,Race(3),,
8,3,2,6,11,0,2,1,3,1,0,0,1,4,4,7,15,10,10,0.0,M2018-10-13D,Race(3),,
9,7,11,7,25,24,2,2,28,17,5,3,25,48,18,12,78,3,3,0.0,M2018-10-13D,Race(3),,
10,0,0,0,0,0,0,0,0,0,0,0,0,0,0,0,0,17,17,0.0,M2018-10-13D,Race(3),,
11,0,0,0,0,0,1,0,1,0,0,1,1,0,1,1,2,26,26,0.0,M2018-10-13D,Race(3),,
12,2,0,0,2,0,0,2,2,0,0,2,2,2,0,4,6,21,21,2.0,M2018-10-13D,Race(3),,
1,6,6,10,22,2,17,4,23,5,7,4,16,13,30,18,61,5.5,5,0.0,M2018-10-13D,Race(4),,
2,6,0,0,6,5,1,10,16,5,2,2,9,16,3,12,31,9,9,0.0,M2018-10-13D,Race(4),,
3,6,0,0,6,2,1,1,4,3,0,2,5,11,1,3,15,7,7,2.0,M2018-10-13D,Race(4),,
4,0,0,0,0,0,0,0,0,0,0,0,0,0,0,0,0,41,41,0.0,M2018-10-13D,Race(4),,
5,5,7,5,17,14,5,8,27,9,4,8,21,28,16,21,65,4.4,4.4,1.0,M2018-10-13D,Race(4),,
6,0,0,3,3,3,0,1,4,3,0,0,3,6,0,4,10,12,12,0.0,M2018-10-13D,Race(4),,
7,2,5,3,10,0,0,2,2,0,3,0,3,2,8,5,15,8.5,8,3.0,M2018-10-13D,Race(4),,
8,0,5,0,5,1,0,0,1,0,2,3,5,1,7,3,11,9,9,0.0,M2018-10-13D,Race(4),,
9,0,5,0,5,0,0,0,0,0,0,1,1,0,5,1,6,15,15,0.0,M2018-10-13D,Race(4),,
10,0,0,0,0,0,1,1,2,0,0,1,1,0,1,2,3,15,15,0.0,M2018-10-13D,Race(4),,
11,0,0,3,3,0,0,1,1,0,1,0,1,0,1,4,5,18,18,0.0,M2018-10-13D,Race(4),,
12,5,2,6,13,3,5,2,10,1,7,5,13,9,14,13,36,9,9,0.0,M2018-10-13D,Race(4),,
1,21,7,0,28,25,5,0,30,17,3,0,20,63,15,0,78,2.2,2.2,0.0,M2018-10-13D,Race(5),,
2,0,0,6,6,0,2,4,6,2,1,3,6,2,3,13,18,8,8,0.0,M2018-10-13D,Race(5),,
3,0,0,0,0,0,0,0,0,0,1,0,1,0,1,0,1,61,61,0.0,M2018-10-13D,Race(5),,
4,0,7,0,7,0,0,1,1,0,1,0,1,0,8,1,9,16,16,0.0,M2018-10-13D,Race(5),,
5,0,0,0,0,0,1,0,1,0,1,1,2,0,2,1,3,19,19,0.0,M2018-10-13D,Race(5),,
6,0,2,5,7,0,12,7,19,1,4,5,10,1,18,17,36,19,19,3.0,M2018-10-13D,Race(5),,
7,0,0,8,8,1,3,3,7,0,4,5,9,1,7,16,24,8.5,8,2.0,M2018-10-13D,Race(5),,
8,3,0,9,12,2,1,4,7,2,6,3,11,7,7,16,30,8.5,8,1.0,M2018-10-13D,Race(5),,
9,2,3,0,5,2,3,11,16,1,3,7,11,5,9,18,32,16,16,0.0,M2018-10-13D,Race(5),,
10,0,0,0,0,0,0,0,0,2,0,0,2,2,0,0,2,16,16,0.0,M2018-10-13D,Race(5),,
11,0,0,0,0,0,1,0,1,0,1,0,1,0,2,0,2,19,19,0.0,M2018-10-13D,Race(5),,
12,0,0,0,0,0,0,0,0,0,0,0,0,0,0,0,0,71,67,0.0,M2018-10-13D,Race(5),,
13,0,0,0,0,0,0,0,0,0,0,0,0,0,0,0,0,61,61,0.0,M2018-10-13D,Race(5),,
14,4,11,2,17,0,2,0,2,1,1,2,4,5,14,4,23,11,11,0.0,M2018-10-13D,Race(5),,
1,0,0,0,0,0,0,0,0,0,0,0,0,0,0,0,0,21,21,0.0,M2018-10-13D,Race(6),,
2,0,0,0,0,0,1,0,1,1,1,0,2,1,2,0,3,31,31,0.0,M2018-10-13D,Race(6),,
3,0,0,0,0,0,0,0,0,0,0,0,0,0,0,0,0,34,34,0.0,M2018-10-13D,Race(6),,
4,4,6,7,17,5,5,14,24,10,2,5,17,19,13,26,58,5,5,2.0,M2018-10-13D,Race(6),,
5,0,0,3,3,1,4,0,5,1,6,3,10,2,10,6,18,16,16,0.0,M2018-10-13D,Race(6),,
6,9,2,5,16,3,13,4,20,4,10,1,15,16,25,10,51,6,6,0.0,M2018-10-13D,Race(6),,
7,14,13,0,27,21,2,4,27,9,5,7,21,44,20,11,75,2.05,2,0.0,M2018-10-13D,Race(6),,
8,0,6,6,12,0,3,6,9,0,1,6,7,0,10,18,28,12,12,1.0,M2018-10-13D,Race(6),,
9,0,0,0,0,0,0,0,0,0,0,0,0,0,0,0,0,19,19,0.0,M2018-10-13D,Race(6),,
10,0,0,0,0,0,0,0,0,0,0,1,1,0,0,1,1,34,34,0.0,M2018-10-13D,Race(6),,
11,3,3,9,15,0,2,2,4,1,1,3,5,4,6,14,24,7,7,3.0,M2018-10-13D,Race(6),,
12,0,0,0,0,0,0,0,0,0,0,0,0,0,0,0,0,61,61,0.0,M2018-10-13D,Race(6),,
1,6,12,2,20,15,7,5,27,10,9,4,23,31,28,11,70,5,5,3.0,M2018-10-13D,Race(7),,
2,0,0,3,3,0,0,2,2,1,0,2,3,1,0,7,8,13,13,0.0,M2018-10-13D,Race(7),,
3,9,11,3,23,7,14,5,26,5,7,8,20,21,32,16,69,4.4,4.5,1.0,M2018-10-13D,Race(7),,
4,2,0,2,4,1,3,13,17,2,2,7,11,5,5,22,32,15,15,2.0,M2018-10-13D,Race(7),,
5,0,0,0,0,0,0,0,0,0,0,0,0,0,0,0,0,19,19,0.0,M2018-10-13D,Race(7),,
6,11,2,10,23,6,2,4,12,5,2,4,11,22,6,18,46,3.2,3,0.0,M2018-10-13D,Race(7),,
7,0,5,10,15,0,2,0,2,2,4,0,6,2,11,10,23,11,11,0.0,M2018-10-13D,Race(7),,
8,2,0,0,2,0,0,0,0,0,1,0,1,2,1,0,3,26,26,0.0,M2018-10-13D,Race(7),,
9,0,0,0,0,0,1,0,1,0,0,1,1,0,1,1,2,17,17,0.0,M2018-10-13D,Race(7),,
10,0,0,0,0,1,1,0,2,1,1,0,2,2,2,0,4,13,13,0.0,M2018-10-13D,Race(7),,
11,0,0,0,0,0,0,1,1,0,0,0,0,0,0,1,1,10,10,0.0,M2018-10-13D,Race(7),,
12,0,0,0,0,0,0,0,0,0,0,0,0,0,0,0,0,31,31,0.0,M2018-10-13D,Race(7),,
1,0,0,0,0,0,0,0,0,0,0,0,0,0,0,0,0,51,51,0.0,M2018-10-13D,Race(8),,
2,0,0,9,9,2,1,2,5,4,1,0,5,6,2,11,19,11,11,2.0,M2018-10-13D,Race(8),,
3,3,13,0,16,15,8,4,27,7,7,4,18,25,28,8,61,4,4,0.0,M2018-10-13D,Race(8),,
4,0,0,0,0,1,0,0,1,1,1,1,3,2,1,1,4,26,26,0.0,M2018-10-13D,Race(8),,
5,0,5,3,8,1,0,1,2,0,0,1,1,1,5,5,11,13,13,0.0,M2018-10-13D,Race(8),,
6,3,3,4,10,0,1,0,1,0,2,0,2,3,6,4,13,17,17,1.0,M2018-10-13D,Race(8),,
7,0,0,0,0,0,0,1,1,0,0,2,2,0,0,3,3,17,17,0.0,M2018-10-13D,Race(8),,
8,21,0,6,27,8,14,5,27,10,9,4,23,39,23,15,77,3,3,3.0,M2018-10-13D,Race(8),,
9,0,0,0,0,0,2,2,4,0,0,3,3,0,2,5,7,11,11,0.0,M2018-10-13D,Race(8),,
10,0,0,3,3,1,0,0,1,1,0,0,1,2,0,3,5,26,26,0.0,M2018-10-13D,Race(8),,
11,3,0,3,6,1,1,1,3,3,3,4,10,7,4,8,19,8,8,0.0,M2018-10-13D,Race(8),,
12,0,9,2,11,1,3,14,18,0,3,7,10,1,15,23,39,8,8,0.0,M2018-10-13D,Race(8),,
1,3,5,2,10,3,3,4,10,3,2,3,8,9,10,9,28,7,7,0.0,M2018-10-13D,Race(9),,
2,0,3,11,14,0,4,4,8,1,3,6,10,1,10,21,32,9,9,2.0,M2018-10-13D,Race(9),,
3,4,0,0,4,1,3,3,7,2,2,4,8,7,5,7,19,11,11,0.0,M2018-10-13D,Race(9),,
4,0,0,0,0,0,0,0,0,0,0,1,1,0,0,1,1,17,17,0.0,M2018-10-13D,Race(9),,
5,0,0,0,0,0,0,0,0,1,0,0,1,1,0,0,1,26,26,0.0,M2018-10-13D,Race(9),,
6,12,8,3,23,23,3,3,29,14,7,2,23,49,18,8,75,4,4,0.0,M2018-10-13D,Race(9),,
7,6,11,6,23,2,17,3,22,4,10,4,18,12,38,13,63,4.4,4.5,1.0,M2018-10-13D,Race(9),,
8,0,0,2,2,0,0,0,0,0,0,0,0,0,0,2,2,41,41,0.0,M2018-10-13D,Race(9),,
9,0,0,0,0,0,0,0,0,0,0,0,0,0,0,0,0,21,21,0.0,M2018-10-13D,Race(9),,
10,5,3,6,14,1,0,13,14,1,2,5,8,7,5,24,36,4.6,4.6,0.0,M2018-10-13D,Race(9),,
11,0,0,0,0,0,0,0,0,0,0,0,0,0,0,0,0,21,21,3.0,M2018-10-13D,Race(9),,
12,0,0,0,0,0,0,0,0,0,0,1,1,0,0,1,1,19,19,0.0,M2018-10-13D,Race(9),,
1,4,9,13,26,10,6,4,20,11,5,4,20,25,20,21,66,5,5,3.0,M2018-10-18D,Race(1),,
2,10,7,0,17,3,11,7,21,4,6,3,13,17,24,10,51,3.6,3.6,2.0,M2018-10-18D,Race(1),,
3,0,7,0,7,0,0,1,1,0,0,0,0,0,7,1,8,8.5,8.5,0.0,M2018-10-18D,Race(1),,
4,6,0,6,12,8,10,2,20,9,8,4,21,23,18,12,53,5.5,5.5,0.0,M2018-10-18D,Race(1),,
5,2,0,0,2,0,0,8,8,0,0,2,2,2,0,10,12,31,31,0.0,M2018-10-18D,Race(1),,
6,8,7,8,23,9,3,8,20,2,6,10,18,19,16,26,61,3.3,3.3,0.0,M2018-10-18D,Race(1),,
7,0,0,0,0,0,0,0,0,0,0,1,1,0,0,1,1,26,26,0.0,M2018-10-18D,Race(1),,
8,0,0,0,0,0,0,0,0,0,0,1,1,0,0,1,1,21,21,0.0,M2018-10-18D,Race(1),,
9,0,0,3,3,0,0,0,0,0,1,1,2,0,1,4,5,15,15,1.0,M2018-10-18D,Race(1),,
10,0,0,0,0,0,0,0,0,0,0,0,0,0,0,0,0,31,31,0.0,M2018-10-18D,Race(1),,
1,2,5,6,13,6,6,3,15,7,7,4,18,15,18,13,46,7.5,7.5,0.0,M2018-10-18D,Race(2),,
2,3,0,0,3,0,3,0,3,0,0,0,0,3,3,0,6,9,9,2.0,M2018-10-18D,Race(2),,
3,0,2,0,2,0,8,0,8,0,0,0,0,0,10,0,10,26,26,0.0,M2018-10-18D,Race(2),,
4,0,0,0,0,0,2,8,10,0,2,0,2,0,4,8,12,12,12,0.0,M2018-10-18D,Race(2),,
5,5,15,2,22,12,3,5,20,9,6,1,16,26,24,8,58,4,4,1.0,M2018-10-18D,Race(2),,
6,0,0,0,0,0,0,0,0,0,0,0,0,0,0,0,0,26,26,0.0,M2018-10-18D,Race(2),,
7,8,5,8,21,4,4,4,12,2,3,6,11,14,12,18,44,6,6,0.0,M2018-10-18D,Race(2),,
8,0,0,0,0,0,0,0,0,0,0,0,0,0,0,0,0,41,41,0.0,M2018-10-18D,Race(2),,
9,0,3,4,7,0,1,5,6,0,4,8,12,0,8,17,25,4.2,4.2,3.0,M2018-10-18D,Race(2),,
10,12,0,10,22,8,3,5,16,8,4,7,19,28,7,22,57,4.4,4.4,0.0,M2018-10-18D,Race(2),,
1,2,8,10,20,2,7,2,11,5,9,2,16,9,24,14,47,4,4,1.0,M2018-10-18D,Race(3),,
2,3,0,0,3,2,8,4,14,2,1,2,5,7,9,6,22,6,6,0.0,M2018-10-18D,Race(3),,
3,0,0,0,0,0,2,8,10,0,2,0,2,0,4,8,12,34,34,3.0,M2018-10-18D,Race(3),,
4,9,11,5,25,13,5,2,20,16,2,3,21,38,18,10,66,3,3,0.0,M2018-10-18D,Race(3),,
5,12,2,3,17,3,4,5,12,0,6,5,11,15,12,13,40,8,8,0.0,M2018-10-18D,Race(3),,
6,0,5,7,12,8,1,4,13,1,2,5,8,9,8,16,33,7.5,7,0.0,M2018-10-18D,Race(3),,
7,0,0,0,0,0,0,0,0,0,0,0,0,0,0,0,0,21,21,0.0,M2018-10-18D,Race(3),,
8,2,2,0,4,0,2,2,4,0,3,2,5,2,7,4,13,17,17,0.0,M2018-10-18D,Race(3),,
9,2,2,3,7,2,3,1,6,2,1,7,10,6,6,11,23,8.5,8,2.0,M2018-10-18D,Race(3),,
10,0,0,2,2,0,0,0,0,0,0,0,0,0,0,2,2,26,26,0.0,M2018-10-18D,Race(3),,
1,5,15,6,26,7,8,2,17,2,10,7,19,14,33,15,62,5,5,0.0,M2018-10-18D,Race(4),,
2,0,9,15,24,1,4,10,15,1,6,8,15,2,19,33,54,7,7,3.0,M2018-10-18D,Race(4),,
3,0,2,2,4,1,1,3,5,0,2,2,4,1,5,7,13,12,12,0.0,M2018-10-18D,Race(4),,
4,0,0,0,0,8,0,0,8,0,0,0,0,8,0,0,8,41,41,0.0,M2018-10-18D,Race(4),,
5,0,0,0,0,0,0,0,0,0,0,0,0,0,0,0,0,21,21,0.0,M2018-10-18D,Race(4),,
6,0,0,0,0,0,3,0,3,1,3,1,5,1,6,1,8,9,9,0.0,M2018-10-18D,Race(4),,
7,4,0,0,4,0,0,9,9,0,2,2,4,4,2,11,17,21,21,0.0,M2018-10-18D,Race(4),,
8,21,4,5,30,13,6,3,22,21,3,1,25,55,13,9,77,2.2,2.2,1.0,M2018-10-18D,Race(4),,
9,0,0,2,2,0,8,3,11,1,0,4,5,1,8,9,18,14,14,2.0,M2018-10-18D,Race(4),,
10,0,0,0,0,0,0,0,0,0,0,0,0,0,0,0,0,31,31,0.0,M2018-10-18D,Race(4),,
11,0,0,0,0,0,0,0,0,0,0,1,1,0,0,1,1,16,16,0.0,M2018-10-18D,Race(4),,
12,0,0,0,0,0,0,0,0,0,0,0,0,0,0,0,0,51,51,0.0,M2018-10-18D,Race(4),,
1,3,2,2,7,3,4,4,11,5,3,6,14,11,9,12,32,10,10,0.0,M2018-10-18D,Race(5),,
2,2,0,3,5,1,0,0,1,1,1,1,3,4,1,4,9,14,14,0.0,M2018-10-18D,Race(5),,
3,5,9,4,18,5,5,4,14,11,4,4,19,21,18,12,51,4.6,4.6,3.0,M2018-10-18D,Race(5),,
4,2,5,5,12,1,3,6,10,1,3,5,9,4,11,16,31,4.4,4.4,0.0,M2018-10-18D,Race(5),,
5,4,5,3,12,5,8,2,15,2,2,1,5,11,15,6,32,8,8,0.0,M2018-10-18D,Race(5),,
6,0,0,0,0,0,0,0,0,0,0,1,1,0,0,1,1,51,51,0.0,M2018-10-18D,Race(5),,
7,0,0,0,0,8,0,1,9,0,0,0,0,8,0,1,9,0,0,0.0,M2018-10-18D,Race(5),,
8,0,2,3,5,0,0,0,0,0,0,0,0,0,2,3,5,19,19,0.0,M2018-10-18D,Race(5),,
9,9,7,7,23,3,10,3,16,2,10,2,14,14,27,12,53,4.2,4.2,1.0,M2018-10-18D,Race(5),,
10,2,0,0,2,1,0,8,9,0,1,1,2,3,1,9,13,9,9,0.0,M2018-10-18D,Race(5),,
11,3,0,3,6,3,0,2,5,4,2,4,10,10,2,9,21,7.5,7.5,2.0,M2018-10-18D,Race(5),,
1,0,3,3,6,0,1,1,2,0,1,2,3,0,5,6,11,7.5,7.5,0.0,M2018-10-18D,Race(6),,
2,0,0,2,2,1,0,0,1,0,0,0,0,1,0,2,3,26,26,0.0,M2018-10-18D,Race(6),,
3,5,0,2,7,3,4,5,12,5,4,1,10,13,8,8,29,7.5,7.5,0.0,M2018-10-18D,Race(6),,
4,11,3,0,14,5,3,2,10,5,4,5,14,21,10,7,38,4.8,4.8,0.0,M2018-10-18D,Race(6),,
5,0,0,0,0,8,0,0,8,1,1,1,3,9,1,1,11,7,7,2.0,M2018-10-18D,Race(6),,
6,0,0,0,0,0,8,1,9,0,0,0,0,0,8,1,9,34,34,0.0,M2018-10-18D,Race(6),,
7,2,12,8,22,9,4,6,19,7,7,7,21,18,23,21,62,5,5,3.0,M2018-10-18D,Race(6),,
8,0,2,0,2,0,0,0,0,0,0,0,0,0,2,0,2,19,19,0.0,M2018-10-18D,Race(6),,
9,6,8,4,18,4,5,5,14,6,5,2,13,16,18,11,45,6.5,6.5,1.0,M2018-10-18D,Race(6),,
10,4,0,0,4,0,0,0,0,0,0,0,0,4,0,0,4,26,26,0.0,M2018-10-18D,Race(6),,
11,2,2,6,10,0,5,2,7,1,4,6,11,3,11,14,28,9,9,0.0,M2018-10-18D,Race(6),,
12,0,0,5,5,0,0,8,8,1,0,2,3,1,0,15,16,18,18,0.0,M2018-10-18D,Race(6),,
1,5,11,7,23,9,5,4,18,15,8,1,24,29,24,12,65,2.8,2.8,1.0,M2018-10-18D,Race(7),,
2,2,0,2,4,8,1,0,9,0,1,0,1,10,2,2,14,41,41,0.0,M2018-10-18D,Race(7),,
3,0,3,0,3,1,1,1,3,1,1,4,6,2,5,5,12,9,9,0.0,M2018-10-18D,Race(7),,
4,0,2,3,5,2,8,5,15,1,1,4,6,3,11,12,26,9,9,0.0,M2018-10-18D,Race(7),,
5,0,0,0,0,1,0,1,2,0,0,1,1,1,0,2,3,26,26,0.0,M2018-10-18D,Race(7),,
6,0,0,0,0,0,1,8,9,0,0,2,2,0,1,10,11,17,17,0.0,M2018-10-18D,Race(7),,
7,5,3,8,16,0,2,3,5,2,6,1,9,7,11,12,30,7,7,3.0,M2018-10-18D,Race(7),,
8,0,0,0,0,0,0,0,0,0,0,0,0,0,0,0,0,17,17,2.0,M2018-10-18D,Race(7),,
9,0,0,0,0,0,0,2,2,0,0,2,2,0,0,4,4,26,26,0.0,M2018-10-18D,Race(7),,
10,5,2,2,9,1,3,2,6,1,0,2,3,7,5,6,18,12,12,0.0,M2018-10-18D,Race(7),,
11,2,2,0,4,0,0,0,0,0,0,1,1,2,2,1,5,34,34,0.0,M2018-10-18D,Race(7),,
12,11,7,8,26,8,9,4,21,6,9,8,23,25,25,20,70,4,4,0.0,M2018-10-18D,Race(7),,
1,0,2,3,5,0,3,5,8,0,0,2,2,0,5,10,15,26,26,0.0,M2018-10-18D,Race(8),,
2,0,8,5,13,1,8,5,14,3,12,3,18,4,28,13,45,10,10,0.0,M2018-10-18D,Race(8),,
3,0,0,0,0,0,0,0,0,0,0,0,0,0,0,0,0,51,51,0.0,M2018-10-18D,Race(8),,
4,0,8,10,18,1,3,5,9,0,4,9,13,1,15,24,40,7,7,0.0,M2018-10-18D,Race(8),,
5,0,0,3,3,0,0,0,0,0,0,0,0,0,0,3,3,26,26,0.0,M2018-10-18D,Race(8),,
6,0,0,0,0,0,0,0,0,0,1,0,1,0,1,0,1,101,101,0.0,M2018-10-18D,Race(8),,
7,0,0,0,0,0,0,0,0,0,0,0,0,0,0,0,0,71,67,0.0,M2018-10-18D,Race(8),,
8,30,0,0,30,20,2,1,23,23,2,1,26,73,4,2,79,1.5,1.5,1.0,M2018-10-18D,Race(8),,
9,0,0,0,0,0,9,4,13,0,2,3,5,0,11,7,18,12,12,2.0,M2018-10-18D,Race(8),,
10,0,3,4,7,0,0,8,8,0,0,2,2,0,3,14,17,16,16,3.0,M2018-10-18D,Race(8),,
11,0,7,2,9,0,2,2,4,0,4,3,7,0,13,7,20,13,13,0.0,M2018-10-18D,Race(8),,
12,0,2,3,5,8,3,0,11,0,1,3,4,8,6,6,20,18,18,0.0,M2018-10-18D,Race(8),,
1,10,8,7,25,9,5,5,19,9,5,4,18,28,18,16,62,4.2,4.2,0.0,M2018-10-21D,Race(1),,
2,0,3,0,3,0,0,8,8,0,1,2,3,0,4,10,14,16,16,0.0,M2018-10-21D,Race(1),,
3,0,0,5,5,0,1,1,2,0,1,2,3,0,2,8,10,11,11,1.0,M2018-10-21D,Race(1),,
4,0,0,0,0,0,8,0,8,0,2,0,2,0,10,0,10,11,11,0.0,M2018-10-21D,Race(1),,
5,0,2,5,7,8,0,2,10,0,0,4,4,8,2,11,21,12,12,0.0,M2018-10-21D,Race(1),,
6,7,12,6,25,10,9,2,21,13,9,1,23,30,30,9,69,3.2,3.2,0.0,M2018-10-21D,Race(1),,
7,0,0,5,5,0,0,2,2,0,1,2,3,0,1,9,10,18,18,0.0,M2018-10-21D,Race(1),,
8,0,0,0,0,0,0,0,0,0,1,0,1,0,1,0,1,16,16,0.0,M2018-10-21D,Race(1),,
9,13,5,2,20,3,7,10,20,4,6,9,19,20,18,21,59,3.8,3.8,3.0,M2018-10-21D,Race(1),,
10,0,0,0,0,0,0,0,0,0,0,2,2,0,0,2,2,26,26,2.0,M2018-10-21D,Race(1),,
1,0,3,5,8,2,8,3,13,1,0,2,3,3,11,10,24,8,8,0.0,M2018-10-21D,Race(10),,
2,14,3,2,19,16,6,8,30,19,4,3,26,49,13,13,75,3,3,3.0,M2018-10-21D,Race(10),,
3,4,3,3,10,0,0,3,3,0,0,3,3,4,3,9,16,9,9,1.0,M2018-10-21D,Race(10),,
4,0,4,5,9,0,0,0,0,0,0,1,1,0,4,6,10,11,11,0.0,M2018-10-21D,Race(10),,
5,0,3,10,13,8,5,5,18,2,14,2,18,10,22,17,49,9,9,0.0,M2018-10-21D,Race(10),,
6,5,5,2,12,0,7,6,13,1,6,7,14,6,18,15,39,11,11,0.0,M2018-10-21D,Race(10),,
7,3,2,3,8,0,2,5,7,0,1,6,7,3,5,14,22,9,9,0.0,M2018-10-21D,Race(10),,
8,0,4,0,4,4,2,0,6,1,1,2,4,5,7,2,14,7,7,2.0,M2018-10-21D,Race(10),,
9,0,0,0,0,0,0,0,0,0,0,0,0,0,0,0,0,31,31,0.0,M2018-10-21D,Race(10),,
10,0,0,0,0,0,0,0,0,0,0,0,0,0,0,0,0,51,51,0.0,M2018-10-21D,Race(10),,
11,4,3,0,7,0,0,0,0,2,0,0,2,6,3,0,9,9,9,0.0,M2018-10-21D,Race(10),,
12,0,0,0,0,0,0,0,0,0,0,0,0,0,0,0,0,71,71,0.0,M2018-10-21D,Race(10),,
13,0,0,0,0,0,0,0,0,0,0,0,0,0,0,0,0,101,101,0.0,M2018-10-21D,Race(10),,
1,13,9,6,28,13,5,2,20,17,5,1,23,43,19,9,71,2.7,2.7,0.0,M2018-10-21D,Race(2),,
2,2,2,2,6,2,9,4,15,0,1,5,6,4,12,11,27,11,11,1.0,M2018-10-21D,Race(2),,
3,3,6,11,20,5,9,3,17,3,7,4,14,11,22,18,51,5.5,5.5,0.0,M2018-10-21D,Race(2),,
4,0,2,0,2,0,0,8,8,0,0,1,1,0,2,9,11,15,15,0.0,M2018-10-21D,Race(2),,
5,3,8,0,11,2,4,6,12,2,7,5,14,7,19,11,37,6.5,6.5,0.0,M2018-10-21D,Race(2),,
6,0,0,0,0,0,0,0,0,0,0,0,0,0,0,0,0,21,21,0.0,M2018-10-21D,Race(2),,
7,0,0,3,3,0,2,0,2,0,1,0,1,0,3,3,6,15,15,0.0,M2018-10-21D,Race(2),,
8,0,0,0,0,0,0,0,0,0,0,2,2,0,0,2,2,71,71,0.0,M2018-10-21D,Race(2),,
9,0,0,2,2,0,0,0,0,0,0,0,0,0,0,2,2,21,21,0.0,M2018-10-21D,Race(2),,
10,7,3,6,16,8,1,7,16,4,5,8,17,19,9,21,49,5.5,5.5,0.0,M2018-10-21D,Race(2),,
11,2,0,0,2,0,0,0,0,0,0,0,0,2,0,0,2,21,21,3.0,M2018-10-21D,Race(2),,
12,0,0,0,0,0,0,0,0,0,0,0,0,0,0,0,0,61,61,2.0,M2018-10-21D,Race(2),,
1,0,0,0,0,1,1,0,2,2,0,0,2,3,1,0,4,31,31,3.0,M2018-10-21D,Race(3),,
2,3,0,5,8,0,8,0,8,1,1,0,2,4,9,5,18,13,13,0.0,M2018-10-21D,Race(3),,
3,15,6,2,23,14,3,4,21,17,4,3,24,46,13,9,68,2.8,2.8,1.0,M2018-10-21D,Race(3),,
4,0,0,0,0,0,0,0,0,0,0,0,0,0,0,0,0,16,16,0.0,M2018-10-21D,Race(3),,
5,0,0,0,0,8,0,0,8,0,3,0,3,8,3,0,11,16,16,0.0,M2018-10-21D,Race(3),,
6,0,0,0,0,0,0,0,0,0,0,0,0,0,0,0,0,41,41,0.0,M2018-10-21D,Race(3),,
7,0,7,0,7,1,5,9,15,0,7,4,11,1,19,13,33,7.5,7.5,0.0,M2018-10-21D,Race(3),,
8,0,0,0,0,0,0,8,8,0,0,1,1,0,0,9,9,31,31,0.0,M2018-10-21D,Race(3),,
9,0,0,0,0,0,0,0,0,0,0,1,1,0,0,1,1,41,41,0.0,M2018-10-21D,Race(3),,
10,5,13,10,28,6,10,3,19,6,8,6,20,17,31,19,67,4,4,0.0,M2018-10-21D,Race(3),,
11,2,2,8,12,0,2,3,5,0,2,6,8,2,6,17,25,11,11,2.0,M2018-10-21D,Race(3),,
12,2,2,0,4,0,0,0,0,0,0,0,0,2,2,0,4,71,71,0.0,M2018-10-21D,Race(3),,
13,0,0,0,0,0,0,0,0,0,0,0,0,0,0,0,0,126,126,0.0,M2018-10-21D,Race(3),,
14,3,0,5,8,0,1,3,4,0,1,5,6,3,2,13,18,8,8,0.0,M2018-10-21D,Race(3),,
1,0,2,5,7,0,0,6,6,0,0,5,5,0,2,16,18,34,34,0.0,M2018-10-21D,Race(4),,
2,0,0,4,4,0,0,2,2,1,2,4,7,1,2,10,13,14,14,0.0,M2018-10-21D,Race(4),,
3,0,0,3,3,0,1,8,9,0,1,2,3,0,2,13,15,31,31,0.0,M2018-10-21D,Race(4),,
4,5,20,5,30,13,15,1,29,9,14,2,25,27,49,8,84,4.2,4.2,0.0,M2018-10-21D,Race(4),,
5,25,5,0,30,17,5,1,23,16,8,1,25,58,18,2,78,1.45,1.45,1.0,M2018-10-21D,Race(4),,
6,0,3,11,14,0,1,9,10,0,1,7,8,0,5,27,32,12,12,0.0,M2018-10-21D,Race(4),,
7,0,0,0,0,0,0,0,0,0,0,0,0,0,0,0,0,31,31,2.0,M2018-10-21D,Race(4),,
8,0,0,0,0,0,0,0,0,0,0,0,0,0,0,0,0,71,71,0.0,M2018-10-21D,Race(4),,
9,0,0,0,0,0,8,1,9,0,0,1,1,0,8,2,10,26,26,3.0,M2018-10-21D,Race(4),,
10,0,0,2,2,0,0,2,2,0,0,4,4,0,0,8,8,15,15,0.0,M2018-10-21D,Race(4),,
1,5,9,7,21,11,1,6,18,9,3,3,15,25,13,16,54,4.2,4.2,1.0,M2018-10-21D,Race(5),,
2,3,6,0,9,8,3,2,13,2,4,3,9,13,13,5,31,9,9,3.0,M2018-10-21D,Race(5),,
3,0,0,0,0,0,0,0,0,0,0,0,0,0,0,0,0,51,51,0.0,M2018-10-21D,Race(5),,
4,0,0,5,5,1,2,4,7,2,3,3,8,3,5,12,20,9,9,0.0,M2018-10-21D,Race(5),,
5,0,4,6,10,1,5,3,9,5,5,7,17,6,14,16,36,9,9,0.0,M2018-10-21D,Race(5),,
6,13,4,5,22,9,6,3,18,8,7,5,20,30,17,13,60,4.2,4.2,0.0,M2018-10-21D,Race(5),,
7,0,2,2,4,0,0,0,0,0,0,0,0,0,2,2,4,15,15,0.0,M2018-10-21D,Race(5),,
8,2,0,3,5,0,2,8,10,0,2,1,3,2,4,12,18,11,11,0.0,M2018-10-21D,Race(5),,
9,0,0,0,0,0,0,0,0,0,0,0,0,0,0,0,0,51,51,0.0,M2018-10-21D,Race(5),,
10,3,2,2,7,0,8,1,9,0,0,2,2,3,10,5,18,11,11,2.0,M2018-10-21D,Race(5),,
11,0,0,0,0,0,0,0,0,0,0,0,0,0,0,0,0,31,31,0.0,M2018-10-21D,Race(5),,
12,0,0,0,0,0,0,0,0,0,0,0,0,0,0,0,0,71,71,0.0,M2018-10-21D,Race(5),,
13,2,3,0,5,0,3,3,6,0,2,2,4,2,8,5,15,14,14,0.0,M2018-10-21D,Race(5),,
14,2,0,0,2,0,0,0,0,0,0,0,0,2,0,0,2,31,31,0.0,M2018-10-21D,Race(5),,
1,4,5,5,14,2,6,5,13,2,3,4,9,8,14,14,36,9,9,0.0,M2018-10-21D,Race(6),,
2,2,2,2,6,8,0,5,13,1,0,5,6,11,2,12,25,9,9,0.0,M2018-10-21D,Race(6),,
3,17,9,2,28,14,5,0,19,15,5,3,23,46,19,5,70,3.4,3.4,0.0,M2018-10-21D,Race(6),,
4,3,2,2,7,0,3,5,8,1,3,3,7,4,8,10,22,15,15,0.0,M2018-10-21D,Race(6),,
5,0,0,0,0,0,0,0,0,0,0,1,1,0,0,1,1,17,17,3.0,M2018-10-21D,Race(6),,
6,0,0,0,0,0,0,0,0,0,0,0,0,0,0,0,0,31,31,0.0,M2018-10-21D,Race(6),,
7,0,0,0,0,0,0,0,0,1,0,0,1,1,0,0,1,15,15,0.0,M2018-10-21D,Race(6),,
8,0,0,3,3,1,0,1,2,0,2,1,3,1,2,5,8,26,26,0.0,M2018-10-21D,Race(6),,
9,0,0,3,3,0,2,8,10,0,2,2,4,0,4,13,17,15,15,0.0,M2018-10-21D,Race(6),,
10,0,0,3,3,0,0,0,0,0,1,1,2,0,1,4,5,31,31,0.0,M2018-10-21D,Race(6),,
11,0,9,2,11,5,6,5,16,6,9,4,19,11,24,11,46,3.8,3.8,1.0,M2018-10-21D,Race(6),,
12,0,0,0,0,0,0,0,0,0,0,0,0,0,0,0,0,151,151,0.0,M2018-10-21D,Race(6),,
13,4,3,8,15,0,8,1,9,0,1,2,3,4,12,11,27,8.5,8.5,2.0,M2018-10-21D,Race(6),,
14,0,0,0,0,0,0,0,0,0,0,0,0,0,0,0,0,101,101,0.0,M2018-10-21D,Race(6),,
1,20,3,7,30,20,10,0,30,21,3,0,24,61,16,7,84,2,2,0.0,M2018-10-21D,Race(7),,
2,3,15,7,25,2,9,9,20,1,10,9,20,6,34,25,65,4.2,4.2,3.0,M2018-10-21D,Race(7),,
3,0,0,0,0,0,0,0,0,0,0,2,2,0,0,2,2,17,17,2.0,M2018-10-21D,Race(7),,
4,0,0,0,0,0,0,3,3,1,0,5,6,1,0,8,9,21,21,0.0,M2018-10-21D,Race(7),,
5,3,2,3,8,0,0,8,8,0,0,2,2,3,2,13,18,17,17,0.0,M2018-10-21D,Race(7),,
6,4,7,10,21,8,11,10,29,3,13,6,22,15,31,26,72,4.4,4.4,1.0,M2018-10-21D,Race(7),,
7,0,3,3,6,0,0,0,0,0,0,1,1,0,3,4,7,17,17,0.0,M2018-10-21D,Race(7),,
8,0,0,0,0,0,0,0,0,0,0,0,0,0,0,0,0,31,31,0.0,M2018-10-21D,Race(7),,
9,0,0,0,0,0,0,0,0,0,0,0,0,0,0,0,0,31,31,0.0,M2018-10-21D,Race(7),,
10,0,0,0,0,0,0,0,0,0,0,1,1,0,0,1,1,21,21,0.0,M2018-10-21D,Race(7),,
1,21,7,0,28,20,2,1,23,20,4,2,26,61,13,3,77,2.2,2.2,1.0,M2018-10-21D,Race(8),,
2,5,18,0,23,8,12,5,25,6,11,5,22,19,41,10,70,3.8,3.8,0.0,M2018-10-21D,Race(8),,
3,0,0,2,2,0,3,2,5,0,2,3,5,0,5,7,12,26,26,0.0,M2018-10-21D,Race(8),,
4,0,0,0,0,0,8,2,10,0,1,2,3,0,9,4,13,26,26,0.0,M2018-10-21D,Race(8),,
5,0,0,2,2,0,0,4,4,0,0,0,0,0,0,6,6,21,21,0.0,M2018-10-21D,Race(8),,
6,0,0,6,6,0,1,2,3,0,2,1,3,0,3,9,12,21,21,0.0,M2018-10-21D,Race(8),,
7,2,0,3,5,0,1,8,9,0,1,4,5,2,2,15,19,15,15,0.0,M2018-10-21D,Race(8),,
8,0,0,0,0,0,0,0,0,0,0,0,0,0,0,0,0,71,71,0.0,M2018-10-21D,Race(8),,
9,0,0,0,0,0,0,0,0,0,0,0,0,0,0,0,0,71,71,3.0,M2018-10-21D,Race(8),,
10,0,2,7,9,0,0,5,5,0,1,7,8,0,3,19,22,8.5,8.5,2.0,M2018-10-21D,Race(8),,
11,0,0,0,0,0,0,0,0,0,1,1,2,0,1,1,2,26,26,0.0,M2018-10-21D,Race(8),,
12,2,0,5,7,0,2,0,2,0,1,0,1,2,3,5,10,11,11,0.0,M2018-10-21D,Race(8),,
13,0,0,0,0,0,0,0,0,0,0,0,0,0,0,0,0,151,151,0.0,M2018-10-21D,Race(8),,
14,0,3,5,8,2,1,1,4,0,2,1,3,2,6,7,15,14,14,0.0,M2018-10-21D,Race(8),,
1,9,6,3,18,13,5,2,20,12,6,1,19,34,17,6,57,4,4,3.0,M2018-10-21D,Race(9),,
2,6,0,7,13,0,6,5,11,1,4,7,12,7,10,19,36,9,9,0.0,M2018-10-21D,Race(9),,
3,0,16,5,21,7,5,6,18,8,7,4,19,15,28,15,58,4,4,0.0,M2018-10-21D,Race(9),,
4,0,0,3,3,0,0,8,8,0,0,2,2,0,0,13,13,21,21,0.0,M2018-10-21D,Race(9),,
5,0,2,0,2,0,8,1,9,0,1,2,3,0,11,3,14,14,14,0.0,M2018-10-21D,Race(9),,
6,0,0,0,0,0,0,0,0,0,0,0,0,0,0,0,0,17,17,0.0,M2018-10-21D,Race(9),,
7,0,0,0,0,0,0,0,0,0,0,0,0,0,0,0,0,31,31,0.0,M2018-10-21D,Race(9),,
8,3,2,0,5,0,3,2,5,1,2,2,5,4,7,4,15,11,11,0.0,M2018-10-21D,Race(9),,
9,2,4,7,13,2,1,4,7,4,2,5,11,8,7,16,31,7.5,7.5,2.0,M2018-10-21D,Race(9),,
10,0,0,0,0,0,0,0,0,0,0,0,0,0,0,0,0,67,67,0.0,M2018-10-21D,Race(9),,
11,0,0,0,0,0,0,0,0,0,0,0,0,0,0,0,0,31,31,0.0,M2018-10-21D,Race(9),,
12,8,0,2,10,0,1,2,3,0,3,3,6,8,4,7,19,6,6,1.0,M2018-10-21D,Race(9),,
13,0,0,0,0,0,0,0,0,0,0,0,0,0,0,0,0,41,41,0.0,M2018-10-21D,Race(9),,
14,2,0,3,5,8,1,0,9,0,1,0,1,10,2,3,15,31,31,0.0,M2018-10-21D,Race(9),,
1,15,7,5,27,25,3,2,30,16,4,3,23,56,14,10,80,3.1,3.1,0.0,M2018-10-24D,Race(1),,
2,5,2,8,15,1,4,13,18,2,6,5,13,8,12,26,46,5.5,5.5,0.0,M2018-10-24D,Race(1),,
3,0,8,4,12,1,3,4,8,2,3,2,7,3,14,10,27,7,7,1.0,M2018-10-24D,Race(1),,
4,2,6,10,18,1,15,3,19,4,8,3,15,7,29,16,52,8,8,0.0,M2018-10-24D,Race(1),,
5,0,2,0,2,0,0,0,0,0,0,2,2,0,2,2,4,12,12,3.0,M2018-10-24D,Race(1),,
6,3,0,0,3,1,1,0,2,0,2,0,2,4,3,0,7,15,15,2.0,M2018-10-24D,Race(1),,
7,2,0,0,2,0,0,0,0,0,2,1,3,2,2,1,5,15,15,0.0,M2018-10-24D,Race(1),,
8,3,0,0,3,0,2,2,4,0,0,1,1,3,2,3,8,17,17,0.0,M2018-10-24D,Race(1),,
9,0,0,0,0,0,0,0,0,0,0,1,1,0,0,1,1,14,13,0.0,M2018-10-24D,Race(1),,
10,0,2,0,2,0,1,2,3,0,0,4,4,0,3,6,9,14,15,0.0,M2018-10-24D,Race(1),,
11,0,0,0,0,1,0,3,4,2,0,3,5,3,0,6,9,17,17,0.0,M2018-10-24D,Race(1),,
12,0,3,3,6,0,1,1,2,0,1,1,2,0,5,5,10,21,21,0.0,M2018-10-24D,Race(1),,
1,0,9,6,15,1,1,1,3,1,3,1,5,2,13,8,23,5,5,1.0,M2018-10-24D,Race(2),,
2,3,5,5,13,3,3,11,17,6,2,7,15,12,10,23,45,5,5,0.0,M2018-10-24D,Race(2),,
3,5,0,2,7,3,2,3,8,1,2,1,4,9,4,6,19,9,9,0.0,M2018-10-24D,Race(2),,
4,6,0,0,6,1,0,5,6,1,1,5,7,8,1,10,19,5,5,0.0,M2018-10-24D,Race(2),,
5,2,6,5,13,6,12,4,22,5,8,5,18,13,26,14,53,5,5,0.0,M2018-10-24D,Race(2),,
6,2,0,0,2,0,2,1,3,0,2,0,2,2,4,1,7,13,13,2.0,M2018-10-24D,Race(2),,
7,12,10,3,25,15,8,2,25,9,3,4,16,36,21,9,66,4.8,5,0.0,M2018-10-24D,Race(2),,
8,0,0,9,9,1,2,3,6,3,5,3,11,4,7,15,26,8,8,3.0,M2018-10-24D,Race(2),,
1,17,6,2,25,23,3,4,30,19,4,3,26,59,13,9,81,2.65,2.5,0.0,M2018-10-24D,Race(3),,
2,2,0,0,2,0,0,1,1,1,0,0,1,3,0,1,4,34,34,0.0,M2018-10-24D,Race(3),,
3,2,9,7,18,1,15,4,20,2,10,4,16,5,34,15,54,9,9,1.0,M2018-10-24D,Race(3),,
4,0,0,5,5,0,1,2,3,0,0,5,5,0,1,12,13,8,9,0.0,M2018-10-24D,Race(3),,
5,0,5,5,10,1,3,4,8,1,5,4,10,2,13,13,28,13,13,0.0,M2018-10-24D,Race(3),,
6,3,0,3,6,0,0,0,0,0,0,0,0,3,0,3,6,13,13,0.0,M2018-10-24D,Race(3),,
7,0,2,3,5,0,0,0,0,0,0,1,1,0,2,4,6,16,13,2.0,M2018-10-24D,Race(3),,
8,6,8,3,17,5,8,14,27,3,7,9,19,14,23,26,63,2.8,2.9,0.0,M2018-10-24D,Race(3),,
9,0,0,2,2,0,0,1,1,0,0,0,0,0,0,3,3,19,21,3.0,M2018-10-24D,Race(3),,
10,0,0,0,0,0,0,0,0,0,0,0,0,0,0,0,0,51,51,0.0,M2018-10-24D,Race(3),,
1,0,0,0,0,4,1,3,8,3,0,4,7,7,1,7,15,21,21,0.0,M2018-10-24D,Race(4),,
2,16,6,8,30,18,7,3,28,14,7,1,22,48,20,12,80,2.5,2.5,2.0,M2018-10-24D,Race(4),,
3,3,6,8,17,2,4,11,17,2,3,6,11,7,13,25,45,11,11,3.0,M2018-10-24D,Race(4),,
4,0,3,6,9,3,11,1,15,3,5,3,11,6,19,10,35,9,9,0.0,M2018-10-24D,Race(4),,
5,2,2,0,4,2,1,2,5,2,3,1,6,6,6,3,15,9,9,0.0,M2018-10-24D,Race(4),,
6,0,0,0,0,0,0,1,1,0,0,1,1,0,0,2,2,34,34,0.0,M2018-10-24D,Race(4),,
7,0,0,5,5,0,0,1,1,0,1,1,2,0,1,7,8,21,21,0.0,M2018-10-24D,Race(4),,
8,0,0,0,0,0,0,0,0,0,0,0,0,0,0,0,0,51,51,0.0,M2018-10-24D,Race(4),,
9,0,0,0,0,0,0,1,1,0,0,2,2,0,0,3,3,17,17,0.0,M2018-10-24D,Race(4),,
10,0,0,0,0,0,0,1,1,1,0,0,1,1,0,1,2,17,17,0.0,M2018-10-24D,Race(4),,
11,0,8,3,11,1,2,1,4,1,2,2,5,2,12,6,20,7.5,7.5,0.0,M2018-10-24D,Race(4),,
12,9,5,0,14,0,4,5,9,0,5,5,10,9,14,10,33,5.5,5.5,1.0,M2018-10-24D,Race(4),,
1,10,7,11,28,25,3,1,29,17,4,0,21,52,14,12,78,3.5,3.5,0.0,M2018-10-24D,Race(5),,
2,12,10,0,22,1,16,8,25,3,6,8,17,16,32,16,64,3.9,3.6,1.0,M2018-10-24D,Race(5),,
3,2,3,0,5,0,3,4,7,1,3,7,11,3,9,11,23,18,21,0.0,M2018-10-24D,Race(5),,
4,3,6,3,12,1,2,2,5,1,6,3,10,5,14,8,27,8.5,9,2.0,M2018-10-24D,Race(5),,
5,0,0,3,3,0,0,0,0,0,0,0,0,0,0,3,3,12,12,0.0,M2018-10-24D,Race(5),,
6,0,2,6,8,0,0,1,1,0,0,1,1,0,2,8,10,12,12,0.0,M2018-10-24D,Race(5),,
7,0,0,0,0,0,0,0,0,0,0,0,0,0,0,0,0,71,61,0.0,M2018-10-24D,Race(5),,
8,0,0,0,0,0,0,0,0,4,0,0,4,4,0,0,4,81,81,0.0,M2018-10-24D,Race(5),,
9,3,0,7,10,3,6,12,21,0,4,6,10,6,10,25,41,5,5,3.0,M2018-10-24D,Race(5),,
10,0,0,0,0,0,0,0,0,0,0,0,0,0,0,0,0,41,41,0.0,M2018-10-24D,Race(5),,
11,0,0,0,0,0,0,0,0,0,0,0,0,0,0,0,0,13,13,0.0,M2018-10-24D,Race(5),,
12,0,2,0,2,0,0,2,2,0,3,1,4,0,5,3,8,13,13,0.0,M2018-10-24D,Race(5),,
1,0,0,0,0,0,0,0,0,2,0,0,2,2,0,0,2,34,34,0.0,M2018-10-24D,Race(6),,
2,6,14,0,20,2,9,8,19,3,5,10,18,11,28,18,57,6.5,6.5,2.0,M2018-10-24D,Race(6),,
3,0,2,8,10,1,1,1,3,2,3,0,5,3,6,9,18,13,13,3.0,M2018-10-24D,Race(6),,
4,0,0,0,0,0,0,0,0,0,1,1,2,0,1,1,2,21,21,0.0,M2018-10-24D,Race(6),,
5,0,0,0,0,0,0,0,0,0,0,0,0,0,0,0,0,51,51,0.0,M2018-10-24D,Race(6),,
6,20,3,4,27,24,3,2,29,14,5,3,22,58,11,9,78,1.95,1.95,1.0,M2018-10-24D,Race(6),,
7,0,0,0,0,0,0,0,0,0,0,0,0,0,0,0,0,51,51,0.0,M2018-10-24D,Race(6),,
8,0,6,2,8,1,0,1,2,2,0,4,6,3,6,7,16,12,12,0.0,M2018-10-24D,Race(6),,
9,2,2,10,14,0,1,14,15,0,0,5,5,2,3,29,34,8,8,0.0,M2018-10-24D,Race(6),,
10,0,0,0,0,0,0,0,0,0,0,0,0,0,0,0,0,101,101,0.0,M2018-10-24D,Race(6),,
11,2,3,6,11,2,16,4,22,3,12,3,18,7,31,13,51,5.5,5.5,0.0,M2018-10-24D,Race(6),,
12,0,0,0,0,0,0,0,0,0,0,0,0,0,0,0,0,41,41,0.0,M2018-10-24D,Race(6),,
1,12,8,7,27,20,8,1,29,12,7,2,21,44,23,10,77,2.7,2.7,2.0,M2018-10-24D,Race(7),,
2,0,0,0,0,0,0,0,0,0,0,0,0,0,0,0,0,41,41,0.0,M2018-10-24D,Race(7),,
3,0,2,2,4,2,1,4,7,0,1,4,5,2,4,10,16,21,21,0.0,M2018-10-24D,Race(7),,
4,0,0,0,0,0,2,2,4,1,4,1,6,1,6,3,10,12,12,0.0,M2018-10-24D,Race(7),,
5,5,5,2,12,5,11,4,20,7,2,6,15,17,18,12,47,9,9,0.0,M2018-10-24D,Race(7),,
6,5,0,0,5,0,0,0,0,0,1,0,1,5,1,0,6,19,21,0.0,M2018-10-24D,Race(7),,
7,0,0,0,0,0,0,0,0,1,1,0,2,1,1,0,2,13,13,0.0,M2018-10-24D,Race(7),,
8,0,3,6,9,1,5,12,18,1,3,3,7,2,11,21,34,10,10,0.0,M2018-10-24D,Race(7),,
9,0,0,3,3,0,0,0,0,0,0,0,0,0,0,3,3,34,34,0.0,M2018-10-24D,Race(7),,
10,0,0,2,2,1,1,0,2,1,2,1,4,2,3,3,8,9,9,3.0,M2018-10-24D,Race(7),,
11,5,12,5,22,1,2,4,7,2,3,7,12,8,17,16,41,6.5,7,0.0,M2018-10-24D,Race(7),,
12,3,0,3,6,0,0,3,3,1,2,2,5,4,2,8,14,7,7,1.0,M2018-10-24D,Race(7),,
1,0,6,0,6,0,2,0,2,0,1,1,2,0,9,1,10,14,14,0.0,M2018-10-24D,Race(8),,
2,2,0,3,5,1,1,0,2,2,0,4,6,5,1,7,13,11,11,0.0,M2018-10-24D,Race(8),,
3,3,5,8,16,2,3,14,19,4,8,4,16,9,16,26,51,6.5,6.5,0.0,M2018-10-24D,Race(8),,
4,16,5,4,25,18,5,4,27,9,5,5,19,43,15,13,71,2.3,2.3,1.0,M2018-10-24D,Race(8),,
5,5,3,10,18,7,12,7,26,8,6,5,19,20,21,22,63,7.5,7.5,0.0,M2018-10-24D,Race(8),,
6,0,0,0,0,0,0,1,1,0,0,0,0,0,0,1,1,26,26,3.0,M2018-10-24D,Race(8),,
7,0,0,0,0,0,0,0,0,0,1,0,1,0,1,0,1,81,81,0.0,M2018-10-24D,Race(8),,
8,0,2,0,2,0,2,0,2,0,1,0,1,0,5,0,5,13,13,0.0,M2018-10-24D,Race(8),,
9,0,0,0,0,0,0,0,0,0,0,0,0,0,0,0,0,13,13,0.0,M2018-10-24D,Race(8),,
10,0,3,2,5,1,0,0,1,1,0,0,1,2,3,2,7,13,13,2.0,M2018-10-24D,Race(8),,
11,0,4,0,4,0,0,1,1,0,0,2,2,0,4,3,7,21,21,0.0,M2018-10-24D,Race(8),,
12,4,2,3,9,1,5,3,9,2,4,5,11,7,11,11,29,10,10,0.0,M2018-10-24D,Race(8),,
1,3,4,4,11,0,2,3,5,0,4,4,8,3,10,11,24,9,9,0.0,M2018-10-28D,Race(1),,
2,7,6,5,18,4,14,6,24,4,4,7,15,15,24,18,57,4.4,4.5,3.0,M2018-10-28D,Race(1),,
3,0,0,0,0,0,0,0,0,0,0,0,0,0,0,0,0,101,101,0.0,M2018-10-28D,Race(1),,
4,13,6,5,24,19,4,2,25,15,6,0,21,47,16,7,70,2.7,2.7,0.0,M2018-10-28D,Race(1),,
5,0,0,0,0,0,0,0,0,0,1,1,2,0,1,1,2,16,16,0.0,M2018-10-28D,Race(1),,
6,3,11,3,17,1,8,4,13,2,8,6,16,6,27,13,46,8.5,8.5,2.0,M2018-10-28D,Race(1),,
7,0,0,5,5,0,1,1,2,0,0,1,1,0,1,7,8,18,17,0.0,M2018-10-28D,Race(1),,
8,0,0,0,0,0,0,0,0,0,0,1,1,0,0,1,1,126,126,0.0,M2018-10-28D,Race(1),,
9,0,0,0,0,2,0,1,3,1,0,1,2,3,0,2,5,18,17,0.0,M2018-10-28D,Race(1),,
10,4,3,8,15,4,1,13,18,4,3,5,12,12,7,26,45,5,5,1.0,M2018-10-28D,Race(1),,
11,0,0,0,0,0,0,0,0,0,0,0,0,0,0,0,0,31,31,0.0,M2018-10-28D,Race(1),,
12,0,0,0,0,0,0,0,0,0,0,0,0,0,0,0,0,17,17,0.0,M2018-10-28D,Race(1),,
1,0,0,0,0,0,0,0,0,1,0,0,1,1,0,0,1,21,21,0.0,M2018-10-28D,Race(10),,
2,0,8,2,10,1,3,4,8,3,1,4,8,4,12,10,26,10,10,2.0,M2018-10-28D,Race(10),,
3,23,0,3,26,7,17,2,26,7,14,0,21,37,31,5,73,2.3,2.3,3.0,M2018-10-28D,Race(10),,
4,0,2,3,5,0,0,5,5,0,0,7,7,0,2,15,17,14,14,0.0,M2018-10-28D,Race(10),,
5,2,3,10,15,0,2,4,6,0,3,8,11,2,8,22,32,9,9,0.0,M2018-10-28D,Race(10),,
6,0,13,7,20,18,4,6,28,14,6,3,23,32,23,16,71,6.5,6,0.0,M2018-10-28D,Race(10),,
7,0,0,0,0,0,0,0,0,0,1,0,1,0,1,0,1,16,16,0.0,M2018-10-28D,Race(10),,
8,5,0,5,10,3,3,8,14,0,1,3,4,8,4,16,28,7.5,7.5,0.0,M2018-10-28D,Race(10),,
9,0,0,0,0,1,1,0,2,0,0,0,0,1,1,0,2,34,34,1.0,M2018-10-28D,Race(10),,
10,0,2,0,2,0,0,0,0,1,0,0,1,1,2,0,3,34,26,0.0,M2018-10-28D,Race(10),,
11,0,2,0,2,0,0,0,0,0,0,0,0,0,2,0,2,18,18,0.0,M2018-10-28D,Race(10),,
12,0,0,0,0,0,0,1,1,0,0,1,1,0,0,2,2,21,21,0.0,M2018-10-28D,Race(10),,
1,0,0,2,2,0,0,1,1,0,2,2,4,0,2,5,7,12,12,0.0,M2018-10-28D,Race(2),,
2,0,0,0,0,0,0,0,0,1,0,0,1,1,0,0,1,34,34,0.0,M2018-10-28D,Race(2),,
3,0,3,13,16,3,9,6,18,1,2,7,10,4,14,26,44,6.5,6.5,0.0,M2018-10-28D,Race(2),,
4,23,3,0,26,21,7,2,30,19,5,1,25,63,15,3,81,2.3,2.3,2.0,M2018-10-28D,Race(2),,
5,0,6,2,8,0,2,0,2,0,1,2,3,0,9,4,13,12,12,0.0,M2018-10-28D,Race(2),,
6,2,10,5,17,2,3,5,10,2,6,5,13,6,19,15,40,7,7,0.0,M2018-10-28D,Race(2),,
7,3,8,0,11,2,6,13,21,0,6,4,10,5,20,17,42,7,7,3.0,M2018-10-28D,Race(2),,
8,0,0,0,0,0,1,0,1,0,1,1,2,0,2,1,3,31,31,0.0,M2018-10-28D,Race(2),,
9,0,0,8,8,2,0,2,4,3,0,2,5,5,0,12,17,12,12,1.0,M2018-10-28D,Race(2),,
10,2,0,0,2,0,0,0,0,0,1,0,1,2,1,0,3,21,21,0.0,M2018-10-28D,Race(2),,
11,0,0,0,0,0,2,1,3,0,2,2,4,0,4,3,7,15,15,0.0,M2018-10-28D,Race(2),,
1,0,0,2,2,1,2,5,8,3,2,3,8,4,4,10,18,14,14,0.0,M2018-10-28D,Race(3),,
2,2,10,3,15,2,6,9,17,3,5,3,11,7,21,15,43,4.8,4.8,0.0,M2018-10-28D,Race(3),,
3,0,5,0,5,0,3,5,8,2,2,4,8,2,10,9,21,34,34,0.0,M2018-10-28D,Race(3),,
4,2,2,2,6,1,0,0,1,0,0,0,0,3,2,2,7,15,15,1.0,M2018-10-28D,Race(3),,
5,0,0,2,2,0,0,0,0,0,2,2,4,0,2,4,6,41,41,0.0,M2018-10-28D,Race(3),,
6,0,0,5,5,0,3,1,4,1,5,3,9,1,8,9,18,8,8,0.0,M2018-10-28D,Race(3),,
7,6,0,2,8,14,2,2,18,5,1,4,10,25,3,8,36,6,6,0.0,M2018-10-28D,Race(3),,
8,0,0,2,2,0,0,0,0,0,0,0,0,0,0,2,2,18,18,0.0,M2018-10-28D,Race(3),,
9,6,6,0,12,1,1,3,5,0,2,2,4,7,9,5,21,10,10,2.0,M2018-10-28D,Race(3),,
10,3,0,3,6,0,0,0,0,0,0,0,0,3,0,3,6,18,18,0.0,M2018-10-28D,Race(3),,
11,5,5,3,13,4,4,2,10,3,4,3,10,12,13,8,33,6.5,6.5,3.0,M2018-10-28D,Race(3),,
12,6,2,6,14,7,9,3,19,9,3,2,14,22,14,11,47,4,4,0.0,M2018-10-28D,Race(3),,
1,0,0,0,0,1,1,0,2,0,0,0,0,1,1,0,2,17,17,0.0,M2018-10-28D,Race(4),,
2,2,3,2,7,1,1,1,3,2,2,1,5,5,6,4,15,17,16,0.0,M2018-10-28D,Race(4),,
3,5,4,8,17,4,14,4,22,3,6,7,16,12,24,19,55,4.4,4.2,1.0,M2018-10-28D,Race(4),,
4,0,0,0,0,0,0,0,0,1,0,0,1,1,0,0,1,31,34,0.0,M2018-10-28D,Race(4),,
5,0,2,3,5,0,0,4,4,1,2,2,5,1,4,9,14,15,15,0.0,M2018-10-28D,Race(4),,
6,0,0,0,0,0,0,1,1,0,0,1,1,0,0,2,2,34,34,0.0,M2018-10-28D,Race(4),,
7,2,6,0,8,14,5,3,22,6,5,3,14,22,16,6,44,9,8.5,3.0,M2018-10-28D,Race(4),,
8,2,8,10,20,2,3,3,8,1,5,5,11,5,16,18,39,7.5,7.5,0.0,M2018-10-28D,Race(4),,
9,0,0,0,0,0,0,0,0,0,0,0,0,0,0,0,0,23,21,0.0,M2018-10-28D,Race(4),,
10,0,0,3,3,1,0,0,1,0,0,0,0,1,0,3,4,31,34,0.0,M2018-10-28D,Race(4),,
11,19,7,2,28,7,6,13,26,12,6,4,22,38,19,19,76,2.3,2.3,2.0,M2018-10-28D,Race(4),,
12,0,0,2,2,0,0,1,1,0,0,3,3,0,0,6,6,17,17,0.0,M2018-10-28D,Race(4),,
1,17,7,4,28,23,2,5,30,20,1,3,24,60,10,12,82,3.8,3.8,0.0,M2018-10-28D,Race(5),,
2,2,3,2,7,0,1,0,1,0,3,1,4,2,7,3,12,13,12,0.0,M2018-10-28D,Race(5),,
3,5,8,0,13,0,2,1,3,1,4,2,7,6,14,3,23,10,9,0.0,M2018-10-28D,Race(5),,
4,0,0,0,0,0,0,0,0,0,0,0,0,0,0,0,0,81,81,0.0,M2018-10-28D,Race(5),,
5,0,2,3,5,0,2,1,3,0,0,1,1,0,4,5,9,11,11,0.0,M2018-10-28D,Race(5),,
6,0,3,8,11,0,3,13,16,0,5,6,11,0,11,27,38,4.4,4.2,0.0,M2018-10-28D,Race(5),,
7,6,5,9,20,3,15,6,24,2,8,7,17,11,28,22,61,5,5,1.0,M2018-10-28D,Race(5),,
8,0,0,2,2,3,4,4,11,2,2,2,6,5,6,8,19,9.5,9,0.0,M2018-10-28D,Race(5),,
9,0,2,0,2,0,1,0,1,0,1,0,1,0,4,0,4,18,17,2.0,M2018-10-28D,Race(5),,
10,0,0,0,0,0,0,0,0,0,0,2,2,0,0,2,2,17,17,3.0,M2018-10-28D,Race(5),,
11,0,0,0,0,1,0,0,1,1,1,1,3,2,1,1,4,26,26,0.0,M2018-10-28D,Race(5),,
12,0,0,2,2,0,0,0,0,0,1,1,2,0,1,3,4,23,21,0.0,M2018-10-28D,Race(5),,
1,4,2,2,8,4,1,5,10,1,1,3,5,9,4,10,23,8.5,8,2.0,M2018-10-28D,Race(6),,
2,13,2,3,18,1,8,9,18,4,10,5,19,18,20,17,55,4.8,4.5,3.0,M2018-10-28D,Race(6),,
3,3,5,3,11,4,7,3,14,5,6,2,13,12,18,8,38,8.5,8.5,0.0,M2018-10-28D,Race(6),,
4,0,8,9,17,14,6,7,27,8,3,7,18,22,17,23,62,4.2,4,1.0,M2018-10-28D,Race(6),,
5,0,0,0,0,0,0,0,0,0,0,0,0,0,0,0,0,18,17,0.0,M2018-10-28D,Race(6),,
6,0,0,0,0,1,0,1,2,1,2,1,4,2,2,2,6,16,16,0.0,M2018-10-28D,Race(6),,
7,0,0,2,2,0,0,0,0,0,0,1,1,0,0,3,3,21,21,0.0,M2018-10-28D,Race(6),,
8,3,7,8,18,6,8,2,16,7,3,3,13,16,18,13,47,4.2,4.5,0.0,M2018-10-28D,Race(6),,
9,7,3,3,13,0,0,3,3,0,1,2,3,7,4,8,19,8,8,0.0,M2018-10-28D,Race(6),,
10,0,3,0,3,0,0,0,0,0,0,1,1,0,3,1,4,21,21,0.0,M2018-10-28D,Race(6),,
11,0,0,0,0,0,0,0,0,0,0,0,0,0,0,0,0,101,101,0.0,M2018-10-28D,Race(6),,
12,0,0,0,0,0,0,0,0,0,0,0,0,0,0,0,0,81,81,0.0,M2018-10-28D,Race(6),,
1,0,0,0,0,0,0,0,0,0,0,0,0,0,0,0,0,17,15,0.0,M2018-10-28D,Race(7),,
2,5,3,0,8,0,3,13,16,0,3,1,4,5,9,14,28,6.5,6.5,3.0,M2018-10-28D,Race(7),,
3,0,0,0,0,0,0,3,3,0,0,2,2,0,0,5,5,17,15,0.0,M2018-10-28D,Race(7),,
4,0,0,9,9,0,0,2,2,0,1,4,5,0,1,15,16,12,12,0.0,M2018-10-28D,Race(7),,
5,18,8,2,28,20,10,0,30,14,10,1,25,52,28,3,83,2.5,2.5,2.0,M2018-10-28D,Race(7),,
6,5,15,5,25,10,16,3,29,11,8,3,22,26,39,11,76,3.8,3.8,0.0,M2018-10-28D,Race(7),,
7,0,4,12,16,0,0,8,8,1,3,12,16,1,7,32,40,8,7.5,0.0,M2018-10-28D,Race(7),,
8,0,0,0,0,0,0,0,0,0,0,2,2,0,0,2,2,21,21,1.0,M2018-10-28D,Race(7),,
9,2,0,2,4,0,1,1,2,0,1,0,1,2,2,3,7,17,17,0.0,M2018-10-28D,Race(7),,
10,0,0,0,0,0,0,0,0,0,0,1,1,0,0,1,1,34,34,0.0,M2018-10-28D,Race(7),,
1,2,10,2,14,4,2,11,17,5,4,5,14,11,16,18,45,4.4,4.2,0.0,M2018-10-28D,Race(8),,
2,5,5,5,15,18,2,3,23,13,2,2,17,36,9,10,55,5.5,5.5,2.0,M2018-10-28D,Race(8),,
3,6,0,2,8,1,1,2,4,0,1,3,4,7,2,7,16,7.5,7.5,0.0,M2018-10-28D,Race(8),,
4,0,0,0,0,0,0,0,0,0,0,0,0,0,0,0,0,34,31,0.0,M2018-10-28D,Race(8),,
5,0,0,0,0,0,0,0,0,0,1,0,1,0,1,0,1,21,21,0.0,M2018-10-28D,Race(8),,
6,3,11,4,18,3,17,5,25,4,9,4,17,10,37,13,60,3.5,3.5,0.0,M2018-10-28D,Race(8),,
7,6,0,0,6,1,1,2,4,1,2,4,7,8,3,6,17,11,10,0.0,M2018-10-28D,Race(8),,
8,0,0,6,6,0,0,0,0,0,0,0,0,0,0,6,6,18,17,1.0,M2018-10-28D,Race(8),,
9,6,0,11,17,2,5,5,12,2,6,4,12,10,11,20,41,10,10,3.0,M2018-10-28D,Race(8),,
10,2,0,0,2,1,0,0,1,0,0,0,0,3,0,0,3,21,21,0.0,M2018-10-28D,Race(8),,
11,0,0,0,0,0,1,0,1,0,1,1,2,0,2,1,3,41,41,0.0,M2018-10-28D,Race(8),,
12,0,4,0,4,0,1,2,3,1,0,3,4,1,5,5,11,19,17,0.0,M2018-10-28D,Race(8),,
1,0,3,3,6,0,2,0,2,0,1,0,1,0,6,3,9,19,17,0.0,M2018-10-28D,Race(9),,
2,2,2,0,4,2,4,1,7,0,2,1,3,4,8,2,14,13,13,0.0,M2018-10-28D,Race(9),,
3,0,0,0,0,0,0,0,0,0,0,0,0,0,0,0,0,26,26,0.0,M2018-10-28D,Race(9),,
4,5,5,0,10,3,2,9,14,1,3,0,4,9,10,9,28,10,10,1.0,M2018-10-28D,Race(9),,
5,0,0,0,0,0,0,0,0,0,0,0,0,0,0,0,0,26,21,0.0,M2018-10-28D,Race(9),,
6,0,0,3,3,1,2,3,6,0,3,5,8,1,5,11,17,12,12,3.0,M2018-10-28D,Race(9),,
7,4,5,7,16,15,3,3,21,15,5,0,20,34,13,10,57,7.5,7.5,0.0,M2018-10-28D,Race(9),,
8,3,4,5,12,5,4,4,13,5,5,6,16,13,13,15,41,8,8,0.0,M2018-10-28D,Race(9),,
9,0,0,2,2,0,0,0,0,0,1,1,2,0,1,3,4,21,21,0.0,M2018-10-28D,Race(9),,
10,3,0,3,6,0,1,2,3,0,2,2,4,3,3,7,13,5.5,5,0.0,M2018-10-28D,Race(9),,
11,13,8,4,25,3,1,6,10,5,3,7,15,21,12,17,50,3.6,3.5,2.0,M2018-10-28D,Race(9),,
12,0,3,3,6,1,11,2,14,0,1,4,5,1,15,9,25,8.5,8.5,0.0,M2018-10-28D,Race(9),,
1,0,0,2,2,0,1,1,2,0,0,2,2,0,1,5,6,26,26,0.0,M2018-10-31D,Race(1),,
2,10,0,0,10,6,13,3,22,10,6,3,19,26,19,6,51,4.2,4.2,0.0,M2018-10-31D,Race(1),,
3,4,2,5,11,14,6,6,26,8,5,7,20,26,13,18,57,7.5,7.5,0.0,M2018-10-31D,Race(1),,
4,0,2,0,2,7,1,3,11,6,3,2,11,13,6,5,24,6,6,2.0,M2018-10-31D,Race(1),,
5,8,6,0,14,0,1,0,1,1,1,2,4,9,8,2,19,9,9,0.0,M2018-10-31D,Race(1),,
6,0,3,8,11,1,0,2,3,0,0,5,5,1,3,15,19,14,14,1.0,M2018-10-31D,Race(1),,
7,0,0,0,0,0,0,0,0,0,0,0,0,0,0,0,0,61,61,0.0,M2018-10-31D,Race(1),,
8,0,0,0,0,0,0,0,0,0,0,1,1,0,0,1,1,17,17,0.0,M2018-10-31D,Race(1),,
9,2,6,2,10,1,4,12,17,0,7,0,7,3,17,14,34,7.5,7.5,0.0,M2018-10-31D,Race(1),,
10,3,3,0,6,1,0,0,1,1,0,0,1,5,3,0,8,17,17,3.0,M2018-10-31D,Race(1),,
11,0,0,2,2,0,0,0,0,0,0,0,0,0,0,2,2,21,21,0.0,M2018-10-31D,Race(1),,
12,0,0,0,0,0,0,1,1,0,0,0,0,0,0,1,1,81,81,0.0,M2018-10-31D,Race(1),,
13,3,6,11,20,0,4,2,6,0,4,2,6,3,14,15,32,6.5,6.5,0.0,M2018-10-31D,Race(1),,
14,0,2,0,2,0,0,0,0,0,0,2,2,0,2,2,4,18,18,0.0,M2018-10-31D,Race(1),,
1,5,7,2,14,7,2,18,27,8,5,6,19,20,14,26,60,4.6,4.5,0.0,M2018-10-31D,Race(2),,
2,0,0,0,0,1,1,0,2,0,2,0,2,1,3,0,4,15,15,1.0,M2018-10-31D,Race(2),,
3,0,3,3,6,1,0,0,1,0,0,1,1,1,3,4,8,21,21,0.0,M2018-10-31D,Race(2),,
4,18,3,3,24,16,7,4,27,12,4,5,21,46,14,12,72,3.3,3.2,0.0,M2018-10-31D,Race(2),,
5,0,0,0,0,0,0,0,0,1,0,0,1,1,0,0,1,17,17,0.0,M2018-10-31D,Race(2),,
6,0,2,0,2,0,0,0,0,0,0,0,0,0,2,0,2,34,34,0.0,M2018-10-31D,Race(2),,
7,0,8,2,10,3,12,2,17,2,8,0,10,5,28,4,37,7,7,2.0,M2018-10-31D,Race(2),,
8,0,0,0,0,1,1,0,2,0,0,1,1,1,1,1,3,21,21,0.0,M2018-10-31D,Race(2),,
9,0,0,3,3,1,1,3,5,3,1,8,12,4,2,14,20,17,17,0.0,M2018-10-31D,Race(2),,
10,3,0,9,12,0,1,1,2,0,1,2,3,3,2,12,17,7.5,7.5,3.0,M2018-10-31D,Race(2),,
11,4,7,8,19,0,5,2,7,0,5,3,8,4,17,13,34,6.5,6.5,0.0,M2018-10-31D,Race(2),,
12,0,0,0,0,0,0,0,0,0,0,0,0,0,0,0,0,41,41,0.0,M2018-10-31D,Race(2),,
1,14,2,7,23,23,5,1,29,17,4,3,24,54,11,11,76,2.7,2.7,1.0,M2018-10-31D,Race(3),,
2,4,8,11,23,4,13,8,25,3,3,9,15,11,24,28,63,5.5,5.5,0.0,M2018-10-31D,Race(3),,
3,0,0,0,0,0,0,2,2,0,1,2,3,0,1,4,5,11,11,0.0,M2018-10-31D,Race(3),,
4,2,9,0,11,0,4,14,18,1,4,4,9,3,17,18,38,6,6,0.0,M2018-10-31D,Race(3),,
5,5,0,3,8,0,1,2,3,2,2,3,7,7,3,8,18,10,10,3.0,M2018-10-31D,Race(3),,
6,0,0,0,0,0,0,0,0,0,0,0,0,0,0,0,0,21,21,0.0,M2018-10-31D,Race(3),,
7,0,0,2,2,0,0,0,0,0,1,0,1,0,1,2,3,41,41,0.0,M2018-10-31D,Race(3),,
8,3,5,7,15,3,6,3,12,3,10,4,17,9,21,14,44,4.2,4.2,2.0,M2018-10-31D,Race(3),,
9,2,6,0,8,0,1,0,1,0,1,1,2,2,8,1,11,13,13,0.0,M2018-10-31D,Race(3),,
1,5,0,0,5,1,0,1,2,1,2,4,7,7,2,5,14,11,11,0.0,M2018-10-31D,Race(4),,
2,9,0,5,14,6,12,3,21,6,5,2,13,21,17,10,48,8,8,3.0,M2018-10-31D,Race(4),,
3,2,11,8,21,13,11,4,28,3,12,3,18,18,34,15,67,4,4,1.0,M2018-10-31D,Race(4),,
4,0,6,2,8,0,0,2,2,1,0,0,1,1,6,4,11,9.5,9,0.0,M2018-10-31D,Race(4),,
5,5,0,2,7,3,1,14,18,3,1,5,9,11,2,21,34,10,10,0.0,M2018-10-31D,Race(4),,
6,2,2,2,6,4,2,1,7,7,0,2,9,13,4,5,22,8,8,0.0,M2018-10-31D,Race(4),,
7,0,0,0,0,0,0,0,0,0,0,1,1,0,0,1,1,41,41,0.0,M2018-10-31D,Race(4),,
8,0,2,0,2,0,0,0,0,0,0,0,0,0,2,0,2,34,34,0.0,M2018-10-31D,Race(4),,
9,0,2,2,4,0,0,0,0,0,0,0,0,0,2,2,4,12,12,0.0,M2018-10-31D,Race(4),,
10,4,3,6,13,1,1,2,4,2,3,4,9,7,7,12,26,9,9,0.0,M2018-10-31D,Race(4),,
11,3,2,3,8,0,0,0,0,0,1,0,1,3,3,3,9,8,7.5,2.0,M2018-10-31D,Race(4),,
12,0,2,0,2,0,0,0,0,0,0,0,0,0,2,0,2,9.5,9,0.0,M2018-10-31D,Race(4),,
1,0,0,0,0,0,0,0,0,0,0,1,1,0,0,1,1,31,31,0.0,M2018-10-31D,Race(5),,
2,7,6,5,18,2,4,4,10,0,5,3,8,9,15,12,36,8.5,8.5,3.0,M2018-10-31D,Race(5),,
3,3,0,2,5,5,13,3,21,5,5,1,11,13,18,6,37,9,9,0.0,M2018-10-31D,Race(5),,
4,0,3,8,11,3,0,3,6,3,0,5,8,6,3,16,25,17,17,0.0,M2018-10-31D,Race(5),,
5,0,2,3,5,0,0,0,0,0,1,0,1,0,3,3,6,8.5,8.5,0.0,M2018-10-31D,Race(5),,
6,13,5,0,18,13,8,6,27,8,7,7,22,34,20,13,67,4.4,4.2,0.0,M2018-10-31D,Race(5),,
7,0,0,0,0,0,0,1,1,0,0,0,0,0,0,1,1,31,31,0.0,M2018-10-31D,Race(5),,
8,0,0,0,0,0,0,0,0,1,0,0,1,1,0,0,1,31,31,0.0,M2018-10-31D,Race(5),,
9,0,0,0,0,0,0,0,0,0,0,0,0,0,0,0,0,17,17,0.0,M2018-10-31D,Race(5),,
10,5,4,5,14,5,2,10,17,5,3,5,13,15,9,20,44,5.5,5.5,1.0,M2018-10-31D,Race(5),,
11,0,0,2,2,1,0,1,2,1,0,1,2,2,0,4,6,11,11,0.0,M2018-10-31D,Race(5),,
12,2,10,5,17,1,3,2,6,3,5,3,11,6,18,10,34,4.6,4.4,2.0,M2018-10-31D,Race(5),,
1,2,3,0,5,2,1,3,6,3,2,3,8,7,6,6,19,7.5,7.5,0.0,M2018-10-31D,Race(6),,
2,4,3,0,7,0,0,0,0,1,0,0,1,5,3,0,8,19,19,2.0,M2018-10-31D,Race(6),,
3,6,12,10,28,17,8,1,26,6,10,3,19,29,30,14,73,4.2,4.2,0.0,M2018-10-31D,Race(6),,
4,0,0,8,8,3,1,5,9,1,2,5,8,4,3,18,25,8,8,0.0,M2018-10-31D,Race(6),,
5,2,0,2,4,0,2,2,4,0,2,6,8,2,4,10,16,14,14,0.0,M2018-10-31D,Race(6),,
6,0,5,5,10,5,9,5,19,8,2,4,14,13,16,14,43,11,11,0.0,M2018-10-31D,Race(6),,
7,0,0,0,0,0,0,1,1,0,0,0,0,0,0,1,1,0,0,0.0,M2018-10-31D,Race(6),,
8,0,0,0,0,0,1,1,2,0,1,0,1,0,2,1,3,10,10,0.0,M2018-10-31D,Race(6),,
9,9,0,5,14,0,2,1,3,2,0,1,3,11,2,7,20,6,6,0.0,M2018-10-31D,Race(6),,
10,0,0,0,0,0,0,1,1,0,0,0,0,0,0,1,1,19,19,0.0,M2018-10-31D,Race(6),,
11,0,0,0,0,0,0,1,1,0,1,0,1,0,1,1,2,15,15,0.0,M2018-10-31D,Race(6),,
12,4,5,0,9,3,5,9,17,5,5,3,13,12,15,12,39,12,12,1.0,M2018-10-31D,Race(6),,
13,3,2,0,5,0,1,0,1,0,1,0,1,3,4,0,7,8.5,8.5,3.0,M2018-10-31D,Race(6),,
1,0,0,0,0,0,0,1,1,0,0,0,0,0,0,1,1,21,21,0.0,M2018-10-31D,Race(7),,
2,0,3,0,3,2,0,1,3,0,1,2,3,2,4,3,9,18,18,2.0,M2018-10-31D,Race(7),,
3,3,2,0,5,0,0,2,2,1,0,3,4,4,2,5,11,11,10,3.0,M2018-10-31D,Race(7),,
4,2,5,10,17,7,13,1,21,9,5,2,16,18,23,13,54,8,8,0.0,M2018-10-31D,Race(7),,
5,2,2,2,6,3,0,1,4,3,0,1,4,8,2,4,14,8,8,0.0,M2018-10-31D,Race(7),,
6,0,2,0,2,0,0,0,0,1,0,1,2,1,2,1,4,26,21,0.0,M2018-10-31D,Race(7),,
7,0,11,3,14,1,4,13,18,0,3,8,11,1,18,24,43,8.5,8.5,0.0,M2018-10-31D,Race(7),,
8,0,2,0,2,0,0,1,1,0,0,2,2,0,2,3,5,21,21,0.0,M2018-10-31D,Race(7),,
9,2,0,3,5,2,2,1,5,4,4,0,8,8,6,4,18,12,11,0.0,M2018-10-31D,Race(7),,
10,0,0,0,0,0,0,0,0,0,0,0,0,0,0,0,0,41,41,0.0,M2018-10-31D,Race(7),,
11,0,3,5,8,0,2,3,5,1,1,3,5,1,6,11,18,15,15,0.0,M2018-10-31D,Race(7),,
12,21,0,0,21,15,7,5,27,7,11,3,21,43,18,8,69,2.8,2.8,1.0,M2018-10-31D,Race(7),,
13,0,0,5,5,0,2,1,3,0,1,1,2,0,3,7,10,16,16,0.0,M2018-10-31D,Race(7),,
14,0,0,2,2,0,0,0,0,0,0,0,0,0,0,2,2,34,34,0.0,M2018-10-31D,Race(7),,
1,3,3,0,6,1,1,0,2,0,0,0,0,4,4,0,8,10,10,0.0,M2018-10-31D,Race(8),,
2,2,2,3,7,1,14,4,19,5,5,3,13,8,21,10,39,8.5,8,0.0,M2018-10-31D,Race(8),,
3,9,8,0,17,14,3,4,21,6,1,3,10,29,12,7,48,5,5,0.0,M2018-10-31D,Race(8),,
4,4,5,2,11,1,3,3,7,1,4,3,8,6,12,8,26,6,5.5,0.0,M2018-10-31D,Race(8),,
5,6,4,13,23,7,2,12,21,9,6,3,18,22,12,28,62,7.5,7.5,2.0,M2018-10-31D,Race(8),,
6,0,3,7,10,3,3,4,10,3,6,5,14,6,12,16,34,7,6.5,0.0,M2018-10-31D,Race(8),,
7,0,0,0,0,0,0,0,0,0,0,0,0,0,0,0,0,17,17,1.0,M2018-10-31D,Race(8),,
8,0,0,0,0,0,0,0,0,0,0,0,0,0,0,0,0,19,19,0.0,M2018-10-31D,Race(8),,
9,6,3,5,14,1,0,2,3,2,0,6,8,9,3,13,25,9,9,0.0,M2018-10-31D,Race(8),,
10,0,0,0,0,1,3,0,4,0,3,2,5,1,6,2,9,12,12,3.0,M2018-10-31D,Race(8),,
11,0,2,0,2,1,1,1,3,0,1,1,2,1,4,2,7,12,12,0.0,M2018-10-31D,Race(8),,
12,0,0,0,0,0,0,0,0,0,0,0,0,0,0,0,0,71,67,0.0,M2018-10-31D,Race(8),,
1,7,12,8,27,10,9,2,21,9,8,3,20,26,29,13,68,5,5,0.0,M2018-11-04D,Race(1),,
2,0,0,0,0,0,0,0,0,0,0,0,0,0,0,0,0,81,81,0.0,M2018-11-04D,Race(1),,
3,0,0,0,0,0,0,0,0,0,0,0,0,0,0,0,0,51,51,0.0,M2018-11-04D,Race(1),,
4,0,0,0,0,0,0,0,0,0,1,0,1,0,1,0,1,12,12,0.0,M2018-11-04D,Race(1),,
5,0,2,2,4,0,8,1,9,0,1,2,3,0,11,5,16,26,26,0.0,M2018-11-04D,Race(1),,
6,23,5,2,30,12,10,1,23,15,10,0,25,50,25,3,78,2.1,2.1,3.0,M2018-11-04D,Race(1),,
7,0,3,3,6,0,2,13,15,0,3,13,16,0,8,29,37,7.5,7.5,1.0,M2018-11-04D,Race(1),,
8,0,5,8,13,8,1,5,14,2,2,6,10,10,8,19,37,8,8,2.0,M2018-11-04D,Race(1),,
9,0,0,2,2,0,0,0,0,0,0,0,0,0,0,2,2,15,15,0.0,M2018-11-04D,Race(1),,
10,0,3,0,3,0,0,0,0,0,0,0,0,0,3,0,3,26,26,0.0,M2018-11-04D,Race(1),,
11,0,0,5,5,0,0,8,8,0,1,2,3,0,1,15,16,11,11,0.0,M2018-11-04D,Race(1),,
12,0,0,0,0,0,0,0,0,0,0,0,0,0,0,0,0,71,67,0.0,M2018-11-04D,Race(1),,
1,0,0,0,0,0,0,0,0,0,0,0,0,0,0,0,0,41,41,0.0,M2018-11-04D,Race(10),,
2,3,5,12,20,4,9,6,19,7,11,2,20,14,25,20,59,6.5,6.5,0.0,M2018-11-04D,Race(10),,
3,0,0,0,0,8,0,2,10,1,1,3,5,9,1,5,15,19,21,1.0,M2018-11-04D,Race(10),,
4,0,0,0,0,0,0,0,0,0,0,0,0,0,0,0,0,34,34,0.0,M2018-11-04D,Race(10),,
5,0,0,0,0,0,0,0,0,0,0,0,0,0,0,0,0,34,34,0.0,M2018-11-04D,Race(10),,
6,2,0,3,5,2,8,4,14,1,0,7,8,5,8,14,27,15,15,0.0,M2018-11-04D,Race(10),,
7,0,0,2,2,0,2,8,10,0,1,1,2,0,3,11,14,26,26,0.0,M2018-11-04D,Race(10),,
8,0,0,0,0,0,0,0,0,0,0,1,1,0,0,1,1,34,34,0.0,M2018-11-04D,Race(10),,
9,3,11,6,20,2,4,2,8,1,5,3,9,6,20,11,37,5,5,0.0,M2018-11-04D,Race(10),,
10,19,11,0,30,14,7,1,22,14,7,2,23,47,25,3,75,2,2,3.0,M2018-11-04D,Race(10),,
11,3,3,7,13,0,0,7,7,2,1,7,10,5,4,21,30,10,10,2.0,M2018-11-04D,Race(10),,
12,0,0,0,0,0,0,0,0,0,0,0,0,0,0,0,0,19,21,0.0,M2018-11-04D,Race(10),,
13,0,0,0,0,0,0,0,0,0,0,0,0,0,0,0,0,61,61,0.0,M2018-11-04D,Race(10),,
14,0,0,0,0,0,0,0,0,0,0,0,0,0,0,0,0,61,61,0.0,M2018-11-04D,Race(10),,
1,0,0,0,0,2,2,0,4,0,2,1,3,2,4,1,7,15,15,0.0,M2018-11-04D,Race(2),,
2,0,3,9,12,3,3,4,10,0,3,5,8,3,9,18,30,4.2,4.2,0.0,M2018-11-04D,Race(2),,
3,0,0,0,0,0,8,0,8,3,2,1,6,3,10,1,14,34,35,0.0,M2018-11-04D,Race(2),,
4,14,7,4,25,5,6,6,17,6,3,5,14,25,16,15,56,4.2,4.2,3.0,M2018-11-04D,Race(2),,
5,5,5,7,17,6,5,4,15,5,3,6,14,16,13,17,46,6.5,6.5,1.0,M2018-11-04D,Race(2),,
6,0,3,0,3,2,1,9,12,3,5,3,11,5,9,12,26,21,21,0.0,M2018-11-04D,Race(2),,
7,0,0,0,0,0,0,0,0,0,0,0,0,0,0,0,0,41,41,0.0,M2018-11-04D,Race(2),,
8,4,5,0,9,8,1,2,11,2,2,1,5,14,8,3,25,8,8,0.0,M2018-11-04D,Race(2),,
9,0,0,0,0,0,0,0,0,0,1,0,1,0,1,0,1,34,35,0.0,M2018-11-04D,Race(2),,
10,7,7,7,21,4,4,5,13,7,5,3,15,18,16,15,49,3.8,3.8,2.0,M2018-11-04D,Race(2),,
11,0,0,0,0,0,0,0,0,0,0,0,0,0,0,0,0,41,41,0.0,M2018-11-04D,Race(2),,
12,0,0,3,3,0,0,0,0,0,0,1,1,0,0,4,4,81,81,0.0,M2018-11-04D,Race(2),,
13,0,0,0,0,0,0,0,0,0,0,0,0,0,0,0,0,26,26,0.0,M2018-11-04D,Race(2),,
14,0,0,0,0,0,0,0,0,0,0,0,0,0,0,0,0,51,51,0.0,M2018-11-04D,Race(2),,
1,3,9,2,14,9,2,6,17,9,3,5,17,21,14,13,48,6,6,1.0,M2018-11-04D,Race(3),,
2,8,6,3,17,4,6,2,12,6,8,0,14,18,20,5,43,3.4,3.4,3.0,M2018-11-04D,Race(3),,
3,12,2,5,19,1,1,3,5,1,1,3,5,14,4,11,29,12,12,0.0,M2018-11-04D,Race(3),,
4,5,6,5,16,8,2,1,11,1,2,5,8,14,10,11,35,12,12,0.0,M2018-11-04D,Race(3),,
5,0,3,10,13,0,5,3,8,0,4,4,8,0,12,17,29,9,9,0.0,M2018-11-04D,Race(3),,
6,0,0,0,0,0,0,1,1,2,1,1,4,2,1,2,5,9,9,0.0,M2018-11-04D,Race(3),,
7,0,0,3,3,5,5,2,12,4,5,2,11,9,10,7,26,9,9,0.0,M2018-11-04D,Race(3),,
8,0,2,0,2,0,1,2,3,0,1,2,3,0,4,4,8,12,12,2.0,M2018-11-04D,Race(3),,
9,0,2,0,2,0,8,1,9,0,0,1,1,0,10,2,12,18,18,0.0,M2018-11-04D,Race(3),,
10,2,0,2,4,0,0,8,8,0,1,1,2,2,1,11,14,34,34,0.0,M2018-11-04D,Race(3),,
11,0,0,0,0,0,0,0,0,0,0,0,0,0,0,0,0,21,21,0.0,M2018-11-04D,Race(3),,
12,0,0,0,0,0,0,0,0,0,0,0,0,0,0,0,0,61,61,0.0,M2018-11-04D,Race(3),,
13,0,0,0,0,0,0,0,0,0,0,1,1,0,0,1,1,61,61,0.0,M2018-11-04D,Race(3),,
14,0,0,0,0,0,0,0,0,0,0,0,0,0,0,0,0,11,11,0.0,M2018-11-04D,Race(3),,
1,0,0,0,0,0,0,8,8,0,0,0,0,0,0,8,8,126,126,0.0,M2018-11-04D,Race(4),,
2,0,0,0,0,0,0,0,0,0,0,0,0,0,0,0,0,34,35,0.0,M2018-11-04D,Race(4),,
3,0,0,0,0,0,0,0,0,0,0,0,0,0,0,0,0,34,35,0.0,M2018-11-04D,Race(4),,
4,5,10,5,20,9,4,2,15,9,2,6,17,23,16,13,52,4.6,4.6,1.0,M2018-11-04D,Race(4),,
5,2,2,2,6,3,4,5,12,4,8,3,15,9,14,10,33,11,11,3.0,M2018-11-04D,Race(4),,
6,0,0,3,3,0,8,1,9,0,0,2,2,0,8,6,14,10,10,0.0,M2018-11-04D,Race(4),,
7,10,5,12,27,6,8,2,16,8,6,2,16,24,19,16,59,5,5,0.0,M2018-11-04D,Race(4),,
8,3,0,0,3,0,0,1,1,0,0,0,0,3,0,1,4,17,17,0.0,M2018-11-04D,Race(4),,
9,0,0,3,3,0,0,0,0,0,0,0,0,0,0,3,3,31,31,0.0,M2018-11-04D,Race(4),,
10,3,8,5,16,3,3,8,14,4,6,8,18,10,17,21,48,5,5,0.0,M2018-11-04D,Race(4),,
11,7,3,0,10,9,3,3,15,1,4,5,10,17,10,8,35,3.6,3.6,0.0,M2018-11-04D,Race(4),,
12,0,2,0,2,0,0,0,0,0,0,0,0,0,2,0,2,21,21,2.0,M2018-11-04D,Race(4),,
13,0,0,0,0,0,0,0,0,0,0,0,0,0,0,0,0,126,126,0.0,M2018-11-04D,Race(4),,
1,0,0,0,0,3,0,0,3,3,0,2,5,6,0,2,8,14,13,0.0,M2018-11-04D,Race(5),,
2,0,0,0,0,0,8,0,8,0,3,0,3,0,11,0,11,21,19,0.0,M2018-11-04D,Race(5),,
3,2,0,0,2,0,0,0,0,0,0,0,0,2,0,0,2,34,34,0.0,M2018-11-04D,Race(5),,
4,2,2,5,9,1,7,4,12,3,5,3,11,6,14,12,32,15,15,0.0,M2018-11-04D,Race(5),,
5,16,7,4,27,13,1,4,18,14,1,6,21,43,9,14,66,2.65,2.7,2.0,M2018-11-04D,Race(5),,
6,0,0,0,0,0,0,0,0,0,1,0,1,0,1,0,1,18,17,0.0,M2018-11-04D,Race(5),,
7,0,0,0,0,0,0,0,0,0,0,0,0,0,0,0,0,71,61,0.0,M2018-11-04D,Race(5),,
8,2,3,7,12,1,4,2,7,0,5,3,8,3,12,12,27,11,12,3.0,M2018-11-04D,Race(5),,
9,0,0,2,2,8,2,2,12,1,4,2,7,9,6,6,21,16,17,0.0,M2018-11-04D,Race(5),,
10,0,0,0,0,2,1,2,5,3,0,2,5,5,1,4,10,31,26,0.0,M2018-11-04D,Race(5),,
11,0,0,3,3,0,0,0,0,0,0,0,0,0,0,3,3,23,21,0.0,M2018-11-04D,Race(5),,
12,0,2,0,2,0,0,1,1,0,0,1,1,0,2,2,4,13,11,1.0,M2018-11-04D,Race(5),,
13,5,14,0,19,2,7,7,16,2,7,5,14,9,28,12,49,4.2,4,0.0,M2018-11-04D,Race(5),,
14,3,2,9,14,0,0,8,8,0,0,2,2,3,2,19,24,13,17,0.0,M2018-11-04D,Race(5),,
1,3,14,5,22,13,4,1,18,11,4,3,18,27,22,9,58,3.8,3.8,0.0,M2018-11-04D,Race(6),,
2,7,8,5,20,0,4,5,9,3,2,2,7,10,14,12,36,7.5,7.5,3.0,M2018-11-04D,Race(6),,
3,0,2,3,5,0,8,3,11,1,1,6,8,1,11,12,24,10,10,0.0,M2018-11-04D,Race(6),,
4,0,0,0,0,1,0,8,9,0,1,0,1,1,1,8,10,12,13,2.0,M2018-11-04D,Race(6),,
5,0,0,2,2,0,0,0,0,0,0,3,3,0,0,5,5,12,12,0.0,M2018-11-04D,Race(6),,
6,6,3,4,13,2,5,6,13,4,8,6,18,12,16,16,44,8,8,0.0,M2018-11-04D,Race(6),,
7,0,0,0,0,8,0,0,8,0,0,0,0,8,0,0,8,41,41,0.0,M2018-11-04D,Race(6),,
8,0,0,0,0,0,0,0,0,0,0,0,0,0,0,0,0,101,101,0.0,M2018-11-04D,Race(6),,
9,0,0,0,0,0,0,0,0,0,0,0,0,0,0,0,0,34,34,0.0,M2018-11-04D,Race(6),,
10,14,0,11,25,6,9,7,22,7,10,6,23,27,19,24,70,2.9,2.9,1.0,M2018-11-04D,Race(6),,
11,0,3,0,3,0,0,0,0,0,0,0,0,0,3,0,3,15,15,0.0,M2018-11-04D,Race(6),,
12,0,0,0,0,0,0,0,0,0,0,0,0,0,0,0,0,101,101,0.0,M2018-11-04D,Race(6),,
13,0,0,0,0,0,0,0,0,0,0,0,0,0,0,0,0,34,34,0.0,M2018-11-04D,Race(6),,
1,0,11,9,20,4,8,7,19,4,13,6,23,8,32,22,62,5,5,0.0,M2018-11-04D,Race(7),,
2,3,9,9,21,10,4,6,20,3,6,9,18,16,19,24,59,7.5,7.5,0.0,M2018-11-04D,Race(7),,
3,0,0,0,0,0,8,0,8,0,0,0,0,0,8,0,8,11,11,1.0,M2018-11-04D,Race(7),,
4,0,0,5,5,0,4,4,8,0,2,3,5,0,6,12,18,10,10,0.0,M2018-11-04D,Race(7),,
5,2,5,5,12,0,1,3,4,1,1,4,6,3,7,12,22,7.5,7.5,3.0,M2018-11-04D,Race(7),,
6,0,0,0,0,0,0,0,0,0,0,0,0,0,0,0,0,41,41,0.0,M2018-11-04D,Race(7),,
7,2,0,0,2,0,0,0,0,0,0,0,0,2,0,0,2,41,41,0.0,M2018-11-04D,Race(7),,
8,23,5,2,30,16,5,2,23,18,4,4,26,57,14,8,79,1.8,1.8,2.0,M2018-11-04D,Race(7),,
9,0,0,0,0,0,0,8,8,0,0,0,0,0,0,8,8,26,26,0.0,M2018-11-04D,Race(7),,
1,0,0,3,3,8,0,0,8,1,0,0,1,9,0,3,12,12,12,3.0,M2018-11-04D,Race(8),,
2,9,2,0,11,2,3,12,17,5,3,10,18,16,8,22,46,5,5,0.0,M2018-11-04D,Race(8),,
3,11,5,2,18,9,7,5,21,10,5,7,22,30,17,14,61,5,5,0.0,M2018-11-04D,Race(8),,
4,0,0,3,3,1,0,0,1,0,0,1,1,1,0,4,5,12,12,0.0,M2018-11-04D,Race(8),,
5,0,0,0,0,0,0,0,0,0,0,0,0,0,0,0,0,21,21,0.0,M2018-11-04D,Race(8),,
6,5,5,7,17,3,4,4,11,2,6,1,9,10,15,12,37,12,12,0.0,M2018-11-04D,Race(8),,
7,3,10,10,23,2,6,1,9,4,11,2,17,9,27,13,49,5,5,2.0,M2018-11-04D,Race(8),,
8,0,0,0,0,1,1,0,2,2,1,0,3,3,2,0,5,8,8,0.0,M2018-11-04D,Race(8),,
9,0,0,2,2,1,8,0,9,1,0,1,2,2,8,3,13,12,12,0.0,M2018-11-04D,Race(8),,
10,0,2,3,5,0,0,8,8,0,0,2,2,0,2,13,15,26,26,1.0,M2018-11-04D,Race(8),,
11,2,3,0,5,3,1,0,4,1,0,1,2,6,4,1,11,15,15,0.0,M2018-11-04D,Race(8),,
12,0,0,0,0,0,0,0,0,0,0,1,1,0,0,1,1,81,81,0.0,M2018-11-04D,Race(8),,
13,0,3,0,3,0,0,0,0,0,0,0,0,0,3,0,3,15,15,0.0,M2018-11-04D,Race(8),,
1,0,0,2,2,0,0,0,0,0,0,0,0,0,0,2,2,34,34,0.0,M2018-11-04D,Race(9),,
2,2,8,0,10,4,1,7,12,4,3,2,9,10,12,9,31,8,8,3.0,M2018-11-04D,Race(9),,
3,0,0,0,0,1,0,0,1,0,1,0,1,1,1,0,2,12,12,0.0,M2018-11-04D,Race(9),,
4,4,3,0,7,1,8,5,14,6,6,3,15,11,17,8,36,8,8,0.0,M2018-11-04D,Race(9),,
5,0,3,0,3,0,0,0,0,0,0,0,0,0,3,0,3,31,34,0.0,M2018-11-04D,Race(9),,
6,5,2,8,15,7,7,1,15,7,7,2,16,19,16,11,46,12,12,0.0,M2018-11-04D,Race(9),,
7,8,6,3,17,3,2,4,9,3,3,9,15,14,11,16,41,5.5,5.5,0.0,M2018-11-04D,Race(9),,
8,3,2,3,8,0,7,0,7,1,1,1,3,4,10,4,18,26,26,0.0,M2018-11-04D,Race(9),,
9,5,3,11,19,4,2,8,14,2,0,4,6,11,5,23,39,5,5,0.0,M2018-11-04D,Race(9),,
10,0,0,0,0,0,0,0,0,0,0,0,0,0,0,0,0,21,18,0.0,M2018-11-04D,Race(9),,
11,0,0,0,0,0,0,0,0,0,0,0,0,0,0,0,0,34,34,1.0,M2018-11-04D,Race(9),,
12,0,0,3,3,0,8,0,8,0,1,0,1,0,9,3,12,7.5,7.5,0.0,M2018-11-04D,Race(9),,
13,3,3,0,6,2,1,5,8,2,4,5,11,7,8,10,25,7,7,2.0,M2018-11-04D,Race(9),,
14,0,0,0,0,8,0,0,8,1,0,0,1,9,0,0,9,26,26,0.0,M2018-11-04D,Race(9),,
1,18,8,2,28,17,8,4,29,10,9,3,22,45,25,9,79,2.7,2.7,0.0,M2018-11-07D,Race(1),,
2,5,12,0,17,5,16,7,28,5,8,8,21,15,36,15,66,5,5,0.0,M2018-11-07D,Race(1),,
3,0,0,0,0,1,0,0,1,1,0,1,2,2,0,1,3,26,26,0.0,M2018-11-07D,Race(1),,
4,0,2,0,2,0,2,3,5,0,2,2,4,0,6,5,11,15,15,3.0,M2018-11-07D,Race(1),,
5,3,0,0,3,2,1,3,6,3,0,4,7,8,1,7,16,17,17,2.0,M2018-11-07D,Race(1),,
6,2,0,0,2,0,0,1,1,1,0,2,3,3,0,3,6,8,8,1.0,M2018-11-07D,Race(1),,
7,2,3,11,16,2,1,1,4,2,4,3,9,6,8,15,29,8,8,0.0,M2018-11-07D,Race(1),,
8,0,0,0,0,0,0,0,0,0,0,0,0,0,0,0,0,21,21,0.0,M2018-11-07D,Race(1),,
9,0,3,17,20,3,2,11,16,3,3,3,9,6,8,31,45,0,7,0.0,M2018-11-07D,Race(1),,
10,0,0,0,0,0,0,0,0,0,0,0,0,0,0,0,0,21,21,0.0,M2018-11-07D,Race(1),,
11,0,0,0,0,0,0,0,0,1,0,0,1,1,0,0,1,14,14,0.0,M2018-11-07D,Race(1),,
12,0,2,0,2,0,0,0,0,0,0,0,0,0,2,0,2,34,34,0.0,M2018-11-07D,Race(1),,
1,2,3,8,13,1,2,6,9,3,3,6,12,6,8,20,34,6.5,6,0.0,M2018-11-07D,Race(2),,
2,12,3,7,22,16,5,4,25,8,8,4,20,36,16,15,67,4.4,4.4,0.0,M2018-11-07D,Race(2),,
3,2,13,0,15,2,3,2,7,2,4,2,8,6,20,4,30,4.8,4.8,0.0,M2018-11-07D,Race(2),,
4,0,0,3,3,1,1,0,2,1,1,0,2,2,2,3,7,21,21,2.0,M2018-11-07D,Race(2),,
5,0,2,0,2,0,0,1,1,1,0,0,1,1,2,1,4,14,14,1.0,M2018-11-07D,Race(2),,
6,0,0,2,2,1,2,0,3,2,3,1,6,3,5,3,11,21,21,0.0,M2018-11-07D,Race(2),,
7,9,3,2,14,7,14,4,25,8,2,6,16,24,19,12,55,4,4,3.0,M2018-11-07D,Race(2),,
8,0,6,6,12,2,3,12,17,0,5,4,9,2,14,22,38,7.5,7,0.0,M2018-11-07D,Race(2),,
9,0,0,0,0,0,0,0,0,0,0,0,0,0,0,0,0,15,15,0.0,M2018-11-07D,Race(2),,
10,5,0,0,5,0,0,1,1,0,0,2,2,5,0,3,8,26,26,0.0,M2018-11-07D,Race(2),,
11,0,0,2,2,0,0,0,0,0,0,0,0,0,0,2,2,41,41,0.0,M2018-11-07D,Race(2),,
12,0,0,0,0,0,0,0,0,1,0,1,2,1,0,1,2,34,34,0.0,M2018-11-07D,Race(2),,
1,3,9,5,17,3,4,9,16,4,2,4,10,10,15,18,43,15,15,3.0,M2018-11-07D,Race(3),,
2,0,0,0,0,2,1,1,4,2,0,4,6,4,1,5,10,11,11,0.0,M2018-11-07D,Race(3),,
3,0,2,0,2,1,0,0,1,0,0,0,0,1,2,0,3,16,16,0.0,M2018-11-07D,Race(3),,
4,3,5,5,13,2,4,4,10,2,6,5,13,7,15,14,36,15,15,0.0,M2018-11-07D,Race(3),,
5,10,5,5,20,2,2,4,8,3,5,5,13,15,12,14,41,4,4,0.0,M2018-11-07D,Race(3),,
6,0,0,0,0,0,0,0,0,0,0,0,0,0,0,0,0,34,34,0.0,M2018-11-07D,Race(3),,
7,3,0,10,13,1,1,3,5,1,1,0,2,5,2,13,20,5,5,2.0,M2018-11-07D,Race(3),,
8,0,2,2,4,0,0,0,0,0,0,0,0,0,2,2,4,26,26,0.0,M2018-11-07D,Race(3),,
9,4,4,0,8,6,12,4,22,5,7,5,17,15,23,9,47,7.5,7.5,0.0,M2018-11-07D,Race(3),,
10,7,3,3,13,13,6,5,24,9,5,2,16,29,14,10,53,3.6,3.6,0.0,M2018-11-07D,Race(3),,
11,0,0,0,0,0,0,0,0,0,0,0,0,0,0,0,0,41,41,0.0,M2018-11-07D,Race(3),,
12,0,0,0,0,0,0,0,0,0,0,1,1,0,0,1,1,18,17,1.0,M2018-11-07D,Race(3),,
1,6,7,6,19,6,14,1,21,4,8,3,15,16,29,10,55,5,5,0.0,M2018-11-07D,Race(4),,
2,0,0,0,0,0,0,0,0,0,0,0,0,0,0,0,0,31,31,0.0,M2018-11-07D,Race(4),,
3,7,5,3,15,17,3,6,26,12,4,4,20,36,12,13,61,4.2,4.2,0.0,M2018-11-07D,Race(4),,
4,8,8,3,19,4,5,12,21,6,7,5,18,18,20,20,58,5,5,1.0,M2018-11-07D,Race(4),,
5,5,0,2,7,0,0,0,0,0,1,0,1,5,1,2,8,21,21,0.0,M2018-11-07D,Race(4),,
6,2,5,0,7,0,0,3,3,1,1,4,6,3,6,7,16,11,11,2.0,M2018-11-07D,Race(4),,
7,0,0,0,0,0,0,0,0,0,0,0,0,0,0,0,0,51,51,0.0,M2018-11-07D,Race(4),,
8,0,3,3,6,0,3,1,4,1,2,1,4,1,8,5,14,8,8,0.0,M2018-11-07D,Race(4),,
9,0,2,9,11,1,2,3,6,0,2,3,5,1,6,15,22,7,7,3.0,M2018-11-07D,Race(4),,
10,2,0,2,4,2,2,3,7,2,0,5,7,6,2,10,18,8,8,0.0,M2018-11-07D,Race(4),,
11,0,0,0,0,0,1,1,2,0,1,1,2,0,2,2,4,14,14,0.0,M2018-11-07D,Race(4),,
12,0,0,2,2,0,0,0,0,0,0,0,0,0,0,2,2,71,67,0.0,M2018-11-07D,Race(4),,
1,0,8,0,8,4,16,4,24,7,7,4,18,11,31,8,50,7,7,0.0,M2018-11-07D,Race(5),,
2,0,0,3,3,0,0,0,0,0,0,0,0,0,0,3,3,18,18,0.0,M2018-11-07D,Race(5),,
3,0,0,0,0,0,0,0,0,0,0,0,0,0,0,0,0,26,26,3.0,M2018-11-07D,Race(5),,
4,0,5,2,7,0,2,0,2,0,1,1,2,0,8,3,11,7,7,0.0,M2018-11-07D,Race(5),,
5,6,7,5,18,1,3,3,7,0,4,2,6,7,14,10,31,7,7,0.0,M2018-11-07D,Race(5),,
6,0,0,9,9,0,2,4,6,0,1,2,3,0,3,15,18,6,6,0.0,M2018-11-07D,Race(5),,
7,0,0,3,3,0,0,1,1,1,0,1,2,1,0,5,6,18,18,2.0,M2018-11-07D,Race(5),,
8,0,0,0,0,0,0,0,0,0,0,0,0,0,0,0,0,26,26,0.0,M2018-11-07D,Race(5),,
9,0,7,5,12,2,2,13,17,2,4,6,12,4,13,24,41,12,12,0.0,M2018-11-07D,Race(5),,
10,24,0,3,27,23,4,2,29,16,7,2,25,63,11,7,81,2.8,2.8,1.0,M2018-11-07D,Race(5),,
11,0,3,0,3,0,1,3,4,0,1,7,8,0,5,10,15,17,17,0.0,M2018-11-07D,Race(5),,
12,0,0,0,0,0,0,0,0,0,0,0,0,0,0,0,0,26,26,0.0,M2018-11-07D,Race(5),,
1,0,0,2,2,0,0,0,0,0,0,0,0,0,0,2,2,26,26,0.0,M2018-11-07D,Race(6),,
2,0,0,2,2,1,0,0,1,0,0,0,0,1,0,2,3,15,15,0.0,M2018-11-07D,Race(6),,
3,0,3,2,5,0,5,14,19,3,9,6,18,3,17,22,42,10,10,3.0,M2018-11-07D,Race(6),,
4,2,18,3,23,5,14,4,23,4,8,9,21,11,40,16,67,7,7,1.0,M2018-11-07D,Race(6),,
5,0,3,2,5,0,0,0,0,1,0,0,1,1,3,2,6,18,18,0.0,M2018-11-07D,Race(6),,
6,4,0,0,4,0,0,1,1,0,1,0,1,4,1,1,6,10,10,0.0,M2018-11-07D,Race(6),,
7,0,2,0,2,1,1,0,2,0,0,0,0,1,3,0,4,21,21,0.0,M2018-11-07D,Race(6),,
8,16,4,2,22,21,4,3,28,16,3,5,24,53,11,10,74,2.6,2.6,0.0,M2018-11-07D,Race(6),,
9,3,0,6,9,2,2,5,9,2,2,4,8,7,4,15,26,7,7,0.0,M2018-11-07D,Race(6),,
10,5,0,11,16,0,1,1,2,0,1,1,2,5,2,13,20,11,11,2.0,M2018-11-07D,Race(6),,
11,0,0,0,0,0,1,1,2,0,2,0,2,0,3,1,4,16,16,0.0,M2018-11-07D,Race(6),,
12,0,0,0,0,0,2,1,3,0,0,1,1,0,2,2,4,12,12,0.0,M2018-11-07D,Race(6),,
1,2,5,3,10,3,4,3,10,1,7,4,12,6,16,10,32,11,11,0.0,M2018-11-07D,Race(7),,
2,5,16,2,23,21,4,3,28,18,6,1,25,44,26,6,76,3.3,3.3,0.0,M2018-11-07D,Race(7),,
3,2,0,0,2,0,1,1,2,0,0,3,3,2,1,4,7,34,34,3.0,M2018-11-07D,Race(7),,
4,0,0,8,8,0,1,1,2,0,0,0,0,0,1,9,10,15,15,0.0,M2018-11-07D,Race(7),,
5,0,0,0,0,0,0,0,0,0,1,0,1,0,1,0,1,34,34,0.0,M2018-11-07D,Race(7),,
6,0,0,5,5,1,0,14,15,1,1,10,12,2,1,29,32,8,8,0.0,M2018-11-07D,Race(7),,
7,0,0,2,2,0,0,0,0,0,0,0,0,0,0,2,2,71,67,0.0,M2018-11-07D,Race(7),,
8,0,0,6,6,1,2,0,3,0,1,2,3,1,3,8,12,8,8,0.0,M2018-11-07D,Race(7),,
9,0,0,4,4,0,1,2,3,0,1,1,2,0,2,7,9,21,21,1.0,M2018-11-07D,Race(7),,
10,0,0,0,0,0,0,0,0,0,0,0,0,0,0,0,0,71,67,0.0,M2018-11-07D,Race(7),,
11,21,7,0,28,4,17,5,26,6,9,4,19,31,33,9,73,2.4,2.4,2.0,M2018-11-07D,Race(7),,
12,0,2,0,2,0,0,1,1,0,0,1,1,0,2,2,4,26,26,0.0,M2018-11-07D,Race(7),,
1,4,2,8,14,13,5,9,27,6,6,8,20,23,13,25,61,6,6,0.0,M2018-11-07D,Race(8),,
2,3,4,0,7,2,3,0,5,0,1,2,3,5,8,2,15,11,11,1.0,M2018-11-07D,Race(8),,
3,0,2,5,7,6,1,12,19,8,2,5,15,14,5,22,41,8,8,3.0,M2018-11-07D,Race(8),,
4,0,3,2,5,1,3,2,6,2,3,2,7,3,9,6,18,12,12,0.0,M2018-11-07D,Race(8),,
5,2,0,0,2,1,1,0,2,1,3,0,4,4,4,0,8,10,10,0.0,M2018-11-07D,Race(8),,
6,0,3,2,5,2,1,1,4,0,1,0,1,2,5,3,10,21,21,2.0,M2018-11-07D,Race(8),,
7,0,0,3,3,0,0,2,2,0,0,0,0,0,0,5,5,7,7,0.0,M2018-11-07D,Race(8),,
8,13,8,2,23,5,15,3,23,8,7,5,20,26,30,10,66,3,3,0.0,M2018-11-07D,Race(8),,
9,0,0,0,0,0,0,1,1,0,0,1,1,0,0,2,2,16,16,0.0,M2018-11-07D,Race(8),,
10,0,0,0,0,0,0,0,0,0,0,0,0,0,0,0,0,34,34,0.0,M2018-11-07D,Race(8),,
11,8,5,5,18,0,1,0,1,0,3,1,4,8,9,6,23,13,13,0.0,M2018-11-07D,Race(8),,
12,0,3,3,6,0,0,0,0,1,0,2,3,1,3,5,9,21,21,0.0,M2018-11-07D,Race(8),,
1,4,10,12,26,6,4,15,25,7,2,7,16,17,16,34,67,4.4,4.4,0.0,M2018-11-10D,Race(1),,
2,0,2,6,8,1,2,3,6,1,1,6,8,2,5,15,22,13,13,2.0,M2018-11-10D,Race(1),,
3,9,11,7,27,8,14,4,26,5,13,5,23,22,38,16,76,3.7,3.7,3.0,M2018-11-10D,Race(1),,
4,14,2,5,21,15,9,6,30,13,9,3,25,42,20,14,76,2.7,2.7,1.0,M2018-11-10D,Race(1),,
5,0,0,0,0,0,0,0,0,0,1,1,2,0,1,1,2,34,34,0.0,M2018-11-10D,Race(1),,
6,0,0,0,0,0,0,0,0,0,0,1,1,0,0,1,1,12,12,0.0,M2018-11-10D,Race(1),,
7,3,0,0,3,0,1,1,2,0,0,2,2,3,1,3,7,9,9,0.0,M2018-11-10D,Race(1),,
8,0,5,0,5,0,0,1,1,0,0,1,1,0,5,2,7,10,10,0.0,M2018-11-10D,Race(1),,
9,0,0,0,0,0,0,0,0,0,0,0,0,0,0,0,0,34,34,0.0,M2018-11-10D,Race(1),,
1,0,5,13,18,2,2,2,6,0,3,2,5,2,10,17,29,7,7,3.0,M2018-11-10D,Race(10),,
2,0,0,0,0,0,0,2,2,0,0,2,2,0,0,4,4,26,26,0.0,M2018-11-10D,Race(10),,
3,12,0,8,20,9,3,10,22,9,1,5,15,30,4,23,57,5.5,5.5,0.0,M2018-11-10D,Race(10),,
4,0,0,2,2,1,0,0,1,1,1,0,2,2,1,2,5,18,18,0.0,M2018-11-10D,Race(10),,
5,0,0,0,0,0,0,0,0,0,0,0,0,0,0,0,0,26,26,0.0,M2018-11-10D,Race(10),,
6,2,2,0,4,0,1,1,2,0,1,2,3,2,4,3,9,12,12,0.0,M2018-11-10D,Race(10),,
7,0,0,0,0,0,3,1,4,1,6,2,9,1,9,3,13,9,9,0.0,M2018-11-10D,Race(10),,
8,0,0,2,2,0,0,0,0,0,1,0,1,0,1,2,3,15,15,0.0,M2018-11-10D,Race(10),,
9,0,0,0,0,0,0,0,0,0,0,1,1,0,0,1,1,67,67,0.0,M2018-11-10D,Race(10),,
10,3,13,0,16,2,18,6,26,4,7,9,20,9,38,15,62,6,6,0.0,M2018-11-10D,Race(10),,
11,13,8,2,23,16,3,7,26,11,6,3,20,40,17,12,69,3,3,0.0,M2018-11-10D,Race(10),,
12,0,0,0,0,0,0,0,0,0,0,0,0,0,0,0,0,67,67,0.0,M2018-11-10D,Race(10),,
13,0,0,3,3,0,0,1,1,0,0,0,0,0,0,4,4,21,21,2.0,M2018-11-10D,Race(10),,
14,0,2,0,2,0,0,0,0,0,0,0,0,0,2,0,2,31,31,1.0,M2018-11-10D,Race(10),,
1,11,12,2,25,24,3,2,29,21,1,1,23,56,16,5,77,2.75,2.75,3.0,M2018-11-10D,Race(2),,
2,2,6,8,16,1,5,14,20,1,2,5,8,4,13,27,44,8,8,0.0,M2018-11-10D,Race(2),,
3,2,0,2,4,0,0,1,1,1,1,3,5,3,1,6,10,11,11,0.0,M2018-11-10D,Race(2),,
4,11,5,7,23,4,16,5,25,2,8,6,16,17,29,18,64,4,4,1.0,M2018-11-10D,Race(2),,
5,0,0,0,0,0,0,0,0,0,1,0,1,0,1,0,1,81,81,0.0,M2018-11-10D,Race(2),,
6,0,0,0,0,0,0,0,0,0,0,0,0,0,0,0,0,26,26,0.0,M2018-11-10D,Race(2),,
7,0,3,6,9,0,2,1,3,0,1,0,1,0,6,7,13,8.5,8.5,0.0,M2018-11-10D,Race(2),,
8,2,4,2,8,1,2,5,8,0,3,5,8,3,9,12,24,10,10,0.0,M2018-11-10D,Race(2),,
9,0,0,0,0,0,0,0,0,0,1,0,1,0,1,0,1,41,41,0.0,M2018-11-10D,Race(2),,
10,0,0,0,0,0,0,0,0,0,0,0,0,0,0,0,0,41,41,0.0,M2018-11-10D,Race(2),,
11,0,0,0,0,0,0,0,0,0,0,2,2,0,0,2,2,41,41,0.0,M2018-11-10D,Race(2),,
12,0,0,3,3,0,0,1,1,0,0,2,2,0,0,6,6,21,21,0.0,M2018-11-10D,Race(2),,
13,0,0,0,0,0,0,0,0,0,0,0,0,0,0,0,0,31,31,0.0,M2018-11-10D,Race(2),,
14,2,0,0,2,0,2,1,3,1,8,2,11,3,10,3,16,12,12,2.0,M2018-11-10D,Race(2),,
1,2,0,0,2,0,0,0,0,1,0,0,1,3,0,0,3,101,101,0.0,M2018-11-10D,Race(3),,
2,6,8,2,16,1,4,2,7,0,6,3,9,7,18,7,32,3.9,3.9,3.0,M2018-11-10D,Race(3),,
3,2,3,2,7,1,1,0,2,1,1,2,4,4,5,4,13,16,16,0.0,M2018-11-10D,Race(3),,
4,2,4,6,12,3,3,6,12,5,2,4,11,10,9,16,35,4.4,4.4,1.0,M2018-11-10D,Race(3),,
5,2,3,2,7,13,5,3,21,5,4,4,13,20,12,9,41,14,14,2.0,M2018-11-10D,Race(3),,
6,3,0,0,3,3,2,9,14,0,3,1,4,6,5,10,21,9,9,0.0,M2018-11-10D,Race(3),,
7,2,5,13,20,0,2,2,4,1,2,3,6,3,9,18,30,9,9,0.0,M2018-11-10D,Race(3),,
8,3,0,0,3,1,2,3,6,2,5,5,12,6,7,8,21,13,13,0.0,M2018-11-10D,Race(3),,
9,8,7,2,17,6,11,5,22,8,3,3,14,22,21,10,53,3.6,3.6,0.0,M2018-11-10D,Race(3),,
10,0,0,0,0,0,0,0,0,0,0,0,0,0,0,0,0,81,81,0.0,M2018-11-10D,Race(3),,
11,0,0,3,3,2,0,0,2,3,0,0,3,5,0,3,8,13,13,0.0,M2018-11-10D,Race(3),,
12,0,0,0,0,0,0,0,0,0,0,1,1,0,0,1,1,34,34,0.0,M2018-11-10D,Race(3),,
1,0,0,0,0,0,0,0,0,0,0,0,0,0,0,0,0,101,101,0.0,M2018-11-10D,Race(4),,
2,0,0,0,0,0,0,0,0,0,0,0,0,0,0,0,0,81,81,0.0,M2018-11-10D,Race(4),,
3,0,0,0,0,1,2,2,5,4,0,0,4,5,2,2,9,18,18,0.0,M2018-11-10D,Race(4),,
4,0,0,0,0,0,0,0,0,0,0,0,0,0,0,0,0,51,51,3.0,M2018-11-10D,Race(4),,
5,2,5,0,7,1,1,0,2,2,2,1,5,5,8,1,14,8,8,0.0,M2018-11-10D,Race(4),,
6,0,0,0,0,0,2,1,3,0,5,2,7,0,7,3,10,18,18,2.0,M2018-11-10D,Race(4),,
7,6,0,3,9,1,3,2,6,4,5,2,11,11,8,7,26,4.8,4.8,0.0,M2018-11-10D,Race(4),,
8,7,16,5,28,7,13,6,26,6,7,5,18,20,36,16,72,3.3,3.3,0.0,M2018-11-10D,Race(4),,
9,8,7,7,22,15,4,7,26,9,4,10,23,32,15,24,71,7,7,0.0,M2018-11-10D,Race(4),,
10,0,0,0,0,0,2,3,5,0,3,2,5,0,5,5,10,16,16,0.0,M2018-11-10D,Race(4),,
11,0,2,4,6,1,1,1,3,0,0,1,1,1,3,6,10,13,13,0.0,M2018-11-10D,Race(4),,
12,2,0,3,5,0,1,0,1,0,0,1,1,2,1,4,7,19,19,0.0,M2018-11-10D,Race(4),,
13,0,0,0,0,0,0,0,0,0,0,0,0,0,0,0,0,51,51,0.0,M2018-11-10D,Race(4),,
14,5,0,8,13,4,1,9,14,1,0,2,3,10,1,19,30,6,6,1.0,M2018-11-10D,Race(4),,
1,0,4,4,8,0,1,1,2,0,0,1,1,0,5,6,11,10,10,3.0,M2018-11-10D,Race(5),,
2,3,2,0,5,0,2,12,14,2,1,3,6,5,5,15,25,12,12,0.0,M2018-11-10D,Race(5),,
3,0,0,3,3,0,2,2,4,0,2,1,3,0,4,6,10,15,15,0.0,M2018-11-10D,Race(5),,
4,17,5,0,22,26,2,1,29,16,6,2,24,59,13,3,75,2.8,2.8,1.0,M2018-11-10D,Race(5),,
5,3,5,12,20,1,3,4,8,1,9,4,14,5,17,20,42,6,6,2.0,M2018-11-10D,Race(5),,
6,4,12,5,21,1,15,6,22,5,6,9,20,10,33,20,63,7,7,0.0,M2018-11-10D,Race(5),,
7,0,0,0,0,0,0,0,0,0,0,0,0,0,0,0,0,18,18,0.0,M2018-11-10D,Race(5),,
8,0,2,3,5,0,3,2,5,0,1,3,4,0,6,8,14,18,18,0.0,M2018-11-10D,Race(5),,
9,0,0,0,0,0,1,1,2,0,0,1,1,0,1,2,3,14,14,0.0,M2018-11-10D,Race(5),,
10,0,0,0,0,0,0,0,0,0,0,0,0,0,0,0,0,51,51,0.0,M2018-11-10D,Race(5),,
11,0,0,0,0,0,0,0,0,0,0,0,0,0,0,0,0,51,51,0.0,M2018-11-10D,Race(5),,
12,3,0,3,6,1,1,1,3,1,1,2,4,5,2,6,13,8,8,0.0,M2018-11-10D,Race(5),,
13,0,0,0,0,0,0,0,0,0,0,0,0,0,0,0,0,101,101,0.0,M2018-11-10D,Race(5),,
14,0,0,0,0,1,0,0,1,1,0,0,1,2,0,0,2,21,21,0.0,M2018-11-10D,Race(5),,
1,0,0,5,5,0,1,1,2,0,1,1,2,0,2,7,9,21,21,0.0,M2018-11-10D,Race(6),,
2,4,11,5,20,2,2,3,7,3,2,1,6,9,15,9,33,10,10,0.0,M2018-11-10D,Race(6),,
3,3,8,5,16,11,6,3,20,4,8,6,18,18,22,14,54,8,8,3.0,M2018-11-10D,Race(6),,
4,0,2,2,4,0,2,1,3,1,4,1,6,1,8,4,13,19,19,0.0,M2018-11-10D,Race(6),,
5,3,2,3,8,4,1,2,7,6,4,4,14,13,7,9,29,9,9,0.0,M2018-11-10D,Race(6),,
6,0,0,0,0,0,0,0,0,0,0,0,0,0,0,0,0,31,31,0.0,M2018-11-10D,Race(6),,
7,10,5,5,20,4,9,4,17,3,4,4,11,17,18,13,48,5,5,1.0,M2018-11-10D,Race(6),,
8,3,2,3,8,2,6,12,20,2,0,5,7,7,8,20,35,4.6,4.6,2.0,M2018-11-10D,Race(6),,
9,0,0,0,0,0,0,2,2,0,0,1,1,0,0,3,3,11,11,0.0,M2018-11-10D,Race(6),,
10,0,0,0,0,0,2,0,2,1,2,2,5,1,4,2,7,18,18,0.0,M2018-11-10D,Race(6),,
11,0,0,0,0,2,0,1,3,3,0,0,3,5,0,1,6,21,21,0.0,M2018-11-10D,Race(6),,
12,0,0,0,0,1,0,0,1,2,0,0,2,3,0,0,3,13,13,0.0,M2018-11-10D,Race(6),,
13,0,0,2,2,0,0,0,0,0,0,1,1,0,0,3,3,18,18,0.0,M2018-11-10D,Race(6),,
14,7,0,0,7,4,1,1,6,1,1,0,2,12,2,1,15,12,12,0.0,M2018-11-10D,Race(6),,
1,0,0,0,0,0,0,0,0,0,0,0,0,0,0,0,0,101,101,0.0,M2018-11-10D,Race(7),,
2,0,0,2,2,0,0,0,0,0,0,0,0,0,0,2,2,34,34,0.0,M2018-11-10D,Race(7),,
3,0,3,0,3,0,3,2,5,0,3,4,7,0,9,6,15,8,8,0.0,M2018-11-10D,Race(7),,
4,8,3,7,18,5,4,14,23,5,5,6,16,18,12,27,57,5,5,0.0,M2018-11-10D,Race(7),,
5,5,0,0,5,0,1,1,2,0,1,2,3,5,2,3,10,10,10,1.0,M2018-11-10D,Race(7),,
6,0,0,0,0,0,0,0,0,0,0,0,0,0,0,0,0,81,81,0.0,M2018-11-10D,Race(7),,
7,0,0,0,0,3,1,0,4,2,1,1,4,5,2,1,8,16,16,0.0,M2018-11-10D,Race(7),,
8,0,0,3,3,0,1,0,1,0,2,0,2,0,3,3,6,26,26,0.0,M2018-11-10D,Race(7),,
9,5,6,3,14,4,2,3,9,6,4,2,12,15,12,8,35,4,4,0.0,M2018-11-10D,Race(7),,
10,2,8,10,20,3,13,5,21,4,7,5,16,9,28,20,57,8,8,2.0,M2018-11-10D,Race(7),,
11,0,0,0,0,0,0,0,0,0,0,0,0,0,0,0,0,21,21,0.0,M2018-11-10D,Race(7),,
12,2,2,0,4,0,1,1,2,0,0,2,2,2,3,3,8,10,10,0.0,M2018-11-10D,Race(7),,
13,0,0,0,0,0,0,1,1,0,0,0,0,0,0,1,1,34,34,0.0,M2018-11-10D,Race(7),,
14,8,8,5,21,15,4,3,22,9,3,4,16,32,15,12,59,5,5,3.0,M2018-11-10D,Race(7),,
1,0,0,2,2,0,1,1,2,0,1,2,3,0,2,5,7,17,17,0.0,M2018-11-10D,Race(8),,
2,0,2,0,2,1,1,1,3,1,2,3,6,2,5,4,11,10,10,0.0,M2018-11-10D,Race(8),,
3,0,0,0,0,0,0,0,0,0,1,0,1,0,1,0,1,34,34,0.0,M2018-11-10D,Race(8),,
4,0,0,0,0,0,1,0,1,0,1,2,3,0,2,2,4,21,21,0.0,M2018-11-10D,Race(8),,
5,0,0,0,0,0,0,0,0,0,0,0,0,0,0,0,0,21,21,0.0,M2018-11-10D,Race(8),,
6,0,5,0,5,0,0,1,1,2,0,3,5,2,5,4,11,12,12,0.0,M2018-11-10D,Race(8),,
7,8,10,7,25,19,7,4,30,11,8,1,20,38,25,12,75,2.8,2.8,3.0,M2018-11-10D,Race(8),,
8,12,3,8,23,0,3,2,5,4,3,2,9,16,9,12,37,5,5,1.0,M2018-11-10D,Race(8),,
9,2,3,13,18,6,13,6,25,4,8,6,18,12,24,25,61,7,7,0.0,M2018-11-10D,Race(8),,
10,5,4,0,9,4,4,11,19,3,2,4,9,12,10,15,37,17,17,0.0,M2018-11-10D,Race(8),,
11,0,0,0,0,0,0,0,0,0,0,0,0,0,0,0,0,17,17,0.0,M2018-11-10D,Race(8),,
12,0,0,0,0,0,0,0,0,0,0,0,0,0,0,0,0,26,26,0.0,M2018-11-10D,Race(8),,
13,0,0,0,0,0,0,0,0,0,0,0,0,0,0,0,0,41,41,0.0,M2018-11-10D,Race(8),,
14,3,3,0,6,0,0,4,4,1,0,3,4,4,3,7,14,12,12,2.0,M2018-11-10D,Race(8),,
1,2,0,10,12,1,0,1,2,0,1,0,1,3,1,11,15,13,13,0.0,M2018-11-10D,Race(9),,
2,0,0,2,2,0,0,0,0,0,1,0,1,0,1,2,3,17,17,0.0,M2018-11-10D,Race(9),,
3,5,0,3,8,2,5,15,22,1,5,10,16,8,10,28,46,10,10,0.0,M2018-11-10D,Race(9),,
4,0,0,5,5,1,0,3,4,1,0,1,2,2,0,9,11,7,7,3.0,M2018-11-10D,Race(9),,
5,0,2,0,2,0,2,1,3,1,1,1,3,1,5,2,8,12,12,0.0,M2018-11-10D,Race(9),,
6,0,3,0,3,0,1,0,1,2,4,0,6,2,8,0,10,19,19,2.0,M2018-11-10D,Race(9),,
7,0,5,6,11,5,12,4,21,4,3,5,12,9,20,15,44,8,8,0.0,M2018-11-10D,Race(9),,
8,2,0,0,2,0,0,0,0,0,0,0,0,2,0,0,2,14,14,0.0,M2018-11-10D,Race(9),,
9,18,5,0,23,20,4,2,26,13,7,3,23,51,16,5,72,2.6,2.6,0.0,M2018-11-10D,Race(9),,
10,0,4,0,4,0,1,2,3,0,1,3,4,0,6,5,11,14,14,1.0,M2018-11-10D,Race(9),,
11,0,0,0,0,0,0,0,0,0,0,0,0,0,0,0,0,34,34,0.0,M2018-11-10D,Race(9),,
12,3,11,4,18,1,5,2,8,4,3,3,10,8,19,9,36,8,8,0.0,M2018-11-10D,Race(9),,
1,0,0,0,0,0,0,8,8,1,0,2,3,1,0,10,11,21,21,0.0,M2018-11-14D,Race(1),,
2,8,3,10,21,11,7,3,21,11,4,4,19,30,14,17,61,4,4,3.0,M2018-11-14D,Race(1),,
3,0,0,0,0,0,0,0,0,0,0,0,0,0,0,0,0,31,31,0.0,M2018-11-14D,Race(1),,
4,5,9,7,21,0,2,2,4,3,3,4,10,8,14,13,35,4.4,4.4,0.0,M2018-11-14D,Race(1),,
5,0,0,0,0,0,0,1,1,0,0,2,2,0,0,3,3,34,34,0.0,M2018-11-14D,Race(1),,
6,13,10,3,26,5,5,3,13,3,6,2,11,21,21,8,50,4,4,0.0,M2018-11-14D,Race(1),,
7,0,2,0,2,2,4,4,10,5,7,3,15,7,13,7,27,17,17,0.0,M2018-11-14D,Race(1),,
8,0,0,0,0,0,0,0,0,0,0,0,0,0,0,0,0,31,31,0.0,M2018-11-14D,Race(1),,
9,0,0,0,0,0,0,0,0,0,0,1,1,0,0,1,1,17,17,0.0,M2018-11-14D,Race(1),,
10,4,4,3,11,2,4,3,9,0,3,3,6,6,11,9,26,4.5,4.5,2.0,M2018-11-14D,Race(1),,
11,0,2,2,4,2,8,4,14,2,3,3,8,4,13,9,26,12,12,1.0,M2018-11-14D,Race(1),,
12,0,0,5,5,8,0,2,10,1,0,2,3,9,0,9,18,17,17,0.0,M2018-11-14D,Race(1),,
1,0,0,0,0,0,0,2,2,1,0,1,2,1,0,3,4,31,31,0.0,M2018-11-14D,Race(2),,
2,3,0,0,3,8,1,2,11,2,1,3,6,13,2,5,20,12,12,0.0,M2018-11-14D,Race(2),,
3,0,0,0,0,0,0,0,0,0,0,0,0,0,0,0,0,16,16,3.0,M2018-11-14D,Race(2),,
4,5,6,7,18,7,10,2,19,6,6,6,18,18,22,15,55,5,5,0.0,M2018-11-14D,Race(2),,
5,0,2,3,5,2,2,2,6,0,2,2,4,2,6,7,15,17,17,0.0,M2018-11-14D,Race(2),,
6,2,0,0,2,0,1,8,9,0,1,2,3,2,2,10,14,19,19,0.0,M2018-11-14D,Race(2),,
7,5,0,3,8,0,8,0,8,1,2,2,5,6,10,5,21,14,14,0.0,M2018-11-14D,Race(2),,
8,0,5,0,5,0,0,0,0,0,0,0,0,0,5,0,5,26,26,0.0,M2018-11-14D,Race(2),,
9,0,2,3,5,0,0,3,3,0,3,1,4,0,5,7,12,14,14,2.0,M2018-11-14D,Race(2),,
10,0,2,3,5,0,0,0,0,0,0,0,0,0,2,3,5,26,26,0.0,M2018-11-14D,Race(2),,
11,13,10,2,25,13,4,5,22,16,2,5,23,42,16,12,70,2.3,2.3,0.0,M2018-11-14D,Race(2),,
12,2,3,9,14,0,4,5,9,0,9,4,13,2,16,18,36,6.5,6,1.0,M2018-11-14D,Race(2),,
1,7,13,3,23,7,6,2,15,8,3,2,13,22,22,7,51,3.8,3.8,0.0,M2018-11-14D,Race(3),,
2,3,2,10,15,0,8,0,8,0,2,1,3,3,12,11,26,7.5,7,3.0,M2018-11-14D,Race(3),,
3,0,0,0,0,2,0,2,4,2,1,2,5,4,1,4,9,11,11,2.0,M2018-11-14D,Race(3),,
4,16,3,7,26,11,5,5,21,14,4,2,20,41,12,14,67,3.8,3.8,1.0,M2018-11-14D,Race(3),,
5,0,0,0,0,8,0,1,9,0,2,2,4,8,2,3,13,34,34,0.0,M2018-11-14D,Race(3),,
6,0,0,0,0,0,0,1,1,0,0,2,2,0,0,3,3,71,67,0.0,M2018-11-14D,Race(3),,
7,0,0,0,0,0,0,2,2,0,1,1,2,0,1,3,4,12,12,0.0,M2018-11-14D,Race(3),,
8,0,4,0,4,0,5,4,9,0,3,5,8,0,12,9,21,11,11,0.0,M2018-11-14D,Race(3),,
9,0,6,10,16,2,5,4,11,1,8,8,17,3,19,22,44,6.5,6,0.0,M2018-11-14D,Race(3),,
10,0,0,0,0,0,8,0,8,0,0,0,0,0,8,0,8,34,34,0.0,M2018-11-14D,Race(3),,
11,0,0,0,0,0,0,0,0,0,1,0,1,0,1,0,1,51,51,0.0,M2018-11-14D,Race(3),,
12,4,2,0,6,0,0,2,2,1,1,1,3,5,3,3,11,8,8,0.0,M2018-11-14D,Race(3),,
1,2,5,5,12,9,3,6,18,6,6,8,20,17,14,19,50,4,4,0.0,M2018-11-14D,Race(4),,
2,6,11,7,24,4,6,3,13,5,10,5,20,15,27,15,57,4.8,4.8,3.0,M2018-11-14D,Race(4),,
3,0,0,0,0,0,1,0,1,0,2,0,2,0,3,0,3,21,21,2.0,M2018-11-14D,Race(4),,
4,2,10,0,12,2,2,3,7,0,1,4,5,4,13,7,24,13,13,0.0,M2018-11-14D,Race(4),,
5,2,0,2,4,0,1,8,9,0,0,1,1,2,1,11,14,19,19,1.0,M2018-11-14D,Race(4),,
6,0,0,0,0,0,8,0,8,0,0,0,0,0,8,0,8,34,34,0.0,M2018-11-14D,Race(4),,
7,18,2,8,28,6,6,6,18,14,4,5,23,38,12,19,69,2.6,2.6,0.0,M2018-11-14D,Race(4),,
8,0,0,0,0,1,2,2,5,1,1,0,2,2,3,2,7,15,15,0.0,M2018-11-14D,Race(4),,
9,0,0,2,2,0,0,0,0,0,0,0,0,0,0,2,2,21,21,0.0,M2018-11-14D,Race(4),,
10,0,0,3,3,0,0,0,0,0,1,0,1,0,1,3,4,18,18,0.0,M2018-11-14D,Race(4),,
11,0,2,3,5,8,1,2,11,0,1,3,4,8,4,8,20,15,15,0.0,M2018-11-14D,Race(4),,
12,0,0,0,0,0,0,0,0,0,0,0,0,0,0,0,0,101,101,0.0,M2018-11-14D,Race(4),,
1,0,0,0,0,0,0,2,2,0,0,1,1,0,0,3,3,15,15,0.0,M2018-11-14D,Race(5),,
2,0,2,0,2,0,0,0,0,1,0,0,1,1,2,0,3,26,26,2.0,M2018-11-14D,Race(5),,
3,0,2,4,6,0,2,1,3,1,2,4,7,1,6,9,16,12,12,3.0,M2018-11-14D,Race(5),,
4,0,0,0,0,0,0,8,8,0,0,1,1,0,0,9,9,26,26,0.0,M2018-11-14D,Race(5),,
5,18,5,0,23,9,6,6,21,10,3,6,19,37,14,12,63,3,3,1.0,M2018-11-14D,Race(5),,
6,0,2,0,2,0,7,5,12,0,7,3,10,0,16,8,24,17,17,0.0,M2018-11-14D,Race(5),,
7,3,0,15,18,10,3,4,17,3,6,3,12,16,9,22,47,7,7,0.0,M2018-11-14D,Race(5),,
8,5,13,5,23,11,4,4,19,10,7,4,21,26,24,13,63,3.4,3.4,0.0,M2018-11-14D,Race(5),,
9,2,0,3,5,0,0,0,0,1,0,0,1,3,0,3,6,12,12,0.0,M2018-11-14D,Race(5),,
10,0,0,0,0,0,0,0,0,0,0,0,0,0,0,0,0,26,26,0.0,M2018-11-14D,Race(5),,
11,2,0,3,5,0,0,0,0,0,1,2,3,2,1,5,8,16,16,0.0,M2018-11-14D,Race(5),,
12,0,6,0,6,0,8,0,8,0,0,2,2,0,14,2,16,18,18,0.0,M2018-11-14D,Race(5),,
1,0,7,5,12,0,1,4,5,1,1,4,6,1,9,13,23,18,18,0.0,M2018-11-14D,Race(6),,
2,0,0,4,4,0,1,2,3,0,2,2,4,0,3,8,11,21,21,0.0,M2018-11-14D,Race(6),,
3,30,0,0,30,21,2,0,23,22,3,0,25,73,5,0,78,1.4,1.4,2.0,M2018-11-14D,Race(6),,
4,0,3,0,3,0,2,1,3,0,5,1,6,0,10,2,12,21,21,0.0,M2018-11-14D,Race(6),,
5,0,0,0,0,0,1,0,1,0,2,0,2,0,3,0,3,51,51,3.0,M2018-11-14D,Race(6),,
6,0,2,6,8,0,2,5,7,2,1,6,9,2,5,17,24,13,13,0.0,M2018-11-14D,Race(6),,
7,0,0,10,10,0,3,3,6,0,3,3,6,0,6,16,22,16,16,0.0,M2018-11-14D,Race(6),,
8,0,3,0,3,0,3,3,6,0,2,1,3,0,8,4,12,15,15,0.0,M2018-11-14D,Race(6),,
9,0,2,0,2,0,0,0,0,0,0,1,1,0,2,1,3,31,31,0.0,M2018-11-14D,Race(6),,
10,0,2,3,5,1,8,0,9,0,1,0,1,1,11,3,15,31,31,0.0,M2018-11-14D,Race(6),,
11,0,11,2,13,8,6,4,18,1,5,3,9,9,22,9,40,11,11,0.0,M2018-11-14D,Race(6),,
12,0,0,0,0,0,1,8,9,0,1,5,6,0,2,13,15,18,18,1.0,M2018-11-14D,Race(6),,
1,3,0,4,7,2,1,0,3,1,1,1,3,6,2,5,13,11,11,0.0,M2018-11-14D,Race(7),,
2,7,7,6,20,6,3,3,12,8,1,2,11,21,11,11,43,3.1,3.1,2.0,M2018-11-14D,Race(7),,
3,0,0,0,0,0,0,0,0,1,0,0,1,1,0,0,1,19,19,0.0,M2018-11-14D,Race(7),,
4,2,0,0,2,8,2,1,11,2,4,1,7,12,6,2,20,11,11,0.0,M2018-11-14D,Race(7),,
5,10,8,4,22,7,7,6,20,7,12,3,22,24,27,13,64,4.4,4.5,0.0,M2018-11-14D,Race(7),,
6,2,3,2,7,4,4,4,12,4,3,5,12,10,10,11,31,7.5,7,1.0,M2018-11-14D,Race(7),,
7,0,0,0,0,2,0,0,2,0,0,0,0,2,0,0,2,26,26,0.0,M2018-11-14D,Race(7),,
8,0,2,0,2,0,1,8,9,0,0,1,1,0,3,9,12,16,16,3.0,M2018-11-14D,Race(7),,
9,0,0,0,0,0,0,0,0,0,0,0,0,0,0,0,0,19,19,0.0,M2018-11-14D,Race(7),,
10,3,2,8,13,0,8,3,11,1,0,4,5,4,10,15,29,11,11,0.0,M2018-11-14D,Race(7),,
11,0,0,0,0,0,0,0,0,0,0,0,0,0,0,0,0,34,34,0.0,M2018-11-14D,Race(7),,
12,3,8,6,17,1,4,5,10,2,5,9,16,6,17,20,43,9,9,0.0,M2018-11-14D,Race(7),,
1,0,2,0,2,0,0,2,2,1,0,4,5,1,2,6,9,17,17,0.0,M2018-11-14D,Race(8),,
2,0,0,0,0,0,1,1,2,0,0,2,2,0,1,3,4,19,19,0.0,M2018-11-14D,Race(8),,
3,5,6,6,17,1,2,5,8,2,4,5,11,8,12,16,36,7,7,0.0,M2018-11-14D,Race(8),,
4,2,0,0,2,0,2,1,3,0,3,1,4,2,5,2,9,26,26,0.0,M2018-11-14D,Race(8),,
5,6,3,11,20,6,10,5,21,5,12,6,23,17,25,22,64,5.5,5,2.0,M2018-11-14D,Race(8),,
6,3,5,0,8,0,2,6,8,0,3,3,6,3,10,9,22,9,9,1.0,M2018-11-14D,Race(8),,
7,0,0,0,0,0,0,0,0,0,0,0,0,0,0,0,0,26,26,0.0,M2018-11-14D,Race(8),,
8,14,11,3,28,15,5,2,22,17,3,4,24,46,19,9,74,2.05,2,3.0,M2018-11-14D,Race(8),,
9,0,3,0,3,0,0,0,0,0,0,0,0,0,3,0,3,34,34,0.0,M2018-11-14D,Race(8),,
10,0,0,0,0,8,0,0,8,0,0,0,0,8,0,0,8,34,34,0.0,M2018-11-14D,Race(8),,
11,0,0,7,7,0,0,8,8,1,0,1,2,1,0,16,17,10,10,0.0,M2018-11-14D,Race(8),,
12,0,0,3,3,0,8,0,8,0,1,0,1,0,9,3,12,26,26,0.0,M2018-11-14D,Race(8),,
1,14,3,9,26,17,3,2,22,19,4,0,23,50,10,11,71,2.5,2.5,0.0,M2018-11-18D,Race(1),,
2,0,0,0,0,0,0,1,1,0,0,2,2,0,0,3,3,26,26,0.0,M2018-11-18D,Race(1),,
3,0,0,3,3,0,8,2,10,1,3,3,7,1,11,8,20,8.5,8.5,0.0,M2018-11-18D,Race(1),,
4,2,0,2,4,1,2,2,5,2,3,0,5,5,5,4,14,13,13,0.0,M2018-11-18D,Race(1),,
5,3,9,0,12,2,3,3,8,2,5,2,9,7,17,5,29,7,7,1.0,M2018-11-18D,Race(1),,
6,0,0,0,0,0,0,0,0,0,0,0,0,0,0,0,0,34,34,0.0,M2018-11-18D,Race(1),,
7,0,0,3,3,0,0,0,0,0,0,0,0,0,0,3,3,61,61,0.0,M2018-11-18D,Race(1),,
8,2,0,0,2,0,0,0,0,0,0,0,0,2,0,0,2,34,34,0.0,M2018-11-18D,Race(1),,
9,0,0,0,0,0,0,0,0,0,0,0,0,0,0,0,0,71,67,0.0,M2018-11-18D,Race(1),,
10,0,0,0,0,0,1,8,9,0,0,2,2,0,1,10,11,19,19,0.0,M2018-11-18D,Race(1),,
11,5,8,0,13,8,2,6,16,1,3,6,10,14,13,12,39,6.5,6.5,2.0,M2018-11-18D,Race(1),,
12,4,5,11,20,2,11,4,17,1,8,8,17,7,24,23,54,7.5,7.5,0.0,M2018-11-18D,Race(1),,
13,0,0,0,0,0,0,0,0,0,0,0,0,0,0,0,0,41,41,0.0,M2018-11-18D,Race(1),,
14,0,5,2,7,0,0,2,2,0,0,3,3,0,5,7,12,16,16,3.0,M2018-11-18D,Race(1),,
1,0,0,0,0,2,1,1,4,1,0,1,2,3,1,2,6,12,12,0.0,M2018-11-18D,Race(10),,
2,2,10,10,22,9,6,3,18,13,5,3,21,24,21,16,61,6.5,6.5,0.0,M2018-11-18D,Race(10),,
3,3,0,0,3,1,1,3,5,1,4,1,6,5,5,4,14,17,17,0.0,M2018-11-18D,Race(10),,
4,0,0,0,0,0,0,8,8,0,0,3,3,0,0,11,11,12,12,0.0,M2018-11-18D,Race(10),,
5,6,3,0,9,1,8,2,11,3,0,2,5,10,11,4,25,8.5,8.5,2.0,M2018-11-18D,Race(10),,
6,0,0,0,0,0,0,0,0,0,0,1,1,0,0,1,1,51,51,0.0,M2018-11-18D,Race(10),,
7,0,2,6,8,8,1,3,12,0,2,4,6,8,5,13,26,12,12,0.0,M2018-11-18D,Race(10),,
8,0,0,0,0,0,0,0,0,0,0,0,0,0,0,0,0,17,17,0.0,M2018-11-18D,Race(10),,
9,0,0,0,0,0,0,0,0,0,0,0,0,0,0,0,0,41,41,0.0,M2018-11-18D,Race(10),,
10,0,5,3,8,0,0,3,3,0,1,5,6,0,6,11,17,18,18,0.0,M2018-11-18D,Race(10),,
11,13,7,0,20,7,6,5,18,7,9,2,18,27,22,7,56,2.7,2.7,1.0,M2018-11-18D,Race(10),,
12,0,0,4,4,0,2,0,2,0,0,0,0,0,2,4,6,26,26,0.0,M2018-11-18D,Race(10),,
13,0,3,4,7,2,3,2,7,0,2,4,6,2,8,10,20,10,10,3.0,M2018-11-18D,Race(10),,
14,6,0,3,9,0,2,0,2,1,3,0,4,7,5,3,15,19,19,0.0,M2018-11-18D,Race(10),,
1,3,3,0,6,5,4,1,10,7,5,2,14,15,12,3,30,7.5,7.5,3.0,M2018-11-18D,Race(2),,
2,5,8,3,16,4,4,3,11,2,6,0,8,11,18,6,35,7.5,7.5,0.0,M2018-11-18D,Race(2),,
3,0,0,2,2,2,8,1,11,3,0,2,5,5,8,5,18,9,9,1.0,M2018-11-18D,Race(2),,
4,0,0,0,0,0,0,8,8,0,0,0,0,0,0,8,8,16,16,0.0,M2018-11-18D,Race(2),,
5,0,2,0,2,0,0,0,0,0,0,0,0,0,2,0,2,34,34,0.0,M2018-11-18D,Race(2),,
6,2,2,0,4,8,2,2,12,0,3,4,7,10,7,6,23,8.5,8.5,0.0,M2018-11-18D,Race(2),,
7,2,0,0,2,0,0,0,0,0,0,0,0,2,0,0,2,41,41,0.0,M2018-11-18D,Race(2),,
8,2,3,0,5,0,2,3,5,0,3,1,4,2,8,4,14,34,34,0.0,M2018-11-18D,Race(2),,
9,6,7,2,15,0,4,3,7,1,2,7,10,7,13,12,32,7.5,7.5,0.0,M2018-11-18D,Race(2),,
10,4,0,7,11,0,0,1,1,0,0,1,1,4,0,9,13,26,26,0.0,M2018-11-18D,Race(2),,
11,3,2,11,16,8,3,5,16,7,3,4,14,18,8,20,46,3.8,3.8,0.0,M2018-11-18D,Race(2),,
12,0,0,0,0,1,0,1,2,1,1,1,3,2,1,2,5,26,26,0.0,M2018-11-18D,Race(2),,
13,3,3,5,11,2,3,2,7,5,3,3,11,10,9,10,29,8,8,2.0,M2018-11-18D,Race(2),,
14,0,0,0,0,0,0,0,0,0,0,1,1,0,0,1,1,17,17,0.0,M2018-11-18D,Race(2),,
1,0,2,7,9,0,4,6,10,0,6,6,12,0,12,19,31,9,9,0.0,M2018-11-18D,Race(3),,
2,3,0,5,8,0,8,1,9,1,2,3,6,4,10,9,23,7.5,7.5,3.0,M2018-11-18D,Race(3),,
3,23,2,0,25,20,2,1,23,23,3,0,26,66,7,1,74,2.3,2.3,1.0,M2018-11-18D,Race(3),,
4,0,0,0,0,0,0,0,0,0,0,1,1,0,0,1,1,51,51,0.0,M2018-11-18D,Race(3),,
5,0,0,0,0,0,0,0,0,0,0,0,0,0,0,0,0,31,31,0.0,M2018-11-18D,Race(3),,
6,0,3,3,6,0,1,0,1,0,2,0,2,0,6,3,9,12,12,0.0,M2018-11-18D,Race(3),,
7,0,6,2,8,0,0,8,8,1,0,2,3,1,6,12,19,14,14,2.0,M2018-11-18D,Race(3),,
8,0,10,0,10,0,6,3,9,0,1,3,4,0,17,6,23,5.5,5.5,0.0,M2018-11-18D,Race(3),,
9,2,2,7,11,2,3,4,9,1,3,1,5,5,8,12,25,8,8,0.0,M2018-11-18D,Race(3),,
10,2,5,6,13,8,3,2,13,0,3,6,9,10,11,14,35,13,13,0.0,M2018-11-18D,Race(3),,
11,0,0,0,0,0,1,2,3,0,3,2,5,0,4,4,8,34,34,0.0,M2018-11-18D,Race(3),,
1,0,0,0,0,0,0,0,0,0,0,0,0,0,0,0,0,34,34,2.0,M2018-11-18D,Race(4),,
2,12,8,10,30,20,1,2,23,23,0,1,24,55,9,13,77,2.6,2.6,1.0,M2018-11-18D,Race(4),,
3,0,0,0,0,0,0,0,0,0,1,0,1,0,1,0,1,15,14,0.0,M2018-11-18D,Race(4),,
4,3,6,3,12,0,4,6,10,1,3,5,9,4,13,14,31,7.5,7.5,0.0,M2018-11-18D,Race(4),,
5,5,0,4,9,0,1,0,1,0,0,3,3,5,1,7,13,12,12,0.0,M2018-11-18D,Race(4),,
6,0,0,3,3,0,1,3,4,1,2,2,5,1,3,8,12,31,31,0.0,M2018-11-18D,Race(4),,
7,0,0,0,0,0,0,0,0,0,0,0,0,0,0,0,0,41,41,0.0,M2018-11-18D,Race(4),,
8,0,0,0,0,0,0,0,0,0,1,0,1,0,1,0,1,61,61,0.0,M2018-11-18D,Race(4),,
9,5,11,6,22,8,14,6,28,0,13,9,22,13,38,21,72,5,5,0.0,M2018-11-18D,Race(4),,
10,0,0,4,4,2,0,8,10,1,1,1,3,3,1,13,17,15,15,0.0,M2018-11-18D,Race(4),,
11,0,0,0,0,0,0,0,0,0,0,0,0,0,0,0,0,34,34,0.0,M2018-11-18D,Race(4),,
12,3,3,0,6,0,1,5,6,0,5,5,10,3,9,10,22,8,8,0.0,M2018-11-18D,Race(4),,
13,2,2,0,4,0,8,0,8,0,0,0,0,2,10,0,12,11,11,3.0,M2018-11-18D,Race(4),,
14,0,0,0,0,0,0,0,0,0,0,0,0,0,0,0,0,101,101,0.0,M2018-11-18D,Race(4),,
1,12,10,2,24,9,5,5,19,10,10,2,22,31,25,9,65,2.5,2.5,0.0,M2018-11-18D,Race(5),,
2,2,0,0,2,1,2,8,11,0,2,0,2,3,4,8,15,26,26,0.0,M2018-11-18D,Race(5),,
3,10,13,5,28,10,7,2,19,10,3,4,17,30,23,11,64,3.7,3.7,2.0,M2018-11-18D,Race(5),,
4,3,3,3,9,0,2,2,4,0,3,4,7,3,8,9,20,8.5,8.5,0.0,M2018-11-18D,Race(5),,
5,0,0,0,0,0,2,0,2,1,2,0,3,1,4,0,5,15,15,0.0,M2018-11-18D,Race(5),,
6,3,4,5,12,8,4,5,17,2,5,6,13,13,13,16,42,7.5,7.5,1.0,M2018-11-18D,Race(5),,
7,0,0,0,0,0,0,0,0,0,0,0,0,0,0,0,0,26,26,3.0,M2018-11-18D,Race(5),,
8,0,0,0,0,0,0,0,0,0,0,0,0,0,0,0,0,41,41,0.0,M2018-11-18D,Race(5),,
9,0,0,3,3,0,0,6,6,0,0,7,7,0,0,16,16,34,34,0.0,M2018-11-18D,Race(5),,
10,0,0,0,0,0,0,0,0,0,0,1,1,0,0,1,1,41,41,0.0,M2018-11-18D,Race(5),,
11,0,0,0,0,0,0,0,0,0,0,0,0,0,0,0,0,34,34,0.0,M2018-11-18D,Race(5),,
12,0,0,12,12,2,8,2,12,3,1,2,6,5,9,16,30,8,8,0.0,M2018-11-18D,Race(5),,
1,26,4,0,30,22,1,0,23,26,0,0,26,74,5,0,79,1.26,1.26,1.0,M2018-11-18D,Race(6),,
2,0,0,0,0,0,8,0,8,0,0,0,0,0,8,0,8,31,31,0.0,M2018-11-18D,Race(6),,
3,0,0,0,0,0,0,0,0,0,0,0,0,0,0,0,0,31,31,0.0,M2018-11-18D,Race(6),,
4,0,5,3,8,0,0,4,4,0,0,4,4,0,5,11,16,21,21,3.0,M2018-11-18D,Race(6),,
5,4,16,4,24,0,19,4,23,0,21,4,25,4,56,12,72,4.8,4.8,0.0,M2018-11-18D,Race(6),,
6,0,3,11,14,8,1,9,18,0,1,7,8,8,5,27,40,16,16,2.0,M2018-11-18D,Race(6),,
7,0,2,8,10,0,0,8,8,0,1,7,8,0,3,23,26,21,21,0.0,M2018-11-18D,Race(6),,
8,0,0,4,4,0,1,5,6,0,3,4,7,0,4,13,17,16,16,0.0,M2018-11-18D,Race(6),,
1,9,5,3,17,1,4,6,11,1,5,5,11,11,14,14,39,5,5,0.0,M2018-11-18D,Race(7),,
2,14,6,2,22,7,7,6,20,10,10,2,22,31,23,10,64,5.5,5.5,0.0,M2018-11-18D,Race(7),,
3,0,5,5,10,0,8,3,11,0,0,2,2,0,13,10,23,4.8,4.8,3.0,M2018-11-18D,Race(7),,
4,3,6,10,19,8,3,5,16,1,4,9,14,12,13,24,49,6,6,2.0,M2018-11-18D,Race(7),,
5,0,0,3,3,0,0,0,0,0,0,0,0,0,0,3,3,14,14,0.0,M2018-11-18D,Race(7),,
6,0,0,0,0,0,0,2,2,0,0,5,5,0,0,7,7,13,13,1.0,M2018-11-18D,Race(7),,
7,0,0,0,0,0,0,0,0,0,0,0,0,0,0,0,0,34,34,0.0,M2018-11-18D,Race(7),,
8,0,0,0,0,0,0,0,0,0,0,0,0,0,0,0,0,34,34,0.0,M2018-11-18D,Race(7),,
9,4,8,7,19,14,8,8,30,14,7,3,24,32,23,18,73,3,3,0.0,M2018-11-18D,Race(7),,
1,0,4,5,9,8,6,7,21,3,7,7,17,11,17,19,47,5.5,5.5,0.0,M2018-11-18D,Race(8),,
2,12,8,8,28,6,7,6,19,8,6,6,20,26,21,20,67,3.5,3.5,2.0,M2018-11-18D,Race(8),,
3,0,0,2,2,0,1,3,4,0,3,3,6,0,4,8,12,11,11,0.0,M2018-11-18D,Race(8),,
4,3,0,2,5,1,8,0,9,0,2,2,4,4,10,4,18,8,8,3.0,M2018-11-18D,Race(8),,
5,2,3,11,16,0,3,2,5,0,2,2,4,2,8,15,25,14,14,0.0,M2018-11-18D,Race(8),,
6,0,0,0,0,0,0,9,9,0,0,3,3,0,0,12,12,26,26,0.0,M2018-11-18D,Race(8),,
7,13,15,2,30,15,5,2,22,15,6,3,24,43,26,7,76,2.5,2.5,1.0,M2018-11-18D,Race(8),,
8,0,0,0,0,0,0,0,0,0,0,0,0,0,0,0,0,15,15,0.0,M2018-11-18D,Race(8),,
9,0,0,0,0,0,0,0,0,0,0,0,0,0,0,0,0,26,26,0.0,M2018-11-18D,Race(8),,
1,10,15,3,28,10,7,4,21,12,9,1,22,32,31,8,71,6,6,0.0,M2018-11-18D,Race(9),,
2,0,0,0,0,0,0,8,8,0,0,1,1,0,0,9,9,16,16,0.0,M2018-11-18D,Race(9),,
3,3,3,3,9,2,1,3,6,1,2,2,5,6,6,8,20,7.5,7.5,2.0,M2018-11-18D,Race(9),,
4,0,0,3,3,0,8,0,8,0,0,2,2,0,8,5,13,9,9,0.0,M2018-11-18D,Race(9),,
5,0,0,5,5,1,2,3,6,1,1,2,4,2,3,10,15,10,10,0.0,M2018-11-18D,Race(9),,
6,0,0,0,0,1,1,1,3,1,1,2,4,2,2,3,7,15,14,0.0,M2018-11-18D,Race(9),,
7,5,2,4,11,1,2,3,6,2,6,2,10,8,10,9,27,12,12,0.0,M2018-11-18D,Race(9),,
8,0,0,0,0,0,0,0,0,0,0,0,0,0,0,0,0,31,31,0.0,M2018-11-18D,Race(9),,
9,0,0,0,0,0,0,0,0,0,0,0,0,0,0,0,0,26,26,0.0,M2018-11-18D,Race(9),,
10,0,3,2,5,8,1,0,9,0,0,1,1,8,4,3,15,12,12,0.0,M2018-11-18D,Race(9),,
11,0,2,0,2,0,0,2,2,0,0,4,4,0,2,6,8,19,19,0.0,M2018-11-18D,Race(9),,
12,5,5,7,17,6,4,1,11,7,2,0,9,18,11,8,37,5,5,1.0,M2018-11-18D,Race(9),,
13,2,0,0,2,0,2,3,5,0,1,5,6,2,3,8,13,16,16,3.0,M2018-11-18D,Race(9),,
14,5,0,3,8,1,2,2,5,2,4,4,10,8,6,9,23,10,10,0.0,M2018-11-18D,Race(9),,
1,14,9,0,23,5,11,7,23,8,3,6,17,27,23,13,63,3.2,3.2,1.0,M2018-11-21D,Race(1),,
2,2,0,2,4,0,2,0,2,2,0,0,2,4,2,2,8,17,17,0.0,M2018-11-21D,Race(1),,
3,0,0,0,0,0,0,0,0,0,0,0,0,0,0,0,0,51,51,0.0,M2018-11-21D,Race(1),,
4,0,8,11,19,0,4,1,5,1,5,2,8,1,17,14,32,7.5,7.5,2.0,M2018-11-21D,Race(1),,
5,5,5,5,15,17,3,7,27,8,5,10,23,30,13,22,65,4.6,4.6,3.0,M2018-11-21D,Race(1),,
6,0,0,0,0,0,0,1,1,0,1,1,2,0,1,2,3,17,17,0.0,M2018-11-21D,Race(1),,
7,7,8,5,20,6,8,13,27,7,9,4,20,20,25,22,67,3.2,3.2,0.0,M2018-11-21D,Race(1),,
8,0,0,0,0,0,0,0,0,0,0,0,0,0,0,0,0,51,51,0.0,M2018-11-21D,Race(1),,
9,0,0,0,0,0,0,0,0,0,0,1,1,0,0,1,1,13,13,0.0,M2018-11-21D,Race(1),,
10,0,0,0,0,0,0,0,0,0,0,0,0,0,0,0,0,0,0,0.0,M2018-11-21D,Race(1),,
11,2,0,7,9,0,2,1,3,0,2,1,3,2,4,9,15,17,17,0.0,M2018-11-21D,Race(1),,
12,0,0,0,0,0,0,0,0,0,0,1,1,0,0,1,1,41,41,0.0,M2018-11-21D,Race(1),,
1,12,7,2,21,15,3,7,25,6,6,9,21,33,16,18,67,4.4,4.5,0.0,M2018-11-21D,Race(2),,
2,3,0,2,5,1,1,0,2,0,1,0,1,4,2,2,8,26,26,0.0,M2018-11-21D,Race(2),,
3,3,3,0,6,3,4,3,10,4,3,3,10,10,10,6,26,4.4,4.5,1.0,M2018-11-21D,Race(2),,
4,2,0,0,2,0,1,0,1,1,0,0,1,3,1,0,4,61,61,0.0,M2018-11-21D,Race(2),,
5,0,0,0,0,0,0,0,0,0,0,0,0,0,0,0,0,34,35,0.0,M2018-11-21D,Race(2),,
6,4,14,10,28,6,12,5,23,7,5,6,18,17,31,21,69,4,4,0.0,M2018-11-21D,Race(2),,
7,0,0,0,0,1,0,0,1,0,1,0,1,1,1,0,2,31,31,0.0,M2018-11-21D,Race(2),,
8,4,4,11,19,2,6,10,18,4,6,2,12,10,16,23,49,0,0,0.0,M2018-11-21D,Race(2),,
9,2,0,3,5,2,0,1,3,1,0,2,3,5,0,6,11,8.5,8.5,0.0,M2018-11-21D,Race(2),,
10,0,0,0,0,0,0,0,0,0,0,1,1,0,0,1,1,26,26,3.0,M2018-11-21D,Race(2),,
11,0,2,2,4,0,3,4,7,3,4,3,10,3,9,9,21,6,6,2.0,M2018-11-21D,Race(2),,
12,0,0,0,0,0,0,0,0,0,0,0,0,0,0,0,0,41,41,0.0,M2018-11-21D,Race(2),,
1,15,6,2,23,17,6,3,26,11,7,2,20,43,19,7,69,2.5,2.5,2.0,M2018-11-21D,Race(3),,
2,0,0,2,2,0,0,1,1,0,0,0,0,0,0,3,3,21,21,0.0,M2018-11-21D,Race(3),,
3,0,0,0,0,0,2,2,4,0,0,5,5,0,2,7,9,16,16,0.0,M2018-11-21D,Race(3),,
4,3,4,5,12,5,4,3,12,9,6,2,17,17,14,10,41,13,13,0.0,M2018-11-21D,Race(3),,
5,0,3,0,3,0,0,0,0,0,1,2,3,0,4,2,6,7.5,7.5,0.0,M2018-11-21D,Race(3),,
6,3,0,2,5,0,1,1,2,1,1,2,4,4,2,5,11,26,26,3.0,M2018-11-21D,Race(3),,
7,6,5,5,16,6,8,3,17,1,0,4,5,13,13,12,38,12,12,0.0,M2018-11-21D,Race(3),,
8,0,0,0,0,0,0,0,0,0,0,0,0,0,0,0,0,51,51,0.0,M2018-11-21D,Race(3),,
9,0,0,3,3,0,0,1,1,0,0,1,1,0,0,5,5,11,11,0.0,M2018-11-21D,Race(3),,
10,3,12,11,26,2,9,14,25,4,11,5,20,9,32,30,71,4,4,1.0,M2018-11-21D,Race(3),,
11,0,0,0,0,0,0,1,1,0,0,2,2,0,0,3,3,21,21,0.0,M2018-11-21D,Race(3),,
12,0,0,0,0,0,0,1,1,0,0,1,1,0,0,2,2,21,21,0.0,M2018-11-21D,Race(3),,
1,2,3,4,9,3,13,3,19,3,3,4,10,8,19,11,38,8.5,8.5,1.0,M2018-11-21D,Race(4),,
2,8,5,8,21,6,5,15,26,8,8,7,23,22,18,30,70,2.7,2.7,0.0,M2018-11-21D,Race(4),,
3,0,0,3,3,0,0,0,0,0,0,0,0,0,0,3,3,34,35,0.0,M2018-11-21D,Race(4),,
4,6,2,3,11,3,4,2,9,2,3,5,10,11,9,10,30,7,7,0.0,M2018-11-21D,Race(4),,
5,0,3,0,3,0,0,0,0,0,0,0,0,0,3,0,3,34,35,3.0,M2018-11-21D,Race(4),,
6,12,7,4,23,4,5,2,11,3,6,4,13,19,18,10,47,7,7,0.0,M2018-11-21D,Race(4),,
7,0,3,2,5,0,0,0,0,1,0,0,1,1,3,2,6,17,17,0.0,M2018-11-21D,Race(4),,
8,0,0,0,0,0,0,0,0,0,1,0,1,0,1,0,1,10,10,0.0,M2018-11-21D,Race(4),,
9,0,0,0,0,0,2,0,2,0,0,0,0,0,2,0,2,34,35,0.0,M2018-11-21D,Race(4),,
10,0,3,6,9,0,0,7,7,1,2,4,7,1,5,17,23,8,8,0.0,M2018-11-21D,Race(4),,
11,2,4,0,6,14,1,1,16,8,3,1,12,24,8,2,34,8,8,2.0,M2018-11-21D,Race(4),,
12,0,0,0,0,0,0,0,0,0,0,1,1,0,0,1,1,34,35,0.0,M2018-11-21D,Race(4),,
1,2,2,0,4,0,0,0,0,0,0,0,0,2,2,0,4,19,19,0.0,M2018-11-21D,Race(5),,
2,0,3,0,3,0,0,0,0,1,0,0,1,1,3,0,4,19,19,0.0,M2018-11-21D,Race(5),,
3,0,0,5,5,2,1,2,5,0,1,1,2,2,2,8,12,12,12,0.0,M2018-11-21D,Race(5),,
4,0,3,2,5,2,2,5,9,3,5,5,13,5,10,12,27,15,15,0.0,M2018-11-21D,Race(5),,
5,0,3,0,3,0,3,1,4,0,1,2,3,0,7,3,10,10,10,0.0,M2018-11-21D,Race(5),,
6,6,3,4,13,16,5,3,24,10,6,3,19,32,14,10,56,3.4,3.4,2.0,M2018-11-21D,Race(5),,
7,3,0,8,11,1,2,1,4,2,3,4,9,6,5,13,24,11,11,0.0,M2018-11-21D,Race(5),,
8,8,12,3,23,1,3,15,19,3,4,6,13,12,19,24,55,6,6,0.0,M2018-11-21D,Race(5),,
9,0,0,0,0,0,0,0,0,0,0,0,0,0,0,0,0,41,41,0.0,M2018-11-21D,Race(5),,
10,0,0,0,0,0,0,0,0,0,0,0,0,0,0,0,0,17,17,0.0,M2018-11-21D,Race(5),,
11,11,2,6,19,8,14,3,25,7,6,5,18,26,22,14,62,3.7,3.7,1.0,M2018-11-21D,Race(5),,
12,0,2,2,4,0,0,0,0,0,0,0,0,0,2,2,4,26,26,3.0,M2018-11-21D,Race(5),,
1,2,7,7,16,4,13,5,22,8,5,5,18,14,25,17,56,11,11,0.0,M2018-11-21D,Race(6),,
2,11,5,5,21,13,1,3,17,8,0,3,11,32,6,11,49,5.5,5.5,1.0,M2018-11-21D,Race(6),,
3,0,0,3,3,0,0,0,0,0,1,0,1,0,1,3,4,13,13,0.0,M2018-11-21D,Race(6),,
4,0,6,2,8,1,3,4,8,1,7,6,14,2,16,12,30,8.5,8.5,0.0,M2018-11-21D,Race(6),,
5,0,0,0,0,0,0,0,0,0,0,0,0,0,0,0,0,15,15,0.0,M2018-11-21D,Race(6),,
6,7,5,2,14,4,4,3,11,3,10,3,16,14,19,8,41,5.5,5.5,0.0,M2018-11-21D,Race(6),,
7,3,0,3,6,0,0,0,0,0,0,1,1,3,0,4,7,12,12,3.0,M2018-11-21D,Race(6),,
8,2,5,0,7,4,6,10,20,4,2,4,10,10,13,14,37,5,5,0.0,M2018-11-21D,Race(6),,
9,0,0,0,0,1,0,0,1,0,0,0,0,1,0,0,1,34,34,0.0,M2018-11-21D,Race(6),,
10,0,0,3,3,1,0,2,3,1,0,2,3,2,0,7,9,10,10,0.0,M2018-11-21D,Race(6),,
11,5,0,3,8,1,2,3,6,1,1,2,4,7,3,8,18,9,9,2.0,M2018-11-21D,Race(6),,
12,0,2,2,4,1,1,0,2,0,0,0,0,1,3,2,6,17,17,0.0,M2018-11-21D,Race(6),,
1,7,6,7,20,8,16,4,28,13,7,3,23,28,29,14,71,6,6,0.0,M2018-11-21D,Race(7),,
2,2,0,0,2,0,1,3,4,0,3,5,8,2,4,8,14,26,26,0.0,M2018-11-21D,Race(7),,
3,5,5,2,12,1,0,1,2,0,0,2,2,6,5,5,16,9,9,0.0,M2018-11-21D,Race(7),,
4,0,5,3,8,0,1,1,2,0,0,0,0,0,6,4,10,15,15,3.0,M2018-11-21D,Race(7),,
5,0,0,0,0,0,0,0,0,0,1,0,1,0,1,0,1,26,26,1.0,M2018-11-21D,Race(7),,
6,0,2,5,7,0,1,0,1,0,2,2,4,0,5,7,12,10,10,0.0,M2018-11-21D,Race(7),,
7,8,2,0,10,1,4,2,7,1,5,1,7,10,11,3,24,5.5,5.5,2.0,M2018-11-21D,Race(7),,
8,3,3,3,9,1,2,14,17,1,2,8,11,5,7,25,37,12,12,0.0,M2018-11-21D,Race(7),,
9,5,7,8,20,19,5,4,28,11,6,2,19,35,18,14,67,2.7,2.7,0.0,M2018-11-21D,Race(7),,
10,0,0,2,2,0,0,0,0,0,0,0,0,0,0,2,2,12,12,0.0,M2018-11-21D,Race(7),,
11,0,0,0,0,0,0,1,1,0,0,3,3,0,0,4,4,26,26,0.0,M2018-11-21D,Race(7),,
12,0,0,0,0,0,0,0,0,0,0,0,0,0,0,0,0,51,51,0.0,M2018-11-21D,Race(7),,
1,7,0,0,7,1,0,2,3,0,0,3,3,8,0,5,13,15,15,2.0,M2018-11-21D,Race(8),,
2,2,2,0,4,2,1,4,7,4,1,6,11,8,4,10,22,9,9,1.0,M2018-11-21D,Race(8),,
3,3,5,3,11,4,4,3,11,9,4,0,13,16,13,6,35,5.5,5.5,0.0,M2018-11-21D,Race(8),,
4,0,0,3,3,1,0,0,1,0,0,0,0,1,0,3,4,41,41,0.0,M2018-11-21D,Race(8),,
5,0,0,0,0,0,1,0,1,0,0,0,0,0,1,0,1,41,26,0.0,M2018-11-21D,Race(8),,
6,13,7,2,22,12,5,2,19,2,13,4,19,27,25,8,60,3.7,3.7,0.0,M2018-11-21D,Race(8),,
7,0,3,7,10,5,3,13,21,7,3,4,14,12,9,24,45,11,11,0.0,M2018-11-21D,Race(8),,
8,0,0,2,2,0,0,0,0,0,0,2,2,0,0,4,4,17,17,3.0,M2018-11-21D,Race(8),,
9,0,2,6,8,1,2,0,3,1,1,0,2,2,5,6,13,11,11,0.0,M2018-11-21D,Race(8),,
10,5,11,5,21,4,13,6,23,3,3,7,13,12,27,18,57,3,3,0.0,M2018-11-21D,Race(8),,
11,0,0,2,2,0,1,0,1,0,1,0,1,0,2,2,4,34,34,0.0,M2018-11-21D,Race(8),,
12,0,0,0,0,0,0,0,0,0,0,0,0,0,0,0,0,71,67,0.0,M2018-11-21D,Race(8),,
1,0,0,0,0,0,0,0,0,0,0,2,2,0,0,2,2,51,51,0.0,M2018-11-25D,Race(1),,
2,20,5,5,30,17,3,2,22,12,7,2,21,49,15,9,73,2.6,2.6,1.0,M2018-11-25D,Race(1),,
3,2,7,0,9,8,9,3,20,3,7,2,12,13,23,5,41,7.5,7.5,0.0,M2018-11-25D,Race(1),,
4,0,7,7,14,2,2,6,10,2,4,5,11,4,13,18,35,7.5,7.5,0.0,M2018-11-25D,Race(1),,
5,0,0,0,0,0,0,8,8,1,0,2,3,1,0,10,11,26,26,0.0,M2018-11-25D,Race(1),,
6,3,6,11,20,3,8,6,17,7,7,6,20,13,21,23,57,3.9,4,0.0,M2018-11-25D,Race(1),,
7,0,0,0,0,0,0,0,0,0,0,0,0,0,0,0,0,41,41,0.0,M2018-11-25D,Race(1),,
8,0,3,5,8,0,0,2,2,0,1,3,4,0,4,10,14,20,21,0.0,M2018-11-25D,Race(1),,
9,0,0,0,0,0,0,0,0,0,0,0,0,0,0,0,0,101,101,0.0,M2018-11-25D,Race(1),,
10,0,0,0,0,0,8,1,9,0,0,2,2,0,8,3,11,11,11,2.0,M2018-11-25D,Race(1),,
11,5,2,0,7,0,0,0,0,0,0,0,0,5,2,0,7,20,21,0.0,M2018-11-25D,Race(1),,
12,0,0,0,0,0,0,0,0,0,0,0,0,0,0,0,0,34,34,0.0,M2018-11-25D,Race(1),,
13,0,0,2,2,0,0,2,2,1,0,2,3,1,0,6,7,20,21,3.0,M2018-11-25D,Race(1),,
14,0,0,0,0,0,0,0,0,0,0,0,0,0,0,0,0,71,67,0.0,M2018-11-25D,Race(1),,
1,0,0,3,3,0,1,8,9,0,1,1,2,0,2,12,14,13,15,0.0,M2018-11-25D,Race(10),,
2,3,3,0,6,2,5,2,9,5,2,5,12,10,10,7,27,10,11,0.0,M2018-11-25D,Race(10),,
3,0,0,5,5,8,2,3,13,0,4,3,7,8,6,11,25,12,11,0.0,M2018-11-25D,Race(10),,
4,0,2,2,4,0,0,5,5,1,2,4,7,1,4,11,16,26,26,0.0,M2018-11-25D,Race(10),,
5,0,5,5,10,0,7,0,7,1,9,1,11,1,21,6,28,10,11,1.0,M2018-11-25D,Race(10),,
6,0,2,5,7,0,1,5,6,0,0,2,2,0,3,12,15,17,17,0.0,M2018-11-25D,Race(10),,
7,0,0,0,0,0,0,0,0,0,0,0,0,0,0,0,0,26,26,3.0,M2018-11-25D,Race(10),,
8,0,0,0,0,0,0,0,0,0,0,0,0,0,0,0,0,34,34,0.0,M2018-11-25D,Race(10),,
9,20,8,2,30,20,1,2,23,18,4,0,22,58,13,4,75,2.3,2.1,2.0,M2018-11-25D,Race(10),,
10,2,3,0,5,0,0,3,3,0,2,6,8,2,5,9,16,16,17,0.0,M2018-11-25D,Race(10),,
11,5,0,0,5,0,8,2,10,0,0,2,2,5,8,4,17,16,17,0.0,M2018-11-25D,Race(10),,
12,0,0,3,3,0,0,0,0,0,0,1,1,0,0,4,4,12,11,0.0,M2018-11-25D,Race(10),,
13,0,0,0,0,0,3,0,3,0,0,0,0,0,3,0,3,34,34,0.0,M2018-11-25D,Race(10),,
14,0,7,5,12,0,2,0,2,1,2,1,4,1,11,6,18,9,9,0.0,M2018-11-25D,Race(10),,
1,5,0,0,5,0,1,0,1,1,0,0,1,6,1,0,7,17,17,0.0,M2018-11-25D,Race(2),,
2,7,5,10,22,3,10,3,16,4,9,5,18,14,24,18,56,3.5,3.5,1.0,M2018-11-25D,Race(2),,
3,6,8,2,16,4,3,6,13,4,4,3,11,14,15,11,40,5,5,2.0,M2018-11-25D,Race(2),,
4,4,0,0,4,0,0,0,0,0,0,0,0,4,0,0,4,7,7,3.0,M2018-11-25D,Race(2),,
5,0,0,0,0,0,0,0,0,0,0,0,0,0,0,0,0,20,21,0.0,M2018-11-25D,Race(2),,
6,0,0,0,0,0,0,4,4,1,0,4,5,1,0,8,9,17,17,0.0,M2018-11-25D,Race(2),,
7,0,2,3,5,0,0,2,2,0,0,3,3,0,2,8,10,19,17,0.0,M2018-11-25D,Race(2),,
8,0,0,0,0,0,0,1,1,0,0,0,0,0,0,1,1,26,26,0.0,M2018-11-25D,Race(2),,
9,0,0,0,0,0,0,0,0,0,1,1,2,0,1,1,2,26,26,0.0,M2018-11-25D,Race(2),,
10,0,0,3,3,0,0,0,0,0,0,0,0,0,0,3,3,31,31,0.0,M2018-11-25D,Race(2),,
11,0,0,0,0,0,0,0,0,0,0,0,0,0,0,0,0,61,61,0.0,M2018-11-25D,Race(2),,
12,2,4,5,11,0,8,1,9,0,2,1,3,2,14,7,23,10,10,0.0,M2018-11-25D,Race(2),,
13,3,11,7,21,8,2,3,13,3,2,7,12,14,15,17,46,7,7,0.0,M2018-11-25D,Race(2),,
14,3,0,0,3,0,0,8,8,0,0,1,1,3,0,9,12,13,13,0.0,M2018-11-25D,Race(2),,
1,2,3,5,10,7,6,4,17,6,4,5,15,15,13,14,42,3.9,4,0.0,M2018-11-25D,Race(3),,
2,7,13,2,22,9,7,1,17,8,5,3,16,24,25,6,55,4.2,4,2.0,M2018-11-25D,Race(3),,
3,6,4,3,13,2,2,5,9,4,3,1,8,12,9,9,30,6,6,1.0,M2018-11-25D,Race(3),,
4,7,6,6,19,4,3,2,9,3,6,2,11,14,15,10,39,5.5,6,0.0,M2018-11-25D,Race(3),,
5,0,0,6,6,0,2,8,10,0,6,1,7,0,8,15,23,10,10,0.0,M2018-11-25D,Race(3),,
6,8,2,0,10,8,2,9,19,5,1,12,18,21,5,21,47,7,7,3.0,M2018-11-25D,Race(3),,
7,0,0,0,0,0,0,0,0,0,0,0,0,0,0,0,0,10,10,0.0,M2018-11-25D,Race(3),,
8,0,0,3,3,0,0,0,0,0,0,0,0,0,0,3,3,34,34,0.0,M2018-11-25D,Race(3),,
9,0,2,5,7,0,8,1,9,0,1,1,2,0,11,7,18,17,17,0.0,M2018-11-25D,Race(3),,
10,0,0,0,0,0,0,0,0,0,0,1,1,0,0,1,1,34,34,0.0,M2018-11-25D,Race(3),,
1,0,0,0,0,0,0,0,0,1,0,0,1,1,0,0,1,81,81,0.0,M2018-11-25D,Race(4),,
2,2,0,0,2,8,3,0,11,1,3,0,4,11,6,0,17,11,11,0.0,M2018-11-25D,Race(4),,
3,5,8,4,17,10,5,4,19,10,5,3,18,25,18,11,54,8.5,9,2.0,M2018-11-25D,Race(4),,
4,0,0,2,2,0,2,2,4,1,5,0,6,1,7,4,12,8.5,9,0.0,M2018-11-25D,Race(4),,
5,0,0,0,0,0,8,1,9,0,1,0,1,0,9,1,10,16,17,0.0,M2018-11-25D,Race(4),,
6,2,10,10,22,8,4,6,18,10,4,4,18,20,18,20,58,5.5,5,3.0,M2018-11-25D,Race(4),,
7,0,4,5,9,0,0,1,1,0,0,5,5,0,4,11,15,14,14,0.0,M2018-11-25D,Race(4),,
8,0,0,0,0,0,0,1,1,0,0,1,1,0,0,2,2,26,26,0.0,M2018-11-25D,Race(4),,
9,8,3,0,11,3,7,6,16,2,8,7,17,13,18,13,44,5,5,1.0,M2018-11-25D,Race(4),,
10,8,2,0,10,1,1,1,3,1,0,5,6,10,3,6,19,6.5,6,0.0,M2018-11-25D,Race(4),,
11,0,3,0,3,0,0,0,0,0,0,0,0,0,3,0,3,51,51,0.0,M2018-11-25D,Race(4),,
12,0,0,3,3,0,0,8,8,0,0,1,1,0,0,12,12,11,10,0.0,M2018-11-25D,Race(4),,
13,5,0,3,8,0,0,0,0,0,0,0,0,5,0,3,8,16,16,0.0,M2018-11-25D,Race(4),,
14,0,0,3,3,0,0,0,0,0,0,0,0,0,0,3,3,13,12,0.0,M2018-11-25D,Race(4),,
1,0,3,2,5,0,0,0,0,0,0,0,0,0,3,2,5,11,11,3.0,M2018-11-25D,Race(5),,
2,0,0,0,0,0,0,0,0,0,0,0,0,0,0,0,0,34,34,0.0,M2018-11-25D,Race(5),,
3,0,0,2,2,2,4,4,10,2,2,3,7,4,6,9,19,12,11,0.0,M2018-11-25D,Race(5),,
4,23,7,0,30,18,4,1,23,20,5,0,25,61,16,1,78,2.4,2.5,1.0,M2018-11-25D,Race(5),,
5,0,0,0,0,0,0,0,0,0,0,0,0,0,0,0,0,41,41,0.0,M2018-11-25D,Race(5),,
6,0,0,0,0,0,0,0,0,0,0,0,0,0,0,0,0,101,101,0.0,M2018-11-25D,Race(5),,
7,4,6,5,15,0,5,1,6,0,7,1,8,4,18,7,29,8.5,9,0.0,M2018-11-25D,Race(5),,
8,0,0,3,3,0,0,8,8,0,0,0,0,0,0,11,11,31,31,0.0,M2018-11-25D,Race(5),,
9,0,2,5,7,0,8,1,9,0,0,0,0,0,10,6,16,20,21,0.0,M2018-11-25D,Race(5),,
10,0,0,0,0,0,0,0,0,0,0,0,0,0,0,0,0,0,0,0.0,M2018-11-25D,Race(5),,
11,0,5,2,7,8,2,7,17,0,2,5,7,8,9,14,31,13,13,0.0,M2018-11-25D,Race(5),,
12,0,3,8,11,0,2,1,3,0,6,7,13,0,11,16,27,8,8,0.0,M2018-11-25D,Race(5),,
13,0,4,3,7,2,5,7,14,4,4,10,18,6,13,20,39,6.5,7,2.0,M2018-11-25D,Race(5),,
14,3,0,0,3,0,0,0,0,0,0,0,0,3,0,0,3,17,17,0.0,M2018-11-25D,Race(5),,
1,5,11,5,21,14,4,5,23,11,8,4,23,30,23,14,67,3.9,4,3.0,M2018-11-25D,Race(6),,
2,0,0,2,2,0,0,0,0,0,1,0,1,0,1,2,3,17,17,0.0,M2018-11-25D,Race(6),,
3,0,0,7,7,0,2,8,10,3,4,0,7,3,6,15,24,15,15,0.0,M2018-11-25D,Race(6),,
4,0,0,0,0,0,0,0,0,0,0,0,0,0,0,0,0,71,67,0.0,M2018-11-25D,Race(6),,
5,16,7,0,23,4,11,3,18,8,8,4,20,28,26,7,61,4.2,4.2,0.0,M2018-11-25D,Race(6),,
6,7,5,5,17,1,3,11,15,1,2,12,15,9,10,28,47,4.8,4.8,0.0,M2018-11-25D,Race(6),,
7,0,0,3,3,8,0,0,8,0,1,1,2,8,1,4,13,31,31,0.0,M2018-11-25D,Race(6),,
8,0,0,0,0,0,0,0,0,0,0,0,0,0,0,0,0,71,67,0.0,M2018-11-25D,Race(6),,
9,0,0,0,0,0,8,0,8,0,0,0,0,0,8,0,8,51,51,0.0,M2018-11-25D,Race(6),,
10,0,4,3,7,1,2,3,6,0,1,3,4,1,7,9,17,8.5,9,1.0,M2018-11-25D,Race(6),,
11,0,0,2,2,0,0,0,0,0,0,0,0,0,0,2,2,21,21,0.0,M2018-11-25D,Race(6),,
12,2,3,3,8,2,0,0,2,3,1,0,4,7,4,3,14,8.5,9,2.0,M2018-11-25D,Race(6),,
13,0,0,0,0,0,0,0,0,0,0,2,2,0,0,2,2,20,21,0.0,M2018-11-25D,Race(6),,
14,0,0,0,0,0,0,0,0,0,0,0,0,0,0,0,0,34,34,0.0,M2018-11-25D,Race(6),,
1,0,3,0,3,0,0,8,8,0,0,1,1,0,3,9,12,26,26,0.0,M2018-11-25D,Race(7),,
2,0,0,0,0,0,0,0,0,0,0,0,0,0,0,0,0,41,34,0.0,M2018-11-25D,Race(7),,
3,4,8,6,18,2,12,4,18,1,10,5,16,7,30,15,52,6,6,0.0,M2018-11-25D,Race(7),,
4,7,2,3,12,14,5,2,21,16,3,3,22,37,10,8,55,3.6,3.5,3.0,M2018-11-25D,Race(7),,
5,0,0,0,0,0,0,0,0,0,0,0,0,0,0,0,0,51,41,0.0,M2018-11-25D,Race(7),,
6,0,0,0,0,0,0,0,0,0,0,0,0,0,0,0,0,26,26,0.0,M2018-11-25D,Race(7),,
7,0,4,2,6,2,8,2,12,3,1,2,6,5,13,6,24,10,11,2.0,M2018-11-25D,Race(7),,
8,0,0,0,0,0,0,0,0,0,0,0,0,0,0,0,0,0,0,0.0,M2018-11-25D,Race(7),,
9,11,6,4,21,0,2,8,10,1,9,8,18,12,17,20,49,6,6,1.0,M2018-11-25D,Race(7),,
10,2,3,4,9,8,1,2,11,0,1,4,5,10,5,10,25,12,11,0.0,M2018-11-25D,Race(7),,
11,0,0,0,0,0,0,0,0,0,0,0,0,0,0,0,0,11,11,0.0,M2018-11-25D,Race(7),,
12,0,0,0,0,0,0,0,0,0,0,0,0,0,0,0,0,51,41,0.0,M2018-11-25D,Race(7),,
13,6,4,11,21,4,2,4,10,5,2,3,10,15,8,18,41,4.2,4.2,0.0,M2018-11-25D,Race(7),,
1,0,0,0,0,0,0,0,0,0,0,0,0,0,0,0,0,71,67,0.0,M2018-11-25D,Race(8),,
2,0,9,5,14,4,2,8,14,4,4,5,13,8,15,18,41,6,6,3.0,M2018-11-25D,Race(8),,
3,0,5,4,9,2,10,8,20,5,8,3,16,7,23,15,45,8.5,9,0.0,M2018-11-25D,Race(8),,
4,2,0,0,2,1,1,2,4,1,1,2,4,4,2,4,10,13,15,0.0,M2018-11-25D,Race(8),,
5,0,2,2,4,2,1,0,3,3,3,1,7,5,6,3,14,12,11,0.0,M2018-11-25D,Race(8),,
6,0,4,2,6,1,2,5,8,0,2,3,5,1,8,10,19,15,15,0.0,M2018-11-25D,Race(8),,
7,18,7,5,30,12,4,2,18,12,5,2,19,42,16,9,67,3,3,2.0,M2018-11-25D,Race(8),,
8,2,0,6,8,0,8,0,8,0,1,2,3,2,9,8,19,8.5,9,1.0,M2018-11-25D,Race(8),,
9,3,0,0,3,0,0,0,0,0,0,3,3,3,0,3,6,8.5,9,0.0,M2018-11-25D,Race(8),,
10,0,0,0,0,0,0,0,0,0,0,0,0,0,0,0,0,51,51,0.0,M2018-11-25D,Race(8),,
11,0,0,3,3,0,1,1,2,0,0,2,2,0,1,6,7,15,15,0.0,M2018-11-25D,Race(8),,
12,5,3,3,11,8,1,4,13,1,2,3,6,14,6,10,30,8.5,8,0.0,M2018-11-25D,Race(8),,
1,5,2,5,12,0,5,4,9,1,2,3,6,6,9,12,27,7.5,7,0.0,M2018-11-25D,Race(9),,
2,2,3,2,7,8,1,3,12,4,1,1,6,14,5,6,25,12,11,0.0,M2018-11-25D,Race(9),,
3,0,0,0,0,0,0,0,0,1,0,0,1,1,0,0,1,81,101,0.0,M2018-11-25D,Race(9),,
4,5,2,0,7,0,8,2,10,0,2,5,7,5,12,7,24,18,17,0.0,M2018-11-25D,Race(9),,
5,8,3,4,15,5,5,3,13,6,8,5,19,19,16,12,47,3.6,4,0.0,M2018-11-25D,Race(9),,
6,0,0,0,0,0,0,0,0,0,0,0,0,0,0,0,0,61,81,0.0,M2018-11-25D,Race(9),,
7,0,0,0,0,0,0,8,8,0,0,3,3,0,0,11,11,21,21,0.0,M2018-11-25D,Race(9),,
8,0,0,0,0,0,0,0,0,0,1,0,1,0,1,0,1,12,11,0.0,M2018-11-25D,Race(9),,
9,0,0,6,6,0,0,0,0,0,0,0,0,0,0,6,6,15,15,0.0,M2018-11-25D,Race(9),,
10,0,0,2,2,3,5,1,9,4,2,0,6,7,7,3,17,17,17,0.0,M2018-11-25D,Race(9),,
11,0,2,0,2,0,0,0,0,0,0,0,0,0,2,0,2,12,11,3.0,M2018-11-25D,Race(9),,
12,0,3,3,6,1,3,4,8,1,4,4,9,2,10,11,23,10,11,0.0,M2018-11-25D,Race(9),,
13,3,2,6,11,2,1,1,4,2,2,2,6,7,5,9,21,8,9,1.0,M2018-11-25D,Race(9),,
14,7,13,2,22,11,2,4,17,7,4,3,14,25,19,9,53,7.5,7,2.0,M2018-11-25D,Race(9),,
1,2,8,0,10,1,1,0,2,1,2,1,4,4,11,1,16,8,8,2.0,M2018-11-28D,Race(1),,
2,0,2,8,10,2,6,13,21,4,5,6,15,6,13,27,46,12,12,0.0,M2018-11-28D,Race(1),,
3,0,2,3,5,0,0,0,0,0,1,0,1,0,3,3,6,9,9,0.0,M2018-11-28D,Race(1),,
4,20,5,0,25,22,5,1,28,12,4,2,18,54,14,3,71,2.6,2.7,1.0,M2018-11-28D,Race(1),,
5,2,0,2,4,0,1,0,1,0,1,0,1,2,2,2,6,8,8,0.0,M2018-11-28D,Race(1),,
6,6,8,5,19,2,14,7,23,7,7,4,18,15,29,16,60,5,5,3.0,M2018-11-28D,Race(1),,
7,0,2,8,10,2,1,1,4,2,3,0,5,4,6,9,19,15,15,0.0,M2018-11-28D,Race(1),,
8,0,0,0,0,0,0,0,0,0,1,1,2,0,1,1,2,26,26,0.0,M2018-11-28D,Race(1),,
9,0,0,0,0,0,0,0,0,0,0,0,0,0,0,0,0,34,34,0.0,M2018-11-28D,Race(1),,
10,0,0,4,4,1,1,3,5,0,1,5,6,1,2,12,15,15,15,0.0,M2018-11-28D,Race(1),,
11,0,0,0,0,0,0,0,0,0,0,0,0,0,0,0,0,34,34,0.0,M2018-11-28D,Race(1),,
12,0,3,0,3,0,0,0,0,0,0,1,1,0,3,1,4,17,17,0.0,M2018-11-28D,Race(1),,
1,0,0,0,0,0,2,1,3,0,0,0,0,0,2,1,3,11,11,0.0,M2018-11-28D,Race(2),,
2,5,0,0,5,0,0,0,0,0,0,0,0,5,0,0,5,34,34,0.0,M2018-11-28D,Race(2),,
3,6,0,0,6,0,2,3,5,0,1,3,4,6,3,6,15,11,11,0.0,M2018-11-28D,Race(2),,
4,0,0,0,0,0,0,0,0,0,1,0,1,0,1,0,1,34,34,0.0,M2018-11-28D,Race(2),,
5,0,12,6,18,8,13,5,26,9,5,4,18,17,30,15,62,5,5,1.0,M2018-11-28D,Race(2),,
6,3,8,5,16,1,1,3,5,1,1,4,6,5,10,12,27,7.5,7.5,0.0,M2018-11-28D,Race(2),,
7,16,5,6,27,19,7,3,29,15,10,1,26,50,22,10,82,2.4,2.4,3.0,M2018-11-28D,Race(2),,
8,0,2,3,5,1,3,12,16,1,8,7,16,2,13,22,37,12,12,0.0,M2018-11-28D,Race(2),,
9,0,0,0,0,0,0,2,2,0,0,1,1,0,0,3,3,14,14,0.0,M2018-11-28D,Race(2),,
10,0,3,10,13,1,2,0,3,0,0,2,2,1,5,12,18,13,13,2.0,M2018-11-28D,Race(2),,
11,0,0,0,0,0,0,0,0,0,0,2,2,0,0,2,2,26,26,0.0,M2018-11-28D,Race(2),,
12,0,0,0,0,0,0,1,1,0,0,2,2,0,0,3,3,26,26,0.0,M2018-11-28D,Race(2),,
1,7,0,13,20,7,12,5,24,5,7,2,14,19,19,20,58,3.3,3.3,0.0,M2018-11-28D,Race(3),,
2,11,12,5,28,14,8,4,26,9,4,6,19,34,24,15,73,4,4,0.0,M2018-11-28D,Race(3),,
3,0,2,2,4,3,3,0,6,6,5,1,12,9,10,3,22,12,12,0.0,M2018-11-28D,Race(3),,
4,0,3,2,5,0,0,5,5,0,0,3,3,0,3,10,13,13,13,0.0,M2018-11-28D,Race(3),,
5,0,6,5,11,1,2,12,15,1,2,7,10,2,10,24,36,7.5,7.5,2.0,M2018-11-28D,Race(3),,
6,0,0,0,0,0,0,0,0,0,0,1,1,0,0,1,1,26,26,0.0,M2018-11-28D,Race(3),,
7,0,2,0,2,1,0,1,2,0,2,2,4,1,4,3,8,10,10,3.0,M2018-11-28D,Race(3),,
8,10,5,3,18,4,4,2,10,3,4,3,10,17,13,8,38,4.4,4.4,0.0,M2018-11-28D,Race(3),,
9,2,0,0,2,0,1,1,2,2,2,1,5,4,3,2,9,12,12,1.0,M2018-11-28D,Race(3),,
1,3,0,7,10,0,2,0,2,1,1,0,2,4,3,7,14,13,13,1.0,M2018-11-28D,Race(4),,
2,12,3,5,20,16,7,3,26,4,8,3,15,32,18,11,61,4.4,4.4,0.0,M2018-11-28D,Race(4),,
3,0,0,0,0,0,0,0,0,1,0,1,2,1,0,1,2,18,18,2.0,M2018-11-28D,Race(4),,
4,5,10,5,20,4,2,12,18,5,3,4,12,14,15,21,50,7,7,0.0,M2018-11-28D,Race(4),,
5,5,7,3,15,6,3,4,13,5,5,4,14,16,15,11,42,4,4,0.0,M2018-11-28D,Race(4),,
6,3,3,8,14,3,15,7,25,8,8,2,18,14,26,17,57,3.8,3.8,0.0,M2018-11-28D,Race(4),,
7,2,0,0,2,0,0,0,0,0,0,0,0,2,0,0,2,26,26,0.0,M2018-11-28D,Race(4),,
8,0,0,0,0,0,0,0,0,0,0,0,0,0,0,0,0,31,31,3.0,M2018-11-28D,Race(4),,
9,0,3,2,5,1,0,1,2,1,0,3,4,2,3,6,11,16,16,0.0,M2018-11-28D,Race(4),,
10,0,0,0,0,0,0,0,0,0,0,0,0,0,0,0,0,34,34,0.0,M2018-11-28D,Race(4),,
11,0,4,0,4,0,1,1,2,0,1,6,7,0,6,7,13,15,15,0.0,M2018-11-28D,Race(4),,
12,0,0,0,0,0,0,2,2,1,0,3,4,1,0,5,6,19,19,0.0,M2018-11-28D,Race(4),,
1,0,4,8,12,2,0,1,3,0,0,5,5,2,4,14,20,10,10,0.0,M2018-11-28D,Race(5),,
2,16,5,2,23,17,7,1,25,10,3,3,16,43,15,6,64,3.1,3.1,3.0,M2018-11-28D,Race(5),,
3,0,0,0,0,0,1,0,1,0,1,0,1,0,2,0,2,17,17,0.0,M2018-11-28D,Race(5),,
4,2,0,0,2,6,12,8,26,8,7,5,20,16,19,13,48,8.5,8.5,0.0,M2018-11-28D,Race(5),,
5,2,0,0,2,0,0,2,2,0,0,1,1,2,0,3,5,13,13,0.0,M2018-11-28D,Race(5),,
6,0,0,3,3,0,1,1,2,0,2,2,4,0,3,6,9,19,19,0.0,M2018-11-28D,Race(5),,
7,3,5,2,10,2,1,3,6,4,5,2,11,9,11,7,27,6,6,0.0,M2018-11-28D,Race(5),,
8,0,13,8,21,3,7,10,20,3,6,4,13,6,26,22,54,7,8.5,1.0,M2018-11-28D,Race(5),,
9,0,0,7,7,0,1,1,2,0,1,1,2,0,2,9,11,12,12,2.0,M2018-11-28D,Race(5),,
10,0,0,0,0,0,0,0,0,0,0,0,0,0,0,0,0,15,15,0.0,M2018-11-28D,Race(5),,
11,7,3,0,10,0,0,3,3,1,1,3,5,8,4,6,18,7.5,7.5,0.0,M2018-11-28D,Race(5),,
1,0,0,2,2,0,2,4,6,0,1,1,2,0,3,7,10,15,15,0.0,M2018-11-28D,Race(6),,
2,8,8,9,25,14,7,4,25,5,8,5,18,27,23,18,68,7,7,0.0,M2018-11-28D,Race(6),,
3,0,0,6,6,1,0,1,2,0,0,2,2,1,0,9,10,16,16,0.0,M2018-11-28D,Race(6),,
4,17,6,3,26,6,5,10,21,10,10,2,22,33,21,15,69,2.4,2.4,2.0,M2018-11-28D,Race(6),,
5,3,9,7,19,7,11,3,21,8,4,2,14,18,24,12,54,6.5,6.5,0.0,M2018-11-28D,Race(6),,
6,0,0,0,0,0,0,0,0,0,0,0,0,0,0,0,0,9.5,9,0.0,M2018-11-28D,Race(6),,
7,0,2,0,2,0,2,0,2,0,0,1,1,0,4,1,5,19,19,0.0,M2018-11-28D,Race(6),,
8,0,0,3,3,0,0,2,2,0,0,0,0,0,0,5,5,19,19,0.0,M2018-11-28D,Race(6),,
9,0,5,0,5,1,1,1,3,0,1,6,7,1,7,7,15,10,10,1.0,M2018-11-28D,Race(6),,
10,0,0,0,0,0,0,0,0,0,0,0,0,0,0,0,0,51,51,0.0,M2018-11-28D,Race(6),,
11,0,0,0,0,0,0,0,0,0,0,0,0,0,0,0,0,34,34,0.0,M2018-11-28D,Race(6),,
12,2,0,0,2,1,0,4,5,1,0,2,3,4,0,6,10,10,10,3.0,M2018-11-28D,Race(6),,
1,2,14,5,21,2,13,4,19,3,7,4,14,7,34,13,54,5.5,5.5,0.0,M2018-11-28D,Race(7),,
2,0,2,0,2,1,4,3,8,1,1,5,7,2,7,8,17,8.5,8.5,0.0,M2018-11-28D,Race(7),,
3,11,7,9,27,17,4,5,26,14,4,3,21,42,15,17,74,3.5,3.5,0.0,M2018-11-28D,Race(7),,
4,0,0,0,0,0,0,0,0,0,0,0,0,0,0,0,0,34,34,0.0,M2018-11-28D,Race(7),,
5,0,0,3,3,1,0,1,2,1,1,2,4,2,1,6,9,18,18,0.0,M2018-11-28D,Race(7),,
6,0,0,0,0,0,3,2,5,0,5,4,9,0,8,6,14,13,13,0.0,M2018-11-28D,Race(7),,
7,0,0,0,0,0,0,1,1,0,1,0,1,0,1,1,2,21,21,2.0,M2018-11-28D,Race(7),,
8,9,3,10,22,7,5,10,22,3,6,4,13,19,14,24,57,3.8,3.8,3.0,M2018-11-28D,Race(7),,
9,3,4,3,10,2,0,0,2,4,0,1,5,9,4,4,17,7.5,7.5,1.0,M2018-11-28D,Race(7),,
10,5,0,0,5,0,1,4,5,0,1,3,4,5,2,7,14,15,15,0.0,M2018-11-28D,Race(7),,
11,0,0,0,0,0,0,0,0,0,0,0,0,0,0,0,0,26,26,0.0,M2018-11-28D,Race(7),,
1,2,0,8,10,0,0,1,1,0,1,1,2,2,1,10,13,11,11,1.0,M2018-11-28D,Race(8),,
2,0,0,0,0,0,0,1,1,0,0,1,1,0,0,2,2,26,26,0.0,M2018-11-28D,Race(8),,
3,0,3,2,5,0,1,3,4,1,0,5,6,1,4,10,15,8,8,0.0,M2018-11-28D,Race(8),,
4,5,6,6,17,8,15,4,27,13,9,1,23,26,30,11,67,6.5,6.5,0.0,M2018-11-28D,Race(8),,
5,0,0,0,0,0,0,0,0,0,0,0,0,0,0,0,0,21,21,0.0,M2018-11-28D,Race(8),,
6,6,5,0,11,1,5,16,22,0,6,7,13,7,16,23,46,9,9,3.0,M2018-11-28D,Race(8),,
7,0,0,8,8,1,0,0,1,2,1,2,5,3,1,10,14,15,15,0.0,M2018-11-28D,Race(8),,
8,0,0,0,0,0,0,0,0,0,0,0,0,0,0,0,0,34,34,0.0,M2018-11-28D,Race(8),,
9,17,11,0,28,19,6,3,28,10,6,6,22,46,23,9,78,2.2,2.2,2.0,M2018-11-28D,Race(8),,
10,0,0,0,0,0,1,0,1,0,0,0,0,0,1,0,1,41,41,0.0,M2018-11-28D,Race(8),,
11,0,5,6,11,1,2,2,5,0,3,3,6,1,10,11,22,8,8,0.0,M2018-11-28D,Race(8),,
12,0,0,0,0,0,0,0,0,0,0,0,0,0,0,0,0,34,34,0.0,M2018-11-28D,Race(8),,
1,7,6,4,17,8,9,2,19,0,4,5,9,15,19,11,45,10,10,0.0,M2018-12-02D,Race(1),,
2,4,5,6,15,2,1,9,12,3,0,3,6,9,6,18,33,12,12,0.0,M2018-12-02D,Race(1),,
3,11,4,6,21,14,3,4,21,14,5,4,23,39,12,14,65,2.45,2.5,1.0,M2018-12-02D,Race(1),,
4,0,0,5,5,0,0,0,0,0,1,0,1,0,1,5,6,10,10,0.0,M2018-12-02D,Race(1),,
5,0,0,0,0,0,8,0,8,1,2,1,4,1,10,1,12,8,8,0.0,M2018-12-02D,Race(1),,
6,5,4,4,13,2,1,0,3,2,3,3,8,9,8,7,24,8.5,8.5,2.0,M2018-12-02D,Race(1),,
7,3,5,2,10,2,5,7,14,4,7,3,14,9,17,12,38,6,6,0.0,M2018-12-02D,Race(1),,
8,0,6,3,9,2,2,8,12,2,3,7,12,4,11,18,33,6,6,3.0,M2018-12-02D,Race(1),,
9,0,0,0,0,0,1,0,1,0,1,0,1,0,2,0,2,26,26,0.0,M2018-12-02D,Race(1),,
1,0,6,9,15,5,6,5,16,4,7,5,16,9,19,19,47,6.5,6.5,1.0,M2018-12-02D,Race(10),,
2,3,0,6,9,8,3,3,14,4,5,2,11,15,8,11,34,8.5,8.5,0.0,M2018-12-02D,Race(10),,
3,13,4,5,22,10,1,2,13,11,2,3,16,34,7,10,51,4.8,5,3.0,M2018-12-02D,Race(10),,
4,0,0,0,0,0,0,0,0,0,0,0,0,0,0,0,0,34,34,0.0,M2018-12-02D,Race(10),,
5,0,5,2,7,0,2,4,6,0,2,4,6,0,9,10,19,12,12,0.0,M2018-12-02D,Race(10),,
6,0,0,0,0,0,0,0,0,0,1,1,2,0,1,1,2,10,10,0.0,M2018-12-02D,Race(10),,
7,0,2,0,2,0,0,0,0,0,0,0,0,0,2,0,2,12,12,0.0,M2018-12-02D,Race(10),,
8,0,0,3,3,0,0,2,2,0,0,0,0,0,0,5,5,13,13,0.0,M2018-12-02D,Race(10),,
9,0,0,0,0,0,0,8,8,0,0,0,0,0,0,8,8,17,51,0.0,M2018-12-02D,Race(10),,
10,0,5,3,8,2,4,1,7,3,5,1,9,5,14,5,24,11,10,0.0,M2018-12-02D,Race(10),,
11,5,6,2,13,5,2,4,11,4,2,6,12,14,10,12,36,6.5,6.5,2.0,M2018-12-02D,Race(10),,
12,4,0,0,4,0,9,2,11,0,0,2,2,4,9,4,17,13,13,0.0,M2018-12-02D,Race(10),,
13,0,0,0,0,0,0,0,0,0,0,0,0,0,0,0,0,61,51,0.0,M2018-12-02D,Race(10),,
14,5,2,0,7,0,0,3,3,0,2,2,4,5,4,5,14,12,12,0.0,M2018-12-02D,Race(10),,
1,9,6,12,27,10,10,1,21,14,9,0,23,33,25,13,71,3.5,3.5,1.0,M2018-12-02D,Race(2),,
2,3,4,6,13,1,9,5,15,0,3,8,11,4,16,19,39,6.5,6.5,3.0,M2018-12-02D,Race(2),,
3,0,0,0,0,0,0,0,0,0,0,0,0,0,0,0,0,51,51,0.0,M2018-12-02D,Race(2),,
4,0,0,0,0,0,0,0,0,0,0,0,0,0,0,0,0,71,67,0.0,M2018-12-02D,Race(2),,
5,13,15,0,28,8,9,5,22,9,11,3,23,30,35,8,73,2.5,2.5,2.0,M2018-12-02D,Race(2),,
6,0,0,0,0,8,0,2,10,1,0,6,7,9,0,8,17,15,15,0.0,M2018-12-02D,Race(2),,
7,0,0,0,0,0,0,0,0,0,0,0,0,0,0,0,0,26,26,0.0,M2018-12-02D,Race(2),,
8,2,5,10,17,3,2,7,12,2,3,4,9,7,10,21,38,6.5,6.5,0.0,M2018-12-02D,Race(2),,
9,0,0,0,0,0,0,2,2,0,0,3,3,0,0,5,5,12,12,0.0,M2018-12-02D,Race(2),,
10,3,0,0,3,0,0,8,8,0,0,2,2,3,0,10,13,23,23,0.0,M2018-12-02D,Race(2),,
11,0,0,2,2,0,0,0,0,0,0,0,0,0,0,2,2,26,26,0.0,M2018-12-02D,Race(2),,
1,5,11,7,23,6,6,5,17,1,3,7,11,12,20,19,51,4.8,4.8,2.0,M2018-12-02D,Race(3),,
2,11,5,2,18,3,6,3,12,5,8,1,14,19,19,6,44,6,6,1.0,M2018-12-02D,Race(3),,
3,3,3,10,16,7,4,5,16,10,5,1,16,20,12,16,48,6,6,0.0,M2018-12-02D,Race(3),,
4,9,5,3,17,2,3,2,7,3,5,1,9,14,13,6,33,5,5,3.0,M2018-12-02D,Race(3),,
5,0,0,0,0,0,2,2,4,2,2,2,6,2,4,4,10,11,11,0.0,M2018-12-02D,Race(3),,
6,0,0,0,0,0,0,0,0,0,0,0,0,0,0,0,0,31,31,0.0,M2018-12-02D,Race(3),,
7,2,2,0,4,8,1,1,10,1,3,1,5,11,6,2,19,13,13,0.0,M2018-12-02D,Race(3),,
8,0,0,5,5,4,0,4,8,2,0,11,13,6,0,20,26,6,6,0.0,M2018-12-02D,Race(3),,
9,0,4,3,7,0,0,8,8,2,0,2,4,2,4,13,19,7,7,0.0,M2018-12-02D,Race(3),,
10,0,0,0,0,0,8,0,8,0,0,0,0,0,8,0,8,21,21,0.0,M2018-12-02D,Race(3),,
1,0,4,0,4,1,6,3,10,2,3,1,6,3,13,4,20,12,12,0.0,M2018-12-02D,Race(4),,
2,2,0,2,4,1,1,4,6,0,4,4,8,3,5,10,18,9,9,0.0,M2018-12-02D,Race(4),,
3,0,5,0,5,8,1,2,11,1,2,3,6,9,8,5,22,8.5,8.5,0.0,M2018-12-02D,Race(4),,
4,6,2,7,15,1,5,4,10,3,3,2,8,10,10,13,33,7.5,7.5,0.0,M2018-12-02D,Race(4),,
5,3,3,0,6,0,1,3,4,1,0,2,3,4,4,5,13,15,15,0.0,M2018-12-02D,Race(4),,
6,0,3,5,8,0,8,0,8,0,3,0,3,0,14,5,19,12,12,1.0,M2018-12-02D,Race(4),,
7,17,3,6,26,16,4,2,22,17,3,5,25,50,10,13,73,3.5,3.5,0.0,M2018-12-02D,Race(4),,
8,2,0,0,2,0,0,0,0,0,1,0,1,2,1,0,3,51,51,3.0,M2018-12-02D,Race(4),,
9,0,0,0,0,0,0,1,1,1,1,1,3,1,1,2,4,14,14,0.0,M2018-12-02D,Race(4),,
10,0,3,10,13,3,4,3,10,1,6,8,15,4,13,21,38,8.5,8.5,0.0,M2018-12-02D,Race(4),,
11,0,7,0,7,0,0,0,0,0,0,0,0,0,7,0,7,6,6,2.0,M2018-12-02D,Race(4),,
12,0,0,0,0,0,0,8,8,0,0,0,0,0,0,8,8,26,27,0.0,M2018-12-02D,Race(4),,
1,19,4,5,28,15,3,3,21,20,6,0,26,54,13,8,75,2.8,2.8,1.0,M2018-12-02D,Race(5),,
2,0,0,4,4,0,0,0,0,0,0,0,0,0,0,4,4,10,10,0.0,M2018-12-02D,Race(5),,
3,0,3,5,8,0,0,8,8,0,0,0,0,0,3,13,16,12,12,3.0,M2018-12-02D,Race(5),,
4,0,0,0,0,0,8,0,8,0,0,0,0,0,8,0,8,81,81,0.0,M2018-12-02D,Race(5),,
5,4,3,2,9,9,1,8,18,4,9,8,21,17,13,18,48,5.5,5.5,2.0,M2018-12-02D,Race(5),,
6,0,5,0,5,0,0,3,3,0,0,4,4,0,5,7,12,11,11,0.0,M2018-12-02D,Race(5),,
7,3,9,3,15,0,2,0,2,0,0,3,3,3,11,6,20,7,7,0.0,M2018-12-02D,Race(5),,
8,0,0,0,0,0,0,1,1,0,0,0,0,0,0,1,1,31,31,0.0,M2018-12-02D,Race(5),,
9,2,6,6,14,0,3,0,3,1,4,1,6,3,13,7,23,15,15,0.0,M2018-12-02D,Race(5),,
10,0,0,5,5,0,0,2,2,1,4,7,12,1,4,14,19,7.5,7.5,0.0,M2018-12-02D,Race(5),,
11,0,0,0,0,0,0,4,4,0,3,3,6,0,3,7,10,16,16,0.0,M2018-12-02D,Race(5),,
12,2,0,0,2,0,0,0,0,0,0,0,0,2,0,0,2,31,31,0.0,M2018-12-02D,Race(5),,
1,14,5,6,25,0,0,0,0,6,10,0,16,20,15,6,41,2.8,2.8,2.0,M2018-12-02D,Race(6),,
2,7,13,2,22,8,7,2,17,14,7,1,22,29,27,5,61,5.5,5.5,0.0,M2018-12-02D,Race(6),,
3,3,3,6,12,10,9,3,22,2,6,6,14,15,18,15,48,5,5,0.0,M2018-12-02D,Race(6),,
4,0,0,0,0,1,2,8,11,0,0,1,1,1,2,9,12,81,81,0.0,M2018-12-02D,Race(6),,
5,0,0,3,3,0,0,0,0,0,0,0,0,0,0,3,3,17,17,0.0,M2018-12-02D,Race(6),,
6,0,0,0,0,8,1,1,10,0,0,1,1,8,1,2,11,41,41,0.0,M2018-12-02D,Race(6),,
7,0,0,0,0,0,0,0,0,0,0,3,3,0,0,3,3,21,21,3.0,M2018-12-02D,Race(6),,
8,6,2,11,19,1,0,0,1,3,2,7,12,10,4,18,32,5,5,0.0,M2018-12-02D,Race(6),,
9,0,0,0,0,2,3,5,10,0,0,1,1,2,3,6,11,34,34,0.0,M2018-12-02D,Race(6),,
10,0,2,0,2,0,0,0,0,1,1,5,7,1,3,5,9,11,11,1.0,M2018-12-02D,Race(6),,
11,0,5,2,7,0,8,3,11,0,0,1,1,0,13,6,19,12,12,0.0,M2018-12-02D,Race(6),,
12,0,0,0,0,0,0,8,8,0,0,0,0,0,0,8,8,81,81,0.0,M2018-12-02D,Race(6),,
1,9,8,9,26,8,4,4,16,7,5,4,16,24,17,17,58,4.2,4.2,2.0,M2018-12-02D,Race(7),,
2,2,0,2,4,2,2,3,7,4,0,0,4,8,2,5,15,13,13,0.0,M2018-12-02D,Race(7),,
3,0,0,2,2,0,0,0,0,1,0,0,1,1,0,2,3,34,34,0.0,M2018-12-02D,Race(7),,
4,0,0,3,3,0,0,0,0,0,0,0,0,0,0,3,3,13,13,0.0,M2018-12-02D,Race(7),,
5,14,7,3,24,8,7,8,23,11,7,4,22,33,21,15,69,4.6,4.6,1.0,M2018-12-02D,Race(7),,
6,3,3,3,9,4,8,7,19,1,10,8,19,8,21,18,47,6.5,6.5,3.0,M2018-12-02D,Race(7),,
7,0,0,0,0,0,0,0,0,0,0,0,0,0,0,0,0,61,61,0.0,M2018-12-02D,Race(7),,
8,0,8,0,8,8,0,0,8,2,1,0,3,10,9,0,19,9,9,0.0,M2018-12-02D,Race(7),,
9,0,0,0,0,0,0,0,0,0,1,0,1,0,1,0,1,34,34,0.0,M2018-12-02D,Race(7),,
10,2,0,3,5,0,1,4,5,0,2,3,5,2,3,10,15,5.5,5.5,0.0,M2018-12-02D,Race(7),,
11,0,4,2,6,0,8,3,11,0,0,5,5,0,12,10,22,12,12,0.0,M2018-12-02D,Race(7),,
12,0,0,3,3,0,0,11,11,0,0,2,2,0,0,16,16,12,12,0.0,M2018-12-02D,Race(7),,
1,0,0,3,3,0,0,0,0,0,0,0,0,0,0,3,3,16,16,1.0,M2018-12-02D,Race(8),,
2,0,3,5,8,0,0,8,8,1,0,1,2,1,3,14,18,9,9,0.0,M2018-12-02D,Race(8),,
3,6,4,10,20,2,5,4,11,3,8,3,14,11,17,17,45,5,5,0.0,M2018-12-02D,Race(8),,
4,0,0,0,0,0,0,0,0,0,0,0,0,0,0,0,0,16,16,0.0,M2018-12-02D,Race(8),,
5,0,2,2,4,0,2,3,5,2,2,3,7,2,6,8,16,10,10,0.0,M2018-12-02D,Race(8),,
6,7,5,5,17,0,6,3,9,10,7,4,21,17,18,12,47,5,5,0.0,M2018-12-02D,Race(8),,
7,12,11,5,28,8,4,9,21,9,5,8,22,29,20,22,71,3.3,3.3,2.0,M2018-12-02D,Race(8),,
8,5,0,0,5,8,2,0,10,0,0,0,0,13,2,0,15,9,9,0.0,M2018-12-02D,Race(8),,
9,0,3,0,3,0,0,1,1,0,0,4,4,0,3,5,8,11,15,3.0,M2018-12-02D,Race(8),,
10,0,0,0,0,0,8,0,8,0,0,0,0,0,8,0,8,21,21,0.0,M2018-12-02D,Race(8),,
11,0,2,0,2,0,0,0,0,0,0,0,0,0,2,0,2,31,31,0.0,M2018-12-02D,Race(8),,
1,0,0,3,3,0,1,0,1,0,0,0,0,0,1,3,4,26,26,0.0,M2018-12-02D,Race(9),,
2,0,7,2,9,0,2,4,6,0,2,4,6,0,11,10,21,15,15,2.0,M2018-12-02D,Race(9),,
3,30,0,0,30,21,2,0,23,24,2,0,26,75,4,0,79,1.9,1.9,3.0,M2018-12-02D,Race(9),,
4,0,6,3,9,9,8,3,20,2,7,3,12,11,21,9,41,9,9,0.0,M2018-12-02D,Race(9),,
5,0,0,5,5,0,3,6,9,0,2,2,4,0,5,13,18,14,14,0.0,M2018-12-02D,Race(9),,
6,0,0,0,0,0,8,0,8,0,0,0,0,0,8,0,8,31,31,0.0,M2018-12-02D,Race(9),,
7,0,0,2,2,0,2,2,4,0,0,2,2,0,2,6,8,9,9,0.0,M2018-12-02D,Race(9),,
8,0,0,0,0,0,1,0,1,0,5,0,5,0,6,0,6,21,21,0.0,M2018-12-02D,Race(9),,
9,0,11,5,16,0,0,3,3,0,2,4,6,0,13,12,25,13,13,1.0,M2018-12-02D,Race(9),,
10,0,0,7,7,0,0,2,2,0,2,5,7,0,2,14,16,11,11,0.0,M2018-12-02D,Race(9),,
11,0,3,0,3,0,2,8,10,0,2,2,4,0,7,10,17,17,17,0.0,M2018-12-02D,Race(9),,
12,0,3,3,6,0,1,2,3,0,2,4,6,0,6,9,15,15,15,0.0,M2018-12-02D,Race(9),,
1,0,2,0,2,8,2,2,12,4,3,2,9,12,7,4,23,15,15,0.0,M2018-12-05D,Race(1),,
2,0,0,7,7,2,8,1,11,1,0,1,2,3,8,9,20,12,12,1.0,M2018-12-05D,Race(1),,
3,3,6,9,18,2,4,5,11,9,3,5,17,14,13,19,46,5,5,0.0,M2018-12-05D,Race(1),,
4,0,0,0,0,0,0,0,0,0,0,0,0,0,0,0,0,101,101,0.0,M2018-12-05D,Race(1),,
5,13,10,3,26,13,5,2,20,9,9,3,21,35,24,8,67,2.3,2.3,2.0,M2018-12-05D,Race(1),,
6,2,3,0,5,0,0,1,1,0,1,0,1,2,4,1,7,26,26,0.0,M2018-12-05D,Race(1),,
7,0,0,0,0,0,0,0,0,0,0,1,1,0,0,1,1,101,101,0.0,M2018-12-05D,Race(1),,
8,6,0,0,6,2,0,8,10,1,1,8,10,9,1,16,26,13,13,0.0,M2018-12-05D,Race(1),,
9,0,5,6,11,0,3,0,3,0,2,3,5,0,10,9,19,8.5,8.5,0.0,M2018-12-05D,Race(1),,
10,6,2,3,11,3,8,3,14,2,5,2,9,11,15,8,34,8.5,8.5,0.0,M2018-12-05D,Race(1),,
11,0,2,2,4,0,0,8,8,0,1,1,2,0,3,11,14,15,15,3.0,M2018-12-05D,Race(1),,
12,0,0,0,0,0,0,0,0,0,1,0,1,0,1,0,1,13,13,0.0,M2018-12-05D,Race(1),,
1,12,4,0,16,1,1,1,3,2,4,0,6,15,9,1,25,9,9,0.0,M2018-12-05D,Race(2),,
2,2,13,5,20,5,2,5,12,6,2,6,14,13,17,16,46,5.5,5.5,0.0,M2018-12-05D,Race(2),,
3,2,0,2,4,7,4,6,17,7,3,7,17,16,7,15,38,8.5,8.5,2.0,M2018-12-05D,Race(2),,
4,3,0,6,9,2,2,1,5,0,3,3,6,5,5,10,20,5.5,5.5,1.0,M2018-12-05D,Race(2),,
5,6,9,7,22,6,5,2,13,8,3,2,13,20,17,11,48,5,5,3.0,M2018-12-05D,Race(2),,
6,0,0,3,3,8,0,0,8,1,0,0,1,9,0,3,12,23,23,0.0,M2018-12-05D,Race(2),,
7,3,2,5,10,0,5,3,8,2,6,2,10,5,13,10,28,5,5,0.0,M2018-12-05D,Race(2),,
8,2,0,0,2,0,0,0,0,0,0,0,0,2,0,0,2,26,26,0.0,M2018-12-05D,Race(2),,
9,0,0,0,0,1,8,1,10,0,0,3,3,1,8,4,13,26,26,0.0,M2018-12-05D,Race(2),,
10,0,2,0,2,0,2,8,10,0,3,1,4,0,7,9,16,16,16,0.0,M2018-12-05D,Race(2),,
11,0,0,0,0,0,0,0,0,0,0,1,1,0,0,1,1,19,19,0.0,M2018-12-05D,Race(2),,
12,0,0,2,2,0,1,3,4,0,2,1,3,0,3,6,9,14,14,0.0,M2018-12-05D,Race(2),,
1,8,5,4,17,4,2,3,9,2,3,5,10,14,10,12,36,5,5,0.0,M2018-12-05D,Race(3),,
2,7,9,7,23,4,2,3,9,4,5,1,10,15,16,11,42,6,6,2.0,M2018-12-05D,Race(3),,
3,8,4,3,15,9,3,3,15,11,4,3,18,28,11,9,48,7.5,7,1.0,M2018-12-05D,Race(3),,
4,0,3,7,10,4,4,2,10,5,3,2,10,9,10,11,30,7.5,7,0.0,M2018-12-05D,Race(3),,
5,0,2,0,2,0,2,8,10,0,2,1,3,0,6,9,15,8,8,0.0,M2018-12-05D,Race(3),,
6,0,0,3,3,0,2,3,5,1,1,2,4,1,3,8,12,17,17,0.0,M2018-12-05D,Race(3),,
7,0,0,0,0,0,0,0,0,0,0,0,0,0,0,0,0,34,34,0.0,M2018-12-05D,Race(3),,
8,3,0,0,3,0,8,0,8,0,2,2,4,3,10,2,15,10,10,0.0,M2018-12-05D,Race(3),,
9,0,0,0,0,0,0,0,0,0,0,0,0,0,0,0,0,21,21,0.0,M2018-12-05D,Race(3),,
10,2,5,6,13,9,2,1,12,2,2,2,6,13,9,9,31,7,7,3.0,M2018-12-05D,Race(3),,
11,0,0,0,0,0,2,0,2,1,2,1,4,1,4,1,6,10,10,0.0,M2018-12-05D,Race(3),,
12,2,2,0,4,0,3,7,10,0,2,7,9,2,7,14,23,16,16,0.0,M2018-12-05D,Race(3),,
1,9,12,2,23,5,6,5,16,6,4,3,13,20,22,10,52,4.6,4.6,0.0,M2018-12-05D,Race(4),,
2,0,2,0,2,0,0,1,1,0,0,0,0,0,2,1,3,20,19,2.0,M2018-12-05D,Race(4),,
3,10,0,6,16,5,4,3,12,6,2,5,13,21,6,14,41,3.6,3.6,0.0,M2018-12-05D,Race(4),,
4,0,7,7,14,3,2,3,8,7,2,2,11,10,11,12,33,9.5,9,0.0,M2018-12-05D,Race(4),,
5,5,3,3,11,0,0,0,0,0,1,1,2,5,4,4,13,16,16,0.0,M2018-12-05D,Race(4),,
6,0,6,9,15,4,1,3,8,2,3,5,10,6,10,17,33,6,6,0.0,M2018-12-05D,Race(4),,
7,2,0,0,2,1,8,1,10,0,1,2,3,3,9,3,15,21,23,0.0,M2018-12-05D,Race(4),,
8,4,0,0,4,4,5,4,13,4,5,5,14,12,10,9,31,8,8,1.0,M2018-12-05D,Race(4),,
9,0,0,0,0,0,2,8,10,0,4,1,5,0,6,9,15,8.5,10,0.0,M2018-12-05D,Race(4),,
10,0,0,3,3,8,2,2,12,1,4,2,7,9,6,7,22,13,13,0.0,M2018-12-05D,Race(4),,
11,0,0,0,0,0,0,0,0,0,0,0,0,0,0,0,0,20,19,3.0,M2018-12-05D,Race(4),,
12,0,0,0,0,0,0,0,0,0,0,0,0,0,0,0,0,61,61,0.0,M2018-12-05D,Race(4),,
1,3,5,0,8,5,6,5,16,1,1,0,2,9,12,5,26,11,11,0.0,M2018-12-05D,Race(5),,
2,7,5,0,12,0,0,8,8,3,1,4,8,10,6,12,28,10,10,2.0,M2018-12-05D,Race(5),,
3,0,0,5,5,5,4,3,12,0,1,0,1,5,5,8,18,16,16,0.0,M2018-12-05D,Race(5),,
4,0,0,4,4,3,2,3,8,1,1,0,2,4,3,7,14,23,23,0.0,M2018-12-05D,Race(5),,
5,0,0,0,0,0,0,0,0,0,0,1,1,0,0,1,1,19,26,3.0,M2018-12-05D,Race(5),,
6,7,15,6,28,4,1,3,8,13,5,6,24,24,21,15,60,3,3,0.0,M2018-12-05D,Race(5),,
7,2,3,7,12,1,8,1,10,1,3,7,11,4,14,15,33,7,7,0.0,M2018-12-05D,Race(5),,
8,0,0,2,2,4,5,4,13,0,3,1,4,4,8,7,19,15,15,0.0,M2018-12-05D,Race(5),,
9,0,0,0,0,0,2,1,3,0,0,0,0,0,2,1,3,51,51,0.0,M2018-12-05D,Race(5),,
10,5,0,0,5,8,2,2,12,5,7,2,14,18,9,4,31,6.5,7,1.0,M2018-12-05D,Race(5),,
11,0,0,3,3,0,0,0,0,1,0,0,1,1,0,3,4,18,18,0.0,M2018-12-05D,Race(5),,
12,6,2,3,11,0,0,0,0,1,4,5,10,7,6,8,21,5,5,0.0,M2018-12-05D,Race(5),,
1,4,2,6,12,4,6,3,13,5,4,3,12,13,12,12,37,8,8,0.0,M2018-12-05D,Race(6),,
2,0,0,2,2,1,4,2,7,0,2,1,3,1,6,5,12,21,21,0.0,M2018-12-05D,Race(6),,
3,21,7,0,28,17,4,2,23,18,4,3,25,56,15,5,76,2,2,1.0,M2018-12-05D,Race(6),,
4,0,2,7,9,0,0,2,2,0,1,2,3,0,3,11,14,18,18,0.0,M2018-12-05D,Race(6),,
5,2,5,3,10,0,8,3,11,1,3,2,6,3,16,8,27,8,8,0.0,M2018-12-05D,Race(6),,
6,0,0,0,0,0,0,0,0,0,0,0,0,0,0,0,0,61,61,0.0,M2018-12-05D,Race(6),,
7,0,0,2,2,8,1,0,9,0,0,1,1,8,1,3,12,16,16,0.0,M2018-12-05D,Race(6),,
8,0,3,5,8,0,1,7,8,0,3,10,13,0,7,22,29,17,17,0.0,M2018-12-05D,Race(6),,
9,3,11,0,14,0,4,3,7,2,6,4,12,5,21,7,33,6,6,3.0,M2018-12-05D,Race(6),,
10,0,0,0,0,0,0,0,0,0,0,0,0,0,0,0,0,26,26,0.0,M2018-12-05D,Race(6),,
11,0,0,2,2,0,2,0,2,0,2,0,2,0,4,2,6,21,21,2.0,M2018-12-05D,Race(6),,
12,0,0,3,3,0,0,8,8,0,1,0,1,0,1,11,12,18,18,0.0,M2018-12-05D,Race(6),,
1,3,8,10,21,1,11,4,16,2,8,4,14,6,27,18,51,7,7,0.0,M2018-12-05D,Race(7),,
2,15,3,3,21,16,2,4,22,16,3,4,23,47,8,11,66,2.5,2.5,3.0,M2018-12-05D,Race(7),,
3,0,2,3,5,0,1,1,2,0,4,1,5,0,7,5,12,21,21,0.0,M2018-12-05D,Race(7),,
4,0,2,2,4,0,0,0,0,0,0,0,0,0,2,2,4,16,16,0.0,M2018-12-05D,Race(7),,
5,5,0,3,8,0,1,1,2,0,0,1,1,5,1,5,11,16,16,0.0,M2018-12-05D,Race(7),,
6,0,0,2,2,0,0,8,8,0,0,1,1,0,0,11,11,26,26,0.0,M2018-12-05D,Race(7),,
7,4,3,0,7,8,4,4,16,0,1,8,9,12,8,12,32,9,9,0.0,M2018-12-05D,Race(7),,
8,0,2,0,2,0,1,2,3,0,2,2,4,0,5,4,9,12,12,0.0,M2018-12-05D,Race(7),,
9,0,5,0,5,3,1,4,8,3,4,3,10,6,10,7,23,11,11,2.0,M2018-12-05D,Race(7),,
10,3,5,0,8,2,1,0,3,5,1,0,6,10,7,0,17,8,8,0.0,M2018-12-05D,Race(7),,
11,0,0,4,4,0,8,2,10,0,2,2,4,0,10,8,18,15,15,0.0,M2018-12-05D,Race(7),,
12,0,0,3,3,0,0,0,0,0,1,0,1,0,1,3,4,12,12,1.0,M2018-12-05D,Race(7),,
1,0,0,2,2,0,0,0,0,1,0,0,1,1,0,2,3,16,16,0.0,M2018-12-05D,Race(8),,
2,10,7,0,17,8,6,4,18,6,7,4,17,24,20,8,52,6.5,6,0.0,M2018-12-05D,Race(8),,
3,5,6,3,14,8,2,2,12,1,3,4,8,14,11,9,34,8,8,0.0,M2018-12-05D,Race(8),,
4,0,2,5,7,0,3,0,3,0,3,0,3,0,8,5,13,10,10,0.0,M2018-12-05D,Race(8),,
5,2,0,0,2,0,8,0,8,0,1,0,1,2,9,0,11,21,21,3.0,M2018-12-05D,Race(8),,
6,0,6,9,15,7,6,4,17,9,3,7,19,16,15,20,51,4.8,5,2.0,M2018-12-05D,Race(8),,
7,0,0,2,2,0,0,0,0,0,0,1,1,0,0,3,3,15,15,0.0,M2018-12-05D,Race(8),,
8,3,0,3,6,3,1,5,9,2,3,3,8,8,4,11,23,8,8,0.0,M2018-12-05D,Race(8),,
9,0,0,0,0,0,0,8,8,0,0,4,4,0,0,12,12,17,17,0.0,M2018-12-05D,Race(8),,
10,8,0,6,14,1,4,4,9,4,4,1,9,13,8,11,32,6.5,6,0.0,M2018-12-05D,Race(8),,
11,0,0,0,0,0,0,0,0,0,0,0,0,0,0,0,0,26,26,1.0,M2018-12-05D,Race(8),,
12,2,9,0,11,3,0,3,6,3,2,2,7,8,11,5,24,6.5,6,0.0,M2018-12-05D,Race(8),,
1,0,0,0,0,8,0,0,8,0,1,2,3,8,1,2,11,17,17,0.0,M2018-12-05D,Race(9),,
2,12,11,4,27,8,6,4,18,9,5,7,21,29,22,15,66,4.6,4.6,0.0,M2018-12-05D,Race(9),,
3,7,10,5,22,4,4,3,11,6,10,4,20,17,24,12,53,4.6,4.6,1.0,M2018-12-05D,Race(9),,
4,0,0,0,0,0,0,0,0,0,0,0,0,0,0,0,0,17,17,0.0,M2018-12-05D,Race(9),,
5,3,2,15,20,9,4,7,20,8,3,8,19,20,9,30,59,3.5,3.5,2.0,M2018-12-05D,Race(9),,
6,0,0,0,0,0,0,8,8,0,1,0,1,0,1,8,9,34,34,0.0,M2018-12-05D,Race(9),,
7,0,3,3,6,1,9,2,12,0,1,0,1,1,13,5,19,15,15,0.0,M2018-12-05D,Race(9),,
8,0,0,0,0,0,0,0,0,0,0,0,0,0,0,0,0,17,17,0.0,M2018-12-05D,Race(9),,
9,0,0,0,0,0,0,0,0,0,0,0,0,0,0,0,0,15,15,3.0,M2018-12-05D,Race(9),,
10,0,0,0,0,0,0,0,0,0,0,0,0,0,0,0,0,34,34,0.0,M2018-12-05D,Race(9),,
11,8,4,0,12,0,7,6,13,3,5,5,13,11,16,11,38,6,6,0.0,M2018-12-05D,Race(9),,
12,0,0,3,3,0,0,0,0,0,0,0,0,0,0,3,3,18,18,0.0,M2018-12-05D,Race(9),,
1,0,3,0,3,0,8,0,8,1,0,0,1,1,11,0,12,31,31,0.0,M2018-12-09D,Race(1),,
2,16,7,4,27,11,8,2,21,11,8,3,22,38,23,9,70,2.9,2.9,0.0,M2018-12-09D,Race(1),,
3,0,0,0,0,0,0,8,8,0,1,3,4,0,1,11,12,51,51,0.0,M2018-12-09D,Race(1),,
4,7,11,5,23,4,4,6,14,2,4,7,13,13,19,18,50,4,4,0.0,M2018-12-09D,Race(1),,
5,0,0,0,0,0,0,0,0,1,0,1,2,1,0,1,2,26,26,1.0,M2018-12-09D,Race(1),,
6,0,2,8,10,3,3,3,9,5,4,2,11,8,9,13,30,15,15,0.0,M2018-12-09D,Race(1),,
7,0,2,7,9,0,3,2,5,0,2,1,3,0,7,10,17,14,14,2.0,M2018-12-09D,Race(1),,
8,0,2,0,2,0,0,0,0,0,0,0,0,0,2,0,2,26,26,3.0,M2018-12-09D,Race(1),,
9,0,3,3,6,3,1,5,9,4,3,3,10,7,7,11,25,5,5,0.0,M2018-12-09D,Race(1),,
10,2,0,0,2,0,0,1,1,0,0,3,3,2,0,4,6,21,21,0.0,M2018-12-09D,Race(1),,
11,0,0,0,0,0,0,0,0,0,0,0,0,0,0,0,0,16,16,0.0,M2018-12-09D,Race(1),,
12,5,0,3,8,9,3,3,15,2,4,2,8,16,7,8,31,11,11,0.0,M2018-12-09D,Race(1),,
13,0,0,0,0,0,0,0,0,0,0,0,0,0,0,0,0,61,61,0.0,M2018-12-09D,Race(1),,
14,0,0,0,0,0,0,0,0,0,0,1,1,0,0,1,1,51,51,0.0,M2018-12-09D,Race(1),,
1,2,0,0,2,0,8,1,9,1,0,4,5,3,8,5,16,12,12,0.0,M2018-12-09D,Race(10),,
2,5,0,0,5,2,2,5,9,1,2,1,4,8,4,6,18,10,10,0.0,M2018-12-09D,Race(10),,
3,0,0,2,2,0,0,0,0,1,0,0,1,1,0,2,3,18,17,0.0,M2018-12-09D,Race(10),,
4,0,0,3,3,0,1,8,9,1,3,1,5,1,4,12,17,20,21,0.0,M2018-12-09D,Race(10),,
5,0,0,2,2,0,2,3,5,0,1,4,5,0,3,9,12,13,13,0.0,M2018-12-09D,Race(10),,
6,0,0,0,0,0,0,0,0,0,0,1,1,0,0,1,1,34,31,0.0,M2018-12-09D,Race(10),,
7,8,12,5,25,8,9,3,20,8,6,6,20,24,27,14,65,3.4,3.4,3.0,M2018-12-09D,Race(10),,
8,12,11,2,25,11,7,4,22,11,11,1,23,34,29,7,70,3.2,3.2,2.0,M2018-12-09D,Race(10),,
9,0,0,0,0,0,0,0,0,0,0,0,0,0,0,0,0,16,15,0.0,M2018-12-09D,Race(10),,
10,3,2,3,8,0,0,0,0,0,0,0,0,3,2,3,8,21,21,1.0,M2018-12-09D,Race(10),,
11,0,5,7,12,0,0,4,4,0,1,6,7,0,6,17,23,17,17,0.0,M2018-12-09D,Race(10),,
12,0,0,3,3,8,0,0,8,1,0,0,1,9,0,3,12,31,31,0.0,M2018-12-09D,Race(10),,
13,0,0,0,0,0,0,0,0,0,0,0,0,0,0,0,0,41,41,0.0,M2018-12-09D,Race(10),,
14,0,0,3,3,1,1,2,4,2,2,2,6,3,3,7,13,18,16,0.0,M2018-12-09D,Race(10),,
1,0,0,0,0,0,0,9,9,1,1,1,3,1,1,10,12,34,34,0.0,M2018-12-09D,Race(2),,
2,11,5,2,18,5,5,2,12,6,1,1,8,22,11,5,38,7.5,7.5,3.0,M2018-12-09D,Race(2),,
3,4,3,5,12,8,4,4,16,0,6,6,12,12,13,15,40,12,12,0.0,M2018-12-09D,Race(2),,
4,2,0,0,2,0,0,0,0,0,0,0,0,2,0,0,2,61,61,0.0,M2018-12-09D,Race(2),,
5,0,9,4,13,8,8,3,19,6,6,5,17,14,23,12,49,3.8,3.8,2.0,M2018-12-09D,Race(2),,
6,0,0,0,0,0,8,0,8,0,2,1,3,0,10,1,11,15,15,1.0,M2018-12-09D,Race(2),,
7,5,3,8,16,5,0,5,10,6,3,6,15,16,6,19,41,6.5,6.5,0.0,M2018-12-09D,Race(2),,
8,0,0,0,0,0,0,0,0,0,0,0,0,0,0,0,0,61,61,0.0,M2018-12-09D,Race(2),,
9,3,3,0,6,0,2,0,2,1,2,0,3,4,7,0,11,7.5,7.5,0.0,M2018-12-09D,Race(2),,
10,0,0,0,0,0,0,0,0,0,0,0,0,0,0,0,0,41,41,0.0,M2018-12-09D,Race(2),,
11,0,5,0,5,0,0,0,0,0,1,0,1,0,6,0,6,13,13,0.0,M2018-12-09D,Race(2),,
12,3,0,6,9,0,0,3,3,1,2,3,6,4,2,12,18,7.5,7.5,0.0,M2018-12-09D,Race(2),,
13,2,0,5,7,4,3,4,11,5,2,3,10,11,5,12,28,8.5,8.5,0.0,M2018-12-09D,Race(2),,
14,0,2,0,2,0,0,0,0,0,0,0,0,0,2,0,2,21,21,0.0,M2018-12-09D,Race(2),,
1,13,13,2,28,7,11,3,21,4,7,7,18,24,31,12,67,3.6,3.6,3.0,M2018-12-09D,Race(3),,
2,4,11,8,23,9,6,5,20,12,3,3,18,25,20,16,61,4.8,4.8,1.0,M2018-12-09D,Race(3),,
3,3,0,0,3,0,0,0,0,0,0,1,1,3,0,1,4,21,21,0.0,M2018-12-09D,Race(3),,
4,0,0,2,2,2,2,3,7,3,4,3,10,5,6,8,19,10,10,0.0,M2018-12-09D,Race(3),,
5,0,2,6,8,1,8,2,11,1,2,2,5,2,12,10,24,7,7,0.0,M2018-12-09D,Race(3),,
6,6,4,5,15,2,0,2,4,3,3,1,7,11,7,8,26,16,16,0.0,M2018-12-09D,Race(3),,
7,0,0,2,2,0,1,8,9,0,4,2,6,0,5,12,17,10,10,0.0,M2018-12-09D,Race(3),,
8,2,0,5,7,1,2,7,10,2,3,7,12,5,5,19,29,7,7,0.0,M2018-12-09D,Race(3),,
9,0,0,0,0,0,0,0,0,0,0,0,0,0,0,0,0,34,34,0.0,M2018-12-09D,Race(3),,
10,0,0,0,0,0,0,0,0,0,0,0,0,0,0,0,0,26,26,2.0,M2018-12-09D,Race(3),,
11,0,0,0,0,8,0,0,8,1,0,0,1,9,0,0,9,26,26,0.0,M2018-12-09D,Race(3),,
12,2,0,0,2,0,0,0,0,0,0,0,0,2,0,0,2,12,12,0.0,M2018-12-09D,Race(3),,
13,0,0,0,0,0,0,0,0,0,0,0,0,0,0,0,0,41,41,0.0,M2018-12-09D,Race(3),,
1,17,3,3,23,9,7,3,19,8,3,6,17,34,13,12,59,5,5,0.0,M2018-12-09D,Race(4),,
2,0,5,10,15,2,3,7,12,4,3,4,11,6,11,21,38,11,12,0.0,M2018-12-09D,Race(4),,
3,0,0,0,0,0,0,0,0,0,0,0,0,0,0,0,0,10,9,0.0,M2018-12-09D,Race(4),,
4,0,4,5,9,1,2,4,7,4,3,5,12,5,9,14,28,8.5,9,1.0,M2018-12-09D,Race(4),,
5,8,8,0,16,5,3,0,8,4,3,0,7,17,14,0,31,6.5,7.5,0.0,M2018-12-09D,Race(4),,
6,0,7,2,9,1,2,2,5,1,4,2,7,2,13,6,21,11,10,0.0,M2018-12-09D,Race(4),,
7,0,0,0,0,0,0,0,0,0,0,0,0,0,0,0,0,15,17,0.0,M2018-12-09D,Race(4),,
8,0,0,0,0,0,0,8,8,0,0,0,0,0,0,8,8,15,13,0.0,M2018-12-09D,Race(4),,
9,0,0,0,0,0,0,0,0,0,0,0,0,0,0,0,0,101,67,0.0,M2018-12-09D,Race(4),,
10,5,0,5,10,2,1,5,8,2,3,6,11,9,4,16,29,10,9,2.0,M2018-12-09D,Race(4),,
11,0,0,2,2,0,8,1,9,0,0,1,1,0,8,4,12,21,17,0.0,M2018-12-09D,Race(4),,
12,0,0,3,3,8,0,0,8,2,1,0,3,10,1,3,14,31,21,3.0,M2018-12-09D,Race(4),,
13,0,3,0,3,2,4,0,6,1,6,1,8,3,13,1,17,9,7.5,0.0,M2018-12-09D,Race(4),,
14,0,0,0,0,0,0,0,0,0,0,1,1,0,0,1,1,23,26,0.0,M2018-12-09D,Race(4),,
1,0,0,3,3,2,2,0,4,2,3,1,6,4,5,4,13,10,9,0.0,M2018-12-09D,Race(5),,
2,9,8,8,25,1,11,9,21,2,14,8,24,12,33,25,70,3.6,3.6,1.0,M2018-12-09D,Race(5),,
3,0,0,0,0,8,0,0,8,0,1,1,2,8,1,1,10,7.5,9,2.0,M2018-12-09D,Race(5),,
4,5,11,8,24,0,6,7,13,0,5,7,12,5,22,22,49,9,9,3.0,M2018-12-09D,Race(5),,
5,11,11,8,30,19,8,1,28,22,1,3,26,52,20,12,84,3,3,0.0,M2018-12-09D,Race(5),,
6,3,0,0,3,0,3,4,7,0,2,5,7,3,5,9,17,15,11,0.0,M2018-12-09D,Race(5),,
7,0,0,3,3,0,0,1,1,0,0,0,0,0,0,4,4,26,21,0.0,M2018-12-09D,Race(5),,
8,0,0,0,0,0,0,0,0,0,0,0,0,0,0,0,0,31,26,0.0,M2018-12-09D,Race(5),,
9,0,0,0,0,0,0,0,0,0,0,0,0,0,0,0,0,41,41,0.0,M2018-12-09D,Race(5),,
10,0,0,0,0,0,0,0,0,0,0,0,0,0,0,0,0,34,21,0.0,M2018-12-09D,Race(5),,
11,0,0,0,0,0,0,0,0,0,0,0,0,0,0,0,0,51,51,0.0,M2018-12-09D,Race(5),,
12,2,0,0,2,0,0,8,8,0,0,1,1,2,0,9,11,14,13,0.0,M2018-12-09D,Race(5),,
1,0,6,5,11,8,5,7,20,4,3,5,12,12,14,17,43,6,6,1.0,M2018-12-09D,Race(6),,
2,0,0,3,3,8,0,1,9,1,0,1,2,9,0,5,14,15,15,0.0,M2018-12-09D,Race(6),,
3,9,3,3,15,1,2,0,3,3,2,4,9,13,7,7,27,6,6,3.0,M2018-12-09D,Race(6),,
4,2,5,2,9,1,2,0,3,1,3,1,5,4,10,3,17,6.5,6.5,0.0,M2018-12-09D,Race(6),,
5,5,4,5,14,7,3,4,14,11,3,1,15,23,10,10,43,6.5,6.5,0.0,M2018-12-09D,Race(6),,
6,0,0,0,0,1,8,1,10,0,1,0,1,1,9,1,11,18,17,0.0,M2018-12-09D,Race(6),,
7,0,2,0,2,0,2,8,10,0,1,1,2,0,5,9,14,31,31,0.0,M2018-12-09D,Race(6),,
8,0,2,4,6,3,2,1,6,2,2,1,5,5,6,6,17,13,13,0.0,M2018-12-09D,Race(6),,
9,0,0,0,0,0,0,0,0,0,0,0,0,0,0,0,0,26,26,0.0,M2018-12-09D,Race(6),,
10,9,3,2,14,0,3,0,3,1,7,2,10,10,13,4,27,5.5,5.5,0.0,M2018-12-09D,Race(6),,
11,5,5,6,16,1,3,8,12,3,4,10,17,9,12,24,45,7.5,7.5,0.0,M2018-12-09D,Race(6),,
12,0,0,0,0,0,0,0,0,0,0,0,0,0,0,0,0,51,51,2.0,M2018-12-09D,Race(6),,
13,0,0,0,0,0,0,0,0,0,0,0,0,0,0,0,0,41,41,0.0,M2018-12-09D,Race(6),,
14,0,0,0,0,0,0,0,0,0,0,0,0,0,0,0,0,41,41,0.0,M2018-12-09D,Race(6),,
1,21,5,2,28,18,0,4,22,25,0,1,26,64,5,7,76,1.75,1.75,1.0,M2018-12-09D,Race(7),,
2,5,3,8,16,0,10,5,15,0,12,7,19,5,25,20,50,8,9,0.0,M2018-12-09D,Race(7),,
3,0,0,0,0,0,0,8,8,0,0,1,1,0,0,9,9,51,34,0.0,M2018-12-09D,Race(7),,
4,2,9,5,16,8,4,5,17,1,3,8,12,11,16,18,45,9.5,9,0.0,M2018-12-09D,Race(7),,
5,0,0,0,0,0,0,0,0,0,0,0,0,0,0,0,0,21,17,0.0,M2018-12-09D,Race(7),,
6,0,0,0,0,0,8,0,8,0,0,0,0,0,8,0,8,17,17,0.0,M2018-12-09D,Race(7),,
7,0,0,0,0,0,0,0,0,0,0,0,0,0,0,0,0,34,26,0.0,M2018-12-09D,Race(7),,
8,2,3,7,12,0,6,6,12,0,10,5,15,2,19,18,39,26,21,0.0,M2018-12-09D,Race(7),,
9,0,0,0,0,0,1,0,1,0,0,1,1,0,1,1,2,19,17,3.0,M2018-12-09D,Race(7),,
10,0,0,0,0,0,0,0,0,0,0,1,1,0,0,1,1,20,15,0.0,M2018-12-09D,Race(7),,
11,0,2,0,2,4,1,2,7,0,1,2,3,4,4,4,12,23,26,0.0,M2018-12-09D,Race(7),,
12,0,0,0,0,0,0,0,0,0,0,0,0,0,0,0,0,51,34,0.0,M2018-12-09D,Race(7),,
13,0,8,3,11,0,0,0,0,0,0,0,0,0,8,3,11,18,17,0.0,M2018-12-09D,Race(7),,
14,0,0,5,5,0,0,0,0,0,0,0,0,0,0,5,5,26,17,2.0,M2018-12-09D,Race(7),,
1,13,13,4,30,9,8,3,20,12,4,5,21,34,25,12,71,2.3,2.25,0.0,M2018-12-09D,Race(8),,
2,3,4,6,13,6,10,6,22,9,9,6,24,18,23,18,59,6.5,6,3.0,M2018-12-09D,Race(8),,
3,0,0,0,0,0,0,0,0,0,0,0,0,0,0,0,0,34,26,0.0,M2018-12-09D,Race(8),,
4,0,0,3,3,0,0,8,8,0,0,0,0,0,0,11,11,34,26,0.0,M2018-12-09D,Race(8),,
5,0,0,5,5,0,8,0,8,0,2,1,3,0,10,6,16,16,13,0.0,M2018-12-09D,Race(8),,
6,0,0,0,0,0,0,0,0,0,0,0,0,0,0,0,0,15,21,0.0,M2018-12-09D,Race(8),,
7,0,2,2,4,0,0,0,0,0,1,1,2,0,3,3,6,15,13,0.0,M2018-12-09D,Race(8),,
8,6,2,3,11,10,2,4,16,3,6,3,12,19,10,10,39,8,10,1.0,M2018-12-09D,Race(8),,
9,8,9,7,24,5,2,9,16,2,4,10,16,15,15,26,56,3.4,3.25,2.0,M2018-12-09D,Race(8),,
1,5,2,11,18,2,6,7,15,2,7,6,15,9,15,24,48,5,5,0.0,M2018-12-09D,Race(9),,
2,5,8,8,21,9,5,6,20,9,7,7,23,23,20,21,64,5,5,0.0,M2018-12-09D,Race(9),,
3,2,0,2,4,8,2,3,13,1,3,2,6,11,5,7,23,6,6,0.0,M2018-12-09D,Race(9),,
4,0,0,0,0,0,2,2,4,0,2,2,4,0,4,4,8,10,10,0.0,M2018-12-09D,Race(9),,
5,0,0,2,2,0,0,0,0,0,0,1,1,0,0,3,3,51,51,0.0,M2018-12-09D,Race(9),,
6,0,3,2,5,0,8,2,10,0,3,1,4,0,14,5,19,12,12,3.0,M2018-12-09D,Race(9),,
7,16,5,2,23,11,7,1,19,14,3,2,19,41,15,5,61,3.5,3.5,1.0,M2018-12-09D,Race(9),,
8,0,0,0,0,0,0,0,0,0,1,0,1,0,1,0,1,31,26,0.0,M2018-12-09D,Race(9),,
9,0,5,0,5,0,0,1,1,0,0,0,0,0,5,1,6,17,17,2.0,M2018-12-09D,Race(9),,
10,2,0,0,2,0,0,0,0,0,0,0,0,2,0,0,2,34,34,0.0,M2018-12-09D,Race(9),,
11,0,0,0,0,0,0,0,0,0,0,0,0,0,0,0,0,61,61,0.0,M2018-12-09D,Race(9),,
12,0,0,3,3,0,0,0,0,0,0,0,0,0,0,3,3,41,41,0.0,M2018-12-09D,Race(9),,
13,0,4,0,4,0,0,8,8,0,0,5,5,0,4,13,17,19,19,0.0,M2018-12-09D,Race(9),,
14,0,3,0,3,0,0,0,0,0,0,0,0,0,3,0,3,41,41,0.0,M2018-12-09D,Race(9),,
1,5,2,13,20,6,5,12,23,3,6,8,17,14,13,33,60,4,4,0.0,M2018-12-12D,Race(1),,
2,8,8,2,18,7,13,5,25,11,2,4,17,26,23,11,60,3.1,3.1,3.0,M2018-12-12D,Race(1),,
3,5,2,5,12,2,5,2,9,2,8,1,11,9,15,8,32,10,10,0.0,M2018-12-12D,Race(1),,
4,0,5,0,5,0,0,1,1,0,0,1,1,0,5,2,7,21,21,0.0,M2018-12-12D,Race(1),,
5,0,2,3,5,0,1,3,4,1,3,5,9,1,6,11,18,10,10,1.0,M2018-12-12D,Race(1),,
6,0,0,0,0,0,0,0,0,0,0,0,0,0,0,0,0,17,17,0.0,M2018-12-12D,Race(1),,
7,0,0,0,0,0,1,1,2,0,0,1,1,0,1,2,3,26,26,0.0,M2018-12-12D,Race(1),,
8,0,0,2,2,0,0,1,1,0,1,2,3,0,1,5,6,26,26,0.0,M2018-12-12D,Race(1),,
9,10,8,2,20,15,5,5,25,9,6,3,18,34,19,10,63,4.4,4.4,2.0,M2018-12-12D,Race(1),,
10,2,3,3,8,0,0,0,0,0,0,1,1,2,3,4,9,21,21,0.0,M2018-12-12D,Race(1),,
11,0,0,0,0,0,0,0,0,0,0,0,0,0,0,0,0,101,101,0.0,M2018-12-12D,Race(1),,
12,0,0,0,0,0,0,0,0,0,0,0,0,0,0,0,0,17,17,0.0,M2018-12-12D,Race(1),,
1,4,6,3,13,7,13,3,23,6,2,1,9,17,21,7,45,5.5,5.5,2.0,M2018-12-12D,Race(2),,
2,3,7,2,12,2,1,1,4,2,1,1,4,7,9,4,20,5.5,5.5,0.0,M2018-12-12D,Race(2),,
3,8,3,0,11,15,5,1,21,13,5,3,21,36,13,4,53,5.5,5.5,1.0,M2018-12-12D,Race(2),,
4,3,0,2,5,2,3,14,19,2,4,8,14,7,7,24,38,9,9,3.0,M2018-12-12D,Race(2),,
5,0,8,9,17,1,1,2,4,1,4,2,7,2,13,13,28,9.5,9.5,0.0,M2018-12-12D,Race(2),,
6,0,0,0,0,0,0,0,0,0,0,0,0,0,0,0,0,34,34,0.0,M2018-12-12D,Race(2),,
7,0,0,0,0,0,0,0,0,0,2,0,2,0,2,0,2,51,51,0.0,M2018-12-12D,Race(2),,
8,0,0,2,2,0,0,0,0,0,0,0,0,0,0,2,2,17,17,0.0,M2018-12-12D,Race(2),,
9,7,0,0,7,0,1,3,4,0,2,2,4,7,3,5,15,15,15,0.0,M2018-12-12D,Race(2),,
10,5,4,2,11,2,1,1,4,1,3,2,6,8,8,5,21,5,5,0.0,M2018-12-12D,Race(2),,
11,0,0,0,0,0,2,0,2,0,1,1,2,0,3,1,4,26,26,0.0,M2018-12-12D,Race(2),,
12,0,2,10,12,1,3,5,9,1,2,6,9,2,7,21,30,8,8,0.0,M2018-12-12D,Race(2),,
1,0,6,2,8,2,1,3,6,4,3,3,10,6,10,8,24,9,9,0.0,M2018-12-12D,Race(3),,
2,14,3,3,20,15,6,5,26,9,4,3,16,38,13,11,62,3.8,3.8,0.0,M2018-12-12D,Race(3),,
3,6,9,5,20,7,12,6,25,9,3,6,18,22,24,17,63,3.4,3.4,0.0,M2018-12-12D,Race(3),,
4,0,0,4,4,0,1,0,1,0,0,1,1,0,1,5,6,18,18,3.0,M2018-12-12D,Race(3),,
5,4,0,0,4,0,0,0,0,0,0,0,0,4,0,0,4,34,34,1.0,M2018-12-12D,Race(3),,
6,3,10,5,18,5,8,11,24,4,13,6,23,12,31,22,65,7.5,7.5,0.0,M2018-12-12D,Race(3),,
7,3,0,6,9,0,2,2,4,0,2,1,3,3,4,9,16,6,6,0.0,M2018-12-12D,Race(3),,
8,0,0,0,0,0,0,2,2,0,0,2,2,0,0,4,4,10,10,0.0,M2018-12-12D,Race(3),,
9,0,2,0,2,1,0,0,1,0,0,1,1,1,2,1,4,26,26,2.0,M2018-12-12D,Race(3),,
10,0,0,5,5,0,0,0,0,0,0,0,0,0,0,5,5,21,21,0.0,M2018-12-12D,Race(3),,
11,0,0,0,0,0,0,0,0,0,0,0,0,0,0,0,0,81,81,0.0,M2018-12-12D,Race(3),,
12,0,0,0,0,0,0,1,1,0,1,3,4,0,1,4,5,21,21,0.0,M2018-12-12D,Race(3),,
1,10,5,9,24,16,8,5,29,12,10,2,24,38,23,16,77,4.2,4.2,3.0,M2018-12-12D,Race(4),,
2,0,3,2,5,2,0,0,2,1,0,0,1,3,3,2,8,31,31,2.0,M2018-12-12D,Race(4),,
3,0,0,5,5,0,2,2,4,1,1,3,5,1,3,10,14,11,11,0.0,M2018-12-12D,Race(4),,
4,12,8,2,22,6,10,5,21,6,5,4,15,24,23,11,58,2.8,2.8,0.0,M2018-12-12D,Race(4),,
5,0,0,0,0,1,1,0,2,1,1,0,2,2,2,0,4,15,15,0.0,M2018-12-12D,Race(4),,
6,0,0,0,0,0,1,0,1,0,0,0,0,0,1,0,1,51,51,0.0,M2018-12-12D,Race(4),,
7,0,0,0,0,0,0,0,0,0,0,0,0,0,0,0,0,34,34,0.0,M2018-12-12D,Race(4),,
8,0,0,0,0,1,0,0,1,0,0,1,1,1,0,1,2,51,51,0.0,M2018-12-12D,Race(4),,
9,3,0,0,3,0,2,1,3,2,1,1,4,5,3,2,10,12,12,0.0,M2018-12-12D,Race(4),,
10,3,12,10,25,4,4,14,22,3,7,10,20,10,23,34,67,3.6,3.6,1.0,M2018-12-12D,Race(4),,
11,0,2,2,4,0,2,3,5,0,1,5,6,0,5,10,15,17,17,0.0,M2018-12-12D,Race(4),,
12,2,0,0,2,0,0,0,0,0,0,0,0,2,0,0,2,41,41,0.0,M2018-12-12D,Race(4),,
1,6,7,8,21,4,3,14,21,6,5,4,15,16,15,26,57,4.4,4.4,0.0,M2018-12-12D,Race(5),,
2,7,3,13,23,2,3,4,9,3,3,4,10,12,9,21,42,9,9,0.0,M2018-12-12D,Race(5),,
3,0,8,7,15,2,15,5,22,3,8,4,15,5,31,16,52,8,8,0.0,M2018-12-12D,Race(5),,
4,0,2,0,2,0,0,0,0,0,0,2,2,0,2,2,4,17,17,0.0,M2018-12-12D,Race(5),,
5,0,0,2,2,1,0,2,3,0,3,2,5,1,3,6,10,17,17,3.0,M2018-12-12D,Race(5),,
6,0,0,0,0,1,0,0,1,0,0,0,0,1,0,0,1,19,19,0.0,M2018-12-12D,Race(5),,
7,0,0,0,0,0,0,0,0,0,0,1,1,0,0,1,1,101,101,0.0,M2018-12-12D,Race(5),,
8,15,8,0,23,19,7,0,26,13,5,0,18,47,20,0,67,2.5,2.5,1.0,M2018-12-12D,Race(5),,
9,0,0,0,0,0,1,0,1,0,0,0,0,0,1,0,1,21,21,0.0,M2018-12-12D,Race(5),,
10,0,0,0,0,1,0,2,3,1,1,3,5,2,1,5,8,17,17,2.0,M2018-12-12D,Race(5),,
11,2,2,0,4,0,0,3,3,0,0,5,5,2,2,8,12,15,15,0.0,M2018-12-12D,Race(5),,
12,0,0,0,0,0,1,0,1,0,1,1,2,0,2,1,3,12,12,0.0,M2018-12-12D,Race(5),,
1,0,2,4,6,1,1,1,3,1,0,0,1,2,3,5,10,12,12,0.0,M2018-12-12D,Race(6),,
2,2,6,8,16,3,5,6,14,4,6,5,15,9,17,19,45,9,9,0.0,M2018-12-12D,Race(6),,
3,0,0,0,0,0,0,0,0,0,0,0,0,0,0,0,0,51,51,0.0,M2018-12-12D,Race(6),,
4,0,2,3,5,2,2,3,7,2,0,3,5,4,4,9,17,12,12,0.0,M2018-12-12D,Race(6),,
5,0,0,4,4,1,1,14,16,0,3,5,8,1,4,23,28,10,10,2.0,M2018-12-12D,Race(6),,
6,0,0,3,3,0,2,0,2,0,3,1,4,0,5,4,9,9,9,0.0,M2018-12-12D,Race(6),,
7,13,4,8,25,15,9,1,25,14,6,1,21,42,19,10,71,4,4,3.0,M2018-12-12D,Race(6),,
8,9,16,0,25,8,10,3,21,5,8,5,18,22,34,8,64,3.8,3.8,0.0,M2018-12-12D,Race(6),,
9,0,0,0,0,0,0,0,0,0,0,3,3,0,0,3,3,14,14,1.0,M2018-12-12D,Race(6),,
10,0,0,0,0,0,0,0,0,0,0,0,0,0,0,0,0,41,41,0.0,M2018-12-12D,Race(6),,
11,0,0,0,0,0,0,1,1,0,0,2,2,0,0,3,3,21,21,0.0,M2018-12-12D,Race(6),,
12,6,0,0,6,0,0,1,1,0,0,1,1,6,0,2,8,7.5,7.5,0.0,M2018-12-12D,Race(6),,
1,3,2,4,9,3,2,4,9,2,2,3,7,8,6,11,25,10,10,0.0,M2018-12-12D,Race(7),,
2,0,0,0,0,0,1,0,1,0,0,1,1,0,1,1,2,26,26,0.0,M2018-12-12D,Race(7),,
3,0,4,0,4,0,0,3,3,2,0,2,4,2,4,5,11,8.5,8,0.0,M2018-12-12D,Race(7),,
4,0,0,2,2,0,0,0,0,0,0,0,0,0,0,2,2,26,26,3.0,M2018-12-12D,Race(7),,
5,0,0,0,0,0,0,0,0,0,0,0,0,0,0,0,0,71,67,0.0,M2018-12-12D,Race(7),,
6,3,5,0,8,3,15,5,23,3,7,7,17,9,27,12,48,4.8,4.8,2.0,M2018-12-12D,Race(7),,
7,0,0,2,2,0,1,1,2,0,3,3,6,0,4,6,10,10,10,0.0,M2018-12-12D,Race(7),,
8,7,6,6,19,3,4,13,20,6,6,5,17,16,16,24,56,7.5,7,1.0,M2018-12-12D,Race(7),,
9,0,0,0,0,0,0,0,0,0,0,0,0,0,0,0,0,81,81,0.0,M2018-12-12D,Race(7),,
10,0,8,8,16,1,4,0,5,1,4,2,7,2,16,10,28,10,8,0.0,M2018-12-12D,Race(7),,
11,15,5,8,28,20,2,4,26,12,4,3,19,47,11,15,73,2.6,2.6,0.0,M2018-12-12D,Race(7),,
12,2,0,0,2,0,0,0,0,0,0,0,0,2,0,0,2,21,21,0.0,M2018-12-12D,Race(7),,
1,2,0,0,2,2,2,2,6,2,2,1,5,6,4,3,13,11,11,0.0,M2018-12-12D,Race(8),,
2,0,2,0,2,0,0,0,0,0,0,0,0,0,2,0,2,26,26,0.0,M2018-12-12D,Race(8),,
3,0,7,3,10,3,1,13,17,4,2,2,8,7,10,18,35,6.5,6.5,2.0,M2018-12-12D,Race(8),,
4,15,0,10,25,3,15,6,24,8,8,4,20,26,23,20,69,4.8,4.8,0.0,M2018-12-12D,Race(8),,
5,3,3,0,6,1,2,4,7,2,1,8,11,6,6,12,24,6,6,1.0,M2018-12-12D,Race(8),,
6,4,11,4,19,20,4,3,27,8,11,3,22,32,26,10,68,5,5,0.0,M2018-12-12D,Race(8),,
7,3,5,5,13,0,1,3,4,0,0,4,4,3,6,12,21,10,10,0.0,M2018-12-12D,Race(8),,
8,0,2,3,5,0,0,0,0,0,0,1,1,0,2,4,6,16,16,3.0,M2018-12-12D,Race(8),,
9,0,0,0,0,0,2,0,2,0,1,0,1,0,3,0,3,21,21,0.0,M2018-12-12D,Race(8),,
10,3,0,5,8,1,3,2,6,2,1,2,5,6,4,9,19,8,8,0.0,M2018-12-12D,Race(8),,
11,0,0,0,0,0,0,0,0,0,0,0,0,0,0,0,0,71,67,0.0,M2018-12-12D,Race(8),,
12,0,0,0,0,0,0,0,0,0,0,1,1,0,0,1,1,11,11,0.0,M2018-12-12D,Race(8),,
1,20,10,0,30,20,7,1,28,23,2,1,26,63,19,2,84,1.75,1.8,1.0,M2018-12-16D,Race(1),,
2,5,13,12,30,0,9,9,18,0,8,11,19,5,30,32,67,4.6,4.6,0.0,M2018-12-16D,Race(1),,
3,5,5,16,26,10,10,7,27,2,12,7,21,17,27,30,74,5.5,5,0.0,M2018-12-16D,Race(1),,
4,0,0,0,0,0,2,5,7,1,3,5,9,1,5,10,16,6,6,2.0,M2018-12-16D,Race(1),,
5,0,2,2,4,0,0,0,0,0,1,0,1,0,3,2,5,31,26,0.0,M2018-12-16D,Race(1),,
6,0,0,0,0,0,0,8,8,0,0,2,2,0,0,10,10,18,17,0.0,M2018-12-16D,Race(1),,
1,3,5,0,8,0,0,8,8,1,1,0,2,4,6,8,18,19,19,0.0,M2018-12-16D,Race(10),,
2,2,6,8,16,5,6,2,13,7,6,2,15,14,18,12,44,5,5,2.0,M2018-12-16D,Race(10),,
3,2,2,3,7,1,2,3,6,1,2,4,7,4,6,10,20,9,9,0.0,M2018-12-16D,Race(10),,
4,0,0,5,5,1,2,1,4,0,4,2,6,1,6,8,15,9.5,9.5,3.0,M2018-12-16D,Race(10),,
5,2,0,0,2,0,0,0,0,0,0,1,1,2,0,1,3,31,31,0.0,M2018-12-16D,Race(10),,
6,0,5,2,7,0,2,2,4,0,4,0,4,0,11,4,15,11,11,0.0,M2018-12-16D,Race(10),,
7,0,0,0,0,0,0,1,1,0,0,1,1,0,0,2,2,34,34,0.0,M2018-12-16D,Race(10),,
8,0,0,0,0,0,0,0,0,0,0,0,0,0,0,0,0,34,34,0.0,M2018-12-16D,Race(10),,
9,0,0,0,0,0,0,0,0,0,0,1,1,0,0,1,1,21,21,0.0,M2018-12-16D,Race(10),,
10,2,2,3,7,3,3,4,10,2,1,5,8,7,6,12,25,7,7,4.0,M2018-12-16D,Race(10),,
11,0,0,0,0,0,0,0,0,0,0,1,1,0,0,1,1,51,51,0.0,M2018-12-16D,Race(10),,
12,14,10,0,24,12,6,3,21,14,5,1,20,40,21,4,65,3.4,3.4,1.0,M2018-12-16D,Race(10),,
13,0,0,0,0,0,8,1,9,0,2,2,4,0,10,3,13,31,31,0.0,M2018-12-16D,Race(10),,
14,5,0,9,14,8,1,5,14,1,1,6,8,14,2,20,36,9,9,0.0,M2018-12-16D,Race(10),,
1,0,0,0,0,0,0,0,0,0,0,0,0,0,0,0,0,71,67,0.0,M2018-12-16D,Race(11),,
2,5,13,7,25,4,7,8,19,6,7,5,18,15,27,20,62,4.4,4.4,1.0,M2018-12-16D,Race(11),,
3,0,0,0,0,0,9,4,13,0,0,0,0,0,9,4,13,0,0,0.0,M2018-12-16D,Race(11),,
4,0,7,3,10,0,0,2,2,0,0,1,1,0,7,6,13,13,13,0.0,M2018-12-16D,Race(11),,
5,0,0,0,0,0,0,0,0,0,1,0,1,0,1,0,1,26,26,0.0,M2018-12-16D,Race(11),,
6,0,0,2,2,0,2,8,10,0,4,0,4,0,6,10,16,15,15,0.0,M2018-12-16D,Race(11),,
7,2,0,2,4,0,3,3,6,1,2,6,9,3,5,11,19,12,12,0.0,M2018-12-16D,Race(11),,
8,0,0,0,0,0,0,0,0,0,0,0,0,0,0,0,0,26,26,0.0,M2018-12-16D,Race(11),,
9,0,0,0,0,0,0,0,0,0,0,0,0,0,0,0,0,51,51,0.0,M2018-12-16D,Race(11),,
10,18,10,0,28,16,4,3,23,16,5,4,25,50,19,7,76,1.95,1.95,2.0,M2018-12-16D,Race(11),,
11,5,0,11,16,2,5,2,9,2,5,5,12,9,10,18,37,8.5,8.5,0.0,M2018-12-16D,Race(11),,
12,0,0,5,5,0,0,0,0,0,0,1,1,0,0,6,6,15,15,3.0,M2018-12-16D,Race(11),,
13,0,0,0,0,8,0,0,8,0,0,0,0,8,0,0,8,41,41,0.0,M2018-12-16D,Race(11),,
14,0,0,0,0,0,0,0,0,0,0,0,0,0,0,0,0,101,101,0.0,M2018-12-16D,Race(11),,
1,5,10,13,28,7,1,5,13,7,3,1,11,19,14,19,52,5,5,0.0,M2018-12-16D,Race(2),,
2,0,0,0,0,0,0,0,0,0,0,0,0,0,0,0,0,34,35,0.0,M2018-12-16D,Race(2),,
3,0,0,11,11,3,6,4,13,3,2,7,12,6,8,22,36,6,6,3.0,M2018-12-16D,Race(2),,
4,0,10,0,10,0,2,4,6,2,3,6,11,2,15,10,27,5.5,5.5,0.0,M2018-12-16D,Race(2),,
5,0,0,2,2,0,0,0,0,0,1,0,1,0,1,2,3,17,17,0.0,M2018-12-16D,Race(2),,
6,3,2,0,5,0,8,2,10,1,2,1,4,4,12,3,19,9,9,1.0,M2018-12-16D,Race(2),,
7,0,0,0,0,0,0,0,0,0,0,0,0,0,0,0,0,61,61,0.0,M2018-12-16D,Race(2),,
8,0,0,0,0,0,0,0,0,0,0,0,0,0,0,0,0,81,81,0.0,M2018-12-16D,Race(2),,
9,0,0,2,2,8,6,3,17,1,9,3,13,9,15,8,32,12,12,0.0,M2018-12-16D,Race(2),,
10,0,0,0,0,0,0,0,0,0,0,0,0,0,0,0,0,81,81,0.0,M2018-12-16D,Race(2),,
11,20,8,2,30,12,7,4,23,12,6,7,25,44,21,13,78,2.9,2.9,0.0,M2018-12-16D,Race(2),,
12,2,0,0,2,0,0,8,8,0,0,1,1,2,0,9,11,12,12,2.0,M2018-12-16D,Race(2),,
1,20,5,0,25,18,1,2,21,19,1,2,22,57,7,4,68,3.8,3.8,3.0,M2018-12-16D,Race(3),,
2,0,5,2,7,0,4,4,8,0,5,3,8,0,14,9,23,7,7,0.0,M2018-12-16D,Race(3),,
3,2,0,4,6,2,7,3,12,2,7,2,11,6,14,9,29,8,8,0.0,M2018-12-16D,Race(3),,
4,3,0,3,6,0,3,0,3,2,4,2,8,5,7,5,17,9,10,2.0,M2018-12-16D,Race(3),,
5,0,6,4,10,1,2,1,4,0,3,4,7,1,11,9,21,16,15,1.0,M2018-12-16D,Race(3),,
6,0,5,9,14,0,5,7,12,1,1,5,7,1,11,21,33,6,6,0.0,M2018-12-16D,Race(3),,
7,0,0,0,0,0,0,0,0,0,1,1,2,0,1,1,2,41,41,0.0,M2018-12-16D,Race(3),,
8,0,0,0,0,0,0,0,0,0,0,1,1,0,0,1,1,26,26,0.0,M2018-12-16D,Race(3),,
9,0,0,0,0,0,0,0,0,0,0,0,0,0,0,0,0,101,101,0.0,M2018-12-16D,Race(3),,
10,0,0,0,0,1,8,2,11,1,0,3,4,2,8,5,15,20,19,0.0,M2018-12-16D,Race(3),,
11,2,3,0,5,8,0,3,11,1,4,1,6,11,7,4,22,11,11,0.0,M2018-12-16D,Race(3),,
12,3,6,6,15,0,0,0,0,0,0,2,2,3,6,8,17,7.5,7.5,0.0,M2018-12-16D,Race(3),,
13,0,0,0,0,0,0,8,8,0,0,0,0,0,0,8,8,41,41,0.0,M2018-12-16D,Race(3),,
14,0,0,2,2,0,0,0,0,0,0,0,0,0,0,2,2,17,17,0.0,M2018-12-16D,Race(3),,
1,0,0,0,0,8,0,0,8,0,0,0,0,8,0,0,8,0,0,0.0,M2018-12-16D,Race(4),,
2,0,0,0,0,0,0,0,0,0,0,0,0,0,0,0,0,26,26,0.0,M2018-12-16D,Race(4),,
3,3,4,5,12,0,2,8,10,1,1,0,2,4,7,13,24,8,8,0.0,M2018-12-16D,Race(4),,
4,0,0,0,0,0,0,0,0,0,0,0,0,0,0,0,0,0,0,0.0,M2018-12-16D,Race(4),,
5,18,5,4,27,17,4,1,22,18,6,2,26,53,15,7,75,2.9,2.9,2.0,M2018-12-16D,Race(4),,
6,0,0,0,0,0,0,0,0,0,1,2,3,0,1,2,3,14,14,0.0,M2018-12-16D,Race(4),,
7,0,0,0,0,0,0,0,0,0,0,1,1,0,0,1,1,13,13,1.0,M2018-12-16D,Race(4),,
8,0,0,0,0,0,2,0,2,0,3,1,4,0,5,1,6,18,18,0.0,M2018-12-16D,Race(4),,
9,0,6,11,17,2,11,7,20,3,12,6,21,5,29,24,58,4.8,4.8,0.0,M2018-12-16D,Race(4),,
10,5,10,5,20,2,3,8,13,2,3,8,13,9,16,21,46,4.8,4.8,3.0,M2018-12-16D,Race(4),,
11,4,5,5,14,8,1,5,14,2,0,0,2,14,6,10,30,6,6,0.0,M2018-12-16D,Race(4),,
1,5,3,3,11,7,4,6,17,8,6,6,20,20,13,15,48,6.5,6.5,0.0,M2018-12-16D,Race(5),,
2,0,0,2,2,2,3,3,8,1,5,3,9,3,8,8,19,12,12,0.0,M2018-12-16D,Race(5),,
3,0,0,2,2,0,0,0,0,0,0,1,1,0,0,3,3,41,41,0.0,M2018-12-16D,Race(5),,
4,2,3,2,7,1,2,1,4,3,0,2,5,6,5,5,16,14,14,0.0,M2018-12-16D,Race(5),,
5,0,3,0,3,0,1,0,1,1,0,0,1,1,4,0,5,9,9,0.0,M2018-12-16D,Race(5),,
6,9,5,3,17,7,7,2,16,9,8,1,18,25,20,6,51,5,5,1.0,M2018-12-16D,Race(5),,
7,3,8,8,19,1,2,7,10,3,2,7,12,7,12,22,41,6.5,6.5,3.0,M2018-12-16D,Race(5),,
8,0,3,5,8,1,8,0,9,1,1,0,2,2,12,5,19,17,17,0.0,M2018-12-16D,Race(5),,
9,2,0,3,5,3,1,3,7,0,3,3,6,5,4,9,18,11,11,0.0,M2018-12-16D,Race(5),,
10,5,2,0,7,0,0,8,8,0,0,1,1,5,2,9,16,8.5,8.5,0.0,M2018-12-16D,Race(5),,
11,0,0,0,0,0,0,0,0,0,1,0,1,0,1,0,1,34,34,0.0,M2018-12-16D,Race(5),,
12,2,3,2,7,8,0,0,8,0,0,1,1,10,3,3,16,10,10,0.0,M2018-12-16D,Race(5),,
13,2,0,0,2,0,2,0,2,0,0,1,1,2,2,1,5,16,16,0.0,M2018-12-16D,Race(5),,
14,0,0,0,0,0,0,0,0,0,0,0,0,0,0,0,0,26,26,2.0,M2018-12-16D,Race(5),,
1,16,4,4,24,2,2,0,4,17,6,1,24,35,12,5,52,3.2,3.2,2.0,M2018-12-16D,Race(6),,
2,0,0,0,0,0,9,1,10,0,2,2,4,0,11,3,14,16,16,0.0,M2018-12-16D,Race(6),,
3,0,0,0,0,0,0,0,0,0,0,0,0,0,0,0,0,34,34,0.0,M2018-12-16D,Race(6),,
4,2,13,4,19,1,8,5,14,5,6,5,16,8,27,14,49,3,3,3.0,M2018-12-16D,Race(6),,
5,0,0,0,0,0,0,0,0,0,0,0,0,0,0,0,0,26,26,0.0,M2018-12-16D,Race(6),,
6,0,5,8,13,8,3,3,14,2,5,2,9,10,13,13,36,7.5,7.5,1.0,M2018-12-16D,Race(6),,
7,3,0,0,3,0,0,8,8,0,0,0,0,3,0,8,11,26,26,0.0,M2018-12-16D,Race(6),,
8,0,3,2,5,0,0,2,2,1,0,3,4,1,3,7,11,18,18,0.0,M2018-12-16D,Race(6),,
9,2,3,6,11,0,5,4,9,1,5,5,11,3,13,15,31,8.5,8.5,0.0,M2018-12-16D,Race(6),,
10,7,0,6,13,0,3,7,10,0,2,8,10,7,5,21,33,7,7,0.0,M2018-12-16D,Race(6),,
11,0,2,0,2,0,0,0,0,0,0,0,0,0,2,0,2,31,31,0.0,M2018-12-16D,Race(6),,
1,13,7,6,26,16,5,2,23,17,6,1,24,46,18,9,73,3,3,2.0,M2018-12-16D,Race(7),,
2,7,6,9,22,1,5,6,12,4,5,6,15,12,16,21,49,7.5,7.5,0.0,M2018-12-16D,Race(7),,
3,0,0,0,0,0,0,0,0,0,0,0,0,0,0,0,0,151,151,0.0,M2018-12-16D,Race(7),,
4,0,0,0,0,0,0,0,0,0,1,0,1,0,1,0,1,0,0,0.0,M2018-12-16D,Race(7),,
5,0,0,0,0,0,1,1,2,0,0,1,1,0,1,2,3,17,17,0.0,M2018-12-16D,Race(7),,
6,0,0,0,0,0,8,1,9,0,0,0,0,0,8,1,9,101,101,0.0,M2018-12-16D,Race(7),,
7,3,5,4,12,0,0,0,0,1,1,4,6,4,6,8,18,11,11,0.0,M2018-12-16D,Race(7),,
8,0,4,3,7,2,1,1,4,0,2,2,4,2,7,6,15,6.5,6.5,0.0,M2018-12-16D,Race(7),,
9,0,0,0,0,0,0,0,0,0,0,0,0,0,0,0,0,26,26,0.0,M2018-12-16D,Race(7),,
10,0,5,6,11,1,5,4,10,2,2,3,7,3,12,13,28,5,5,3.0,M2018-12-16D,Race(7),,
11,3,0,2,5,8,1,3,12,0,0,1,1,11,1,6,18,16,16,1.0,M2018-12-16D,Race(7),,
12,0,0,0,0,1,0,8,9,0,0,0,0,1,0,8,9,21,21,0.0,M2018-12-16D,Race(7),,
13,4,3,0,7,0,1,1,2,2,2,3,7,6,6,4,16,8.5,8.5,0.0,M2018-12-16D,Race(7),,
14,0,0,0,0,1,3,1,5,0,0,0,0,1,3,1,5,34,34,0.0,M2018-12-16D,Race(7),,
1,5,5,4,14,3,2,3,8,3,3,3,9,11,10,10,31,8,8,3.0,M2018-12-16D,Race(8),,
2,6,0,5,11,4,4,7,15,7,2,4,13,17,6,16,39,6,6,0.0,M2018-12-16D,Race(8),,
3,2,3,3,8,2,4,2,8,3,1,2,6,7,8,7,22,4.4,4.4,0.0,M2018-12-16D,Race(8),,
4,0,0,2,2,0,0,0,0,0,0,0,0,0,0,2,2,71,67,0.0,M2018-12-16D,Race(8),,
5,0,0,0,0,0,0,0,0,0,0,0,0,0,0,0,0,19,19,2.0,M2018-12-16D,Race(8),,
6,8,7,0,15,7,5,2,14,8,5,3,16,23,17,5,45,6.5,6.5,0.0,M2018-12-16D,Race(8),,
7,2,2,0,4,0,4,3,7,0,6,5,11,2,12,8,22,9,9,1.0,M2018-12-16D,Race(8),,
8,0,0,0,0,1,8,1,10,0,1,2,3,1,9,3,13,10,10,0.0,M2018-12-16D,Race(8),,
9,7,11,10,28,5,2,4,11,4,5,4,13,16,18,18,52,6,6,0.0,M2018-12-16D,Race(8),,
10,0,0,3,3,8,1,0,9,1,2,0,3,9,3,3,15,16,16,0.0,M2018-12-16D,Race(8),,
11,0,0,3,3,0,0,0,0,0,0,0,0,0,0,3,3,34,34,0.0,M2018-12-16D,Race(8),,
12,0,2,0,2,0,0,8,8,0,1,3,4,0,3,11,14,13,13,0.0,M2018-12-16D,Race(8),,
1,0,2,7,9,0,2,7,9,0,3,8,11,0,7,22,29,15,15,2.0,M2018-12-16D,Race(9),,
2,24,4,2,30,21,2,0,23,24,1,0,25,69,7,2,78,1.7,1.7,1.0,M2018-12-16D,Race(9),,
3,0,13,5,18,8,11,6,25,2,14,5,21,10,38,16,64,7.5,7.5,0.0,M2018-12-16D,Race(9),,
4,0,0,2,2,0,0,8,8,0,1,2,3,0,1,12,13,18,18,3.0,M2018-12-16D,Race(9),,
5,0,3,5,8,0,2,2,4,0,2,2,4,0,7,9,16,17,17,0.0,M2018-12-16D,Race(9),,
6,4,3,6,13,0,2,0,2,0,1,3,4,4,6,9,19,21,21,0.0,M2018-12-16D,Race(9),,
7,2,5,0,7,1,8,3,12,0,2,4,6,3,15,7,25,7.5,7.5,0.0,M2018-12-16D,Race(9),,
8,0,0,0,0,0,0,1,1,0,0,0,0,0,0,1,1,19,23,0.0,M2018-12-16D,Race(9),,
9,0,0,3,3,0,3,3,6,0,2,2,4,0,5,8,13,16,16,0.0,M2018-12-16D,Race(9),,
10,0,0,0,0,0,0,0,0,0,0,0,0,0,0,0,0,31,31,0.0,M2018-12-16D,Race(9),,
11,0,0,0,0,0,0,0,0,0,0,0,0,0,0,0,0,151,151,0.0,M2018-12-16D,Race(9),,
12,0,0,0,0,0,0,0,0,0,0,0,0,0,0,0,0,17,17,0.0,M2018-12-16D,Race(9),,
13,0,0,0,0,0,0,0,0,0,0,0,0,0,0,0,0,101,101,0.0,M2018-12-16D,Race(9),,
1,0,3,0,3,3,1,1,5,1,2,0,3,4,6,1,11,0,0,0.0,M2018-12-19D,Race(1),,
2,2,0,0,2,0,1,2,3,0,0,3,3,2,1,5,8,0,0,0.0,M2018-12-19D,Race(1),,
3,5,2,4,11,1,13,4,18,4,4,3,11,10,19,11,40,0,0,3.0,M2018-12-19D,Race(1),,
4,2,5,7,14,5,0,10,15,3,4,3,10,10,9,20,39,0,0,0.0,M2018-12-19D,Race(1),,
5,5,0,8,13,3,1,2,6,7,2,3,12,15,3,13,31,0,0,0.0,M2018-12-19D,Race(1),,
6,0,0,0,0,0,2,0,2,0,0,0,0,0,2,0,2,0,0,0.0,M2018-12-19D,Race(1),,
7,13,10,3,26,15,6,6,27,7,3,11,21,35,19,20,74,0,0,1.0,M2018-12-19D,Race(1),,
8,0,0,2,2,3,2,3,8,4,2,1,7,7,4,6,17,0,0,2.0,M2018-12-19D,Race(1),,
9,3,10,6,19,0,4,2,6,0,9,2,11,3,23,10,36,0,0,0.0,M2018-12-19D,Race(1),,
10,0,0,0,0,0,0,0,0,0,0,0,0,0,0,0,0,0,0,0.0,M2018-12-19D,Race(1),,
1,0,0,0,0,0,0,1,1,0,0,2,2,0,0,3,3,0,0,0.0,M2018-12-19D,Race(2),,
2,3,3,4,10,0,2,4,6,2,3,3,8,5,8,11,24,0,0,0.0,M2018-12-19D,Race(2),,
3,2,2,2,6,6,1,11,18,8,1,2,11,16,4,15,35,0,0,1.0,M2018-12-19D,Race(2),,
4,7,3,0,10,1,1,1,3,0,1,1,2,8,5,2,15,0,0,0.0,M2018-12-19D,Race(2),,
5,0,4,5,9,1,2,1,4,4,2,1,7,5,8,7,20,0,0,0.0,M2018-12-19D,Race(2),,
6,2,7,3,12,6,12,5,23,5,4,4,13,13,23,12,48,0,0,0.0,M2018-12-19D,Race(2),,
7,2,0,0,2,0,0,0,0,0,1,0,1,2,1,0,3,0,0,0.0,M2018-12-19D,Race(2),,
8,3,0,0,3,1,1,2,4,0,3,3,6,4,4,5,13,0,0,0.0,M2018-12-19D,Race(2),,
9,6,2,3,11,2,0,1,3,1,2,3,6,9,4,7,20,0,0,2.0,M2018-12-19D,Race(2),,
10,3,0,0,3,0,0,1,1,0,0,1,1,3,0,2,5,0,0,0.0,M2018-12-19D,Race(2),,
11,0,3,2,5,0,0,0,0,0,0,1,1,0,3,3,6,0,0,0.0,M2018-12-19D,Race(2),,
12,2,6,11,19,13,11,3,27,6,9,5,20,21,26,19,66,0,0,3.0,M2018-12-19D,Race(2),,
1,0,0,4,4,1,1,1,3,1,0,0,1,2,1,5,8,0,0,0.0,M2018-12-19D,Race(3),,
2,7,3,3,13,1,4,9,14,1,0,3,4,9,7,15,31,0,0,0.0,M2018-12-19D,Race(3),,
3,3,3,8,14,4,11,9,24,7,6,7,20,14,20,24,58,0,0,0.0,M2018-12-19D,Race(3),,
4,0,2,2,4,1,3,0,4,0,4,0,4,1,9,2,12,0,0,0.0,M2018-12-19D,Race(3),,
5,0,5,0,5,1,1,1,3,1,2,2,5,2,8,3,13,0,0,1.0,M2018-12-19D,Race(3),,
6,0,0,0,0,0,0,0,0,0,0,1,1,0,0,1,1,0,0,2.0,M2018-12-19D,Race(3),,
7,2,0,0,2,2,0,1,3,0,0,1,1,4,0,2,6,0,0,0.0,M2018-12-19D,Race(3),,
8,0,0,0,0,0,0,3,3,0,0,2,2,0,0,5,5,0,0,0.0,M2018-12-19D,Race(3),,
9,4,8,10,22,0,6,5,11,1,10,6,17,5,24,21,50,0,0,0.0,M2018-12-19D,Race(3),,
10,14,9,3,26,20,4,1,25,15,4,4,23,49,17,8,74,0,0,3.0,M2018-12-19D,Race(3),,
1,8,7,5,20,15,4,5,24,12,4,5,21,35,15,15,65,0,0,0.0,M2018-12-19D,Race(4),,
2,0,0,5,5,1,2,1,4,1,3,1,5,2,5,7,14,0,0,2.0,M2018-12-19D,Race(4),,
3,2,3,2,7,1,2,0,3,1,3,0,4,4,8,2,14,0,0,0.0,M2018-12-19D,Race(4),,
4,0,0,0,0,3,1,1,5,0,0,1,1,3,1,2,6,0,0,0.0,M2018-12-19D,Race(4),,
5,0,3,0,3,0,1,1,2,1,1,1,3,1,5,2,8,0,0,0.0,M2018-12-19D,Race(4),,
6,11,7,3,21,6,10,4,20,8,6,3,17,25,23,10,58,0,0,0.0,M2018-12-19D,Race(4),,
7,0,0,0,0,0,0,0,0,0,0,0,0,0,0,0,0,0,0,0.0,M2018-12-19D,Race(4),,
8,4,3,3,10,0,1,2,3,0,1,1,2,4,5,6,15,0,0,1.0,M2018-12-19D,Race(4),,
9,0,0,0,0,0,0,0,0,0,0,3,3,0,0,3,3,0,0,0.0,M2018-12-19D,Race(4),,
10,5,5,12,22,4,8,14,26,3,7,10,20,12,20,36,68,0,0,3.0,M2018-12-19D,Race(4),,
11,0,0,0,0,0,0,0,0,0,0,0,0,0,0,0,0,0,0,0.0,M2018-12-19D,Race(4),,
12,0,2,0,2,0,1,2,3,0,1,1,2,0,4,3,7,0,0,0.0,M2018-12-19D,Race(4),,
1,5,0,6,11,1,1,2,4,1,3,2,6,7,4,10,21,0,0,0.0,M2018-12-19D,Race(5),,
2,0,0,0,0,0,0,0,0,0,0,0,0,0,0,0,0,0,0,0.0,M2018-12-19D,Race(5),,
3,5,14,4,23,6,15,7,28,3,5,10,18,14,34,21,69,0,0,0.0,M2018-12-19D,Race(5),,
4,0,0,0,0,0,0,1,1,1,1,1,3,1,1,2,4,0,0,0.0,M2018-12-19D,Race(5),,
5,12,7,11,30,18,6,4,28,15,6,1,22,45,19,16,80,0,0,0.0,M2018-12-19D,Race(5),,
6,0,0,2,2,0,1,0,1,1,0,0,1,1,1,2,4,0,0,3.0,M2018-12-19D,Race(5),,
7,0,0,0,0,0,0,1,1,0,0,2,2,0,0,3,3,0,0,2.0,M2018-12-19D,Race(5),,
8,0,0,0,0,0,0,0,0,0,0,1,1,0,0,1,1,0,0,0.0,M2018-12-19D,Race(5),,
9,0,5,3,8,1,0,1,2,0,2,2,4,1,7,6,14,0,0,1.0,M2018-12-19D,Race(5),,
10,0,2,2,4,0,0,0,0,0,1,1,2,0,3,3,6,0,0,0.0,M2018-12-19D,Race(5),,
11,8,2,2,12,4,7,14,25,5,8,5,18,17,17,21,55,0,0,0.0,M2018-12-19D,Race(5),,
12,0,0,0,0,0,0,0,0,0,0,1,1,0,0,1,1,0,0,0.0,M2018-12-19D,Race(5),,
1,2,6,0,8,12,4,3,19,1,4,1,6,15,14,4,33,0,0,0.0,M2018-12-19D,Race(6),,
2,6,2,2,10,5,10,3,18,11,3,2,16,22,15,7,44,0,0,0.0,M2018-12-19D,Race(6),,
3,2,0,0,2,1,1,1,3,0,1,2,3,3,2,3,8,0,0,0.0,M2018-12-19D,Race(6),,
4,2,0,11,13,1,1,2,4,4,1,2,7,7,2,15,24,0,0,2.0,M2018-12-19D,Race(6),,
5,0,7,2,9,4,6,10,20,2,6,4,12,6,19,16,41,0,0,0.0,M2018-12-19D,Race(6),,
6,0,0,3,3,1,0,1,2,0,1,2,3,1,1,6,8,0,0,0.0,M2018-12-19D,Race(6),,
7,12,9,0,21,3,2,4,9,4,1,6,11,19,12,10,41,0,0,0.0,M2018-12-19D,Race(6),,
8,0,0,0,0,1,2,3,6,1,2,2,5,2,4,5,11,0,0,3.0,M2018-12-19D,Race(6),,
9,0,0,0,0,0,0,0,0,0,0,0,0,0,0,0,0,0,0,1.0,M2018-12-19D,Race(6),,
10,0,0,7,7,0,2,1,3,1,3,2,6,1,5,10,16,0,0,0.0,M2018-12-19D,Race(6),,
11,0,0,0,0,0,0,0,0,0,0,0,0,0,0,0,0,0,0,0.0,M2018-12-19D,Race(6),,
12,6,6,5,17,2,2,2,6,2,4,3,9,10,12,10,32,0,0,0.0,M2018-12-19D,Race(6),,
1,6,7,8,21,3,4,5,12,6,8,4,18,15,19,17,51,0,0,0.0,M2018-12-19D,Race(7),,
2,0,2,5,7,0,3,4,7,1,2,3,6,1,7,12,20,0,0,0.0,M2018-12-19D,Race(7),,
3,0,0,0,0,0,0,0,0,0,0,0,0,0,0,0,0,0,0,0.0,M2018-12-19D,Race(7),,
4,2,0,2,4,0,0,1,1,0,0,2,2,2,0,5,7,0,0,0.0,M2018-12-19D,Race(7),,
5,10,5,7,22,22,3,2,27,15,2,4,21,47,10,13,70,0,0,0.0,M2018-12-19D,Race(7),,
6,0,0,0,0,0,0,0,0,0,0,1,1,0,0,1,1,0,0,0.0,M2018-12-19D,Race(7),,
7,8,5,5,18,0,13,5,18,4,4,4,12,12,22,14,48,0,0,1.0,M2018-12-19D,Race(7),,
8,0,6,0,6,3,5,11,19,0,8,4,12,3,19,15,37,0,0,0.0,M2018-12-19D,Race(7),,
9,0,0,0,0,0,0,0,0,0,0,0,0,0,0,0,0,0,0,2.0,M2018-12-19D,Race(7),,
10,4,5,3,12,2,2,2,6,0,2,4,6,6,9,9,24,0,0,3.0,M2018-12-19D,Race(7),,
11,0,0,0,0,0,0,0,0,0,0,0,0,0,0,0,0,0,0,0.0,M2018-12-19D,Race(7),,
12,0,0,0,0,0,0,0,0,0,0,0,0,0,0,0,0,0,0,0.0,M2018-12-19D,Race(7),,
1,0,4,8,12,0,3,3,6,2,3,4,9,2,10,15,27,0,0,0.0,M2018-12-19D,Race(8),,
2,4,6,8,18,5,4,11,20,5,6,5,16,14,16,24,54,0,0,1.0,M2018-12-19D,Race(8),,
3,2,0,0,2,0,0,0,0,0,0,0,0,2,0,0,2,0,0,0.0,M2018-12-19D,Race(8),,
4,0,5,0,5,0,1,1,2,0,2,2,4,0,8,3,11,0,0,3.0,M2018-12-19D,Race(8),,
5,0,0,0,0,0,0,0,0,0,0,0,0,0,0,0,0,0,0,0.0,M2018-12-19D,Race(8),,
6,3,0,0,3,20,4,2,26,0,0,0,0,23,4,2,29,0,0,0.0,M2018-12-19D,Race(8),,
7,0,0,3,3,0,0,1,1,0,0,1,1,0,0,5,5,0,0,0.0,M2018-12-19D,Race(8),,
8,6,6,6,18,1,1,4,6,1,3,4,8,8,10,14,32,0,0,0.0,M2018-12-19D,Race(8),,
9,0,2,0,2,0,3,2,5,0,2,0,2,0,7,2,9,0,0,0.0,M2018-12-19D,Race(8),,
10,13,7,2,22,4,14,6,24,2,5,6,13,19,26,14,59,0,0,0.0,M2018-12-19D,Race(8),,
11,0,0,0,0,0,0,0,0,0,0,0,0,0,0,0,0,0,0,2.0,M2018-12-19D,Race(8),,
12,2,0,3,5,0,0,0,0,0,1,1,2,2,1,4,7,0,0,0.0,M2018-12-19D,Race(8),,
1,11,3,6,20,16,2,1,19,14,3,3,20,41,8,10,59,4.6,4.6,1.0,M2018-12-23D,Race(1),,
2,8,0,0,8,0,8,1,9,1,0,0,1,9,8,1,18,15,15,0.0,M2018-12-23D,Race(1),,
3,0,4,0,4,0,0,0,0,1,1,0,2,1,5,0,6,17,17,0.0,M2018-12-23D,Race(1),,
4,0,6,11,17,3,9,3,15,6,6,3,15,9,21,17,47,5,5,0.0,M2018-12-23D,Race(1),,
5,4,0,8,12,0,1,2,3,0,4,2,6,4,5,12,21,12,12,3.0,M2018-12-23D,Race(1),,
6,0,0,0,0,0,0,0,0,0,0,0,0,0,0,0,0,71,67,0.0,M2018-12-23D,Race(1),,
7,0,3,0,3,0,3,3,6,2,3,7,12,2,9,10,21,6,6,0.0,M2018-12-23D,Race(1),,
8,0,5,0,5,8,1,1,10,0,1,2,3,8,7,3,18,15,15,0.0,M2018-12-23D,Race(1),,
9,0,0,0,0,0,3,2,5,0,1,2,3,0,4,4,8,12,12,2.0,M2018-12-23D,Race(1),,
10,0,0,0,0,0,0,8,8,0,0,2,2,0,0,10,10,19,19,0.0,M2018-12-23D,Race(1),,
11,7,9,5,21,3,3,6,12,2,7,5,14,12,19,16,47,3.1,3.5,0.0,M2018-12-23D,Race(1),,
1,2,0,3,5,0,1,2,3,1,1,2,4,3,2,7,12,19,19,0.0,M2018-12-23D,Race(10),,
2,3,2,3,8,1,2,2,5,0,0,2,2,4,4,7,15,9.5,9.5,3.0,M2018-12-23D,Race(10),,
3,0,2,0,2,8,1,0,9,1,4,1,6,9,7,1,17,11,11,0.0,M2018-12-23D,Race(10),,
4,0,0,0,0,0,0,0,0,0,0,0,0,0,0,0,0,26,26,0.0,M2018-12-23D,Race(10),,
5,0,0,0,0,0,0,0,0,0,0,0,0,0,0,0,0,51,51,0.0,M2018-12-23D,Race(10),,
6,12,5,7,24,8,6,8,22,9,4,1,14,29,15,16,60,3.8,3.8,0.0,M2018-12-23D,Race(10),,
7,0,0,0,0,0,0,0,0,0,0,0,0,0,0,0,0,61,61,0.0,M2018-12-23D,Race(10),,
8,10,8,4,22,9,7,6,22,10,8,4,22,29,23,14,66,4.8,4.5,1.0,M2018-12-23D,Race(10),,
9,0,3,0,3,0,8,3,11,1,2,6,9,1,13,9,23,7,7,0.0,M2018-12-23D,Race(10),,
10,3,8,8,19,3,4,9,16,2,5,10,17,8,17,27,52,6.5,6.5,0.0,M2018-12-23D,Race(10),,
11,0,0,0,0,0,0,0,0,0,0,0,0,0,0,0,0,61,61,0.0,M2018-12-23D,Race(10),,
12,0,0,0,0,0,0,0,0,0,0,0,0,0,0,0,0,41,41,0.0,M2018-12-23D,Race(10),,
13,0,0,5,5,1,1,0,2,2,2,0,4,3,3,5,11,7,7,2.0,M2018-12-23D,Race(10),,
14,0,2,0,2,0,0,0,0,0,0,0,0,0,2,0,2,31,31,0.0,M2018-12-23D,Race(10),,
1,0,0,3,3,8,0,0,8,1,0,2,3,9,0,5,14,10,10,0.0,M2018-12-23D,Race(2),,
2,8,7,2,17,0,11,6,17,6,6,8,20,14,24,16,54,6,6,0.0,M2018-12-23D,Race(2),,
3,0,0,3,3,2,1,3,6,3,0,2,5,5,1,8,14,12,12,3.0,M2018-12-23D,Race(2),,
4,15,4,3,22,20,3,0,23,16,3,2,21,51,10,5,66,4,4,1.0,M2018-12-23D,Race(2),,
5,0,0,0,0,0,8,0,8,0,0,0,0,0,8,0,8,13,14,2.0,M2018-12-23D,Race(2),,
6,2,3,0,5,0,0,1,1,0,2,1,3,2,5,2,9,8.5,8.5,0.0,M2018-12-23D,Race(2),,
7,0,12,7,19,0,6,7,13,0,12,5,17,0,30,19,49,6,6,0.0,M2018-12-23D,Race(2),,
8,2,4,3,9,0,1,2,3,0,2,3,5,2,7,8,17,12,12,0.0,M2018-12-23D,Race(2),,
9,0,0,0,0,0,0,8,8,0,0,0,0,0,0,8,8,21,21,0.0,M2018-12-23D,Race(2),,
10,3,0,9,12,0,0,3,3,0,1,3,4,3,1,15,19,4.8,4.8,0.0,M2018-12-23D,Race(2),,
1,12,16,0,28,18,4,1,23,19,3,3,25,49,23,4,76,1.6,1.6,1.0,M2018-12-23D,Race(3),,
2,15,12,3,30,4,17,2,23,4,20,0,24,23,49,5,77,3.5,3.5,0.0,M2018-12-23D,Race(3),,
3,3,2,20,25,8,1,18,27,2,1,17,20,13,4,55,72,8,8,0.0,M2018-12-23D,Race(3),,
4,0,0,3,3,0,8,0,8,0,2,3,5,0,10,6,16,10,10,0.0,M2018-12-23D,Race(3),,
5,0,0,0,0,0,0,0,0,0,0,0,0,0,0,0,0,51,51,0.0,M2018-12-23D,Race(3),,
6,0,0,0,0,0,0,1,1,0,0,0,0,0,0,1,1,14,14,2.0,M2018-12-23D,Race(3),,
7,0,0,2,2,0,0,0,0,0,0,0,0,0,0,2,2,51,51,3.0,M2018-12-23D,Race(3),,
8,0,0,2,2,0,0,8,8,1,0,3,4,1,0,13,14,17,17,0.0,M2018-12-23D,Race(3),,
1,8,12,8,28,10,8,7,25,3,10,5,18,21,30,20,71,6,6,0.0,M2018-12-23D,Race(4),,
2,13,5,4,22,10,6,5,21,15,4,2,21,38,15,11,64,2.7,2.7,2.0,M2018-12-23D,Race(4),,
3,0,0,2,2,0,1,0,1,0,0,0,0,0,1,2,3,17,17,0.0,M2018-12-23D,Race(4),,
4,0,0,0,0,0,0,1,1,1,0,0,1,1,0,1,2,18,18,3.0,M2018-12-23D,Race(4),,
5,0,0,0,0,0,0,0,0,0,0,0,0,0,0,0,0,31,31,0.0,M2018-12-23D,Race(4),,
6,2,0,0,2,0,0,2,2,0,1,2,3,2,1,4,7,17,17,0.0,M2018-12-23D,Race(4),,
7,0,5,2,7,0,2,1,3,0,2,3,5,0,9,6,15,10,10,0.0,M2018-12-23D,Race(4),,
8,7,6,6,19,10,5,5,20,7,7,6,20,24,18,17,59,7.5,8,1.0,M2018-12-23D,Race(4),,
9,0,0,3,3,0,0,0,0,0,0,1,1,0,0,4,4,19,19,0.0,M2018-12-23D,Race(4),,
10,0,0,3,3,0,0,8,8,0,0,1,1,0,0,12,12,12,12,0.0,M2018-12-23D,Race(4),,
11,0,0,2,2,0,8,1,9,0,1,3,4,0,9,6,15,15,15,0.0,M2018-12-23D,Race(4),,
12,0,0,0,0,0,0,0,0,0,0,0,0,0,0,0,0,34,34,0.0,M2018-12-23D,Race(4),,
13,0,2,0,2,0,0,0,0,0,0,0,0,0,2,0,2,26,26,0.0,M2018-12-23D,Race(4),,
14,0,0,0,0,0,0,0,0,0,1,3,4,0,1,3,4,17,17,0.0,M2018-12-23D,Race(4),,
1,3,3,7,13,9,3,4,16,1,2,5,8,13,8,16,37,6.5,6.5,0.0,M2018-12-23D,Race(5),,
2,0,0,0,0,0,0,1,1,0,0,0,0,0,0,1,1,31,31,0.0,M2018-12-23D,Race(5),,
3,10,5,8,23,8,12,3,23,15,7,2,24,33,24,13,70,5,5,0.0,M2018-12-23D,Race(5),,
4,8,15,2,25,9,4,8,21,7,8,7,22,24,27,17,68,4.2,4.2,0.0,M2018-12-23D,Race(5),,
5,0,0,0,0,0,0,0,0,0,0,0,0,0,0,0,0,34,34,0.0,M2018-12-23D,Race(5),,
6,0,0,0,0,0,0,0,0,0,0,0,0,0,0,0,0,81,81,0.0,M2018-12-23D,Race(5),,
7,5,2,7,14,4,2,4,10,3,6,6,15,12,10,17,39,4.8,4.5,1.0,M2018-12-23D,Race(5),,
8,0,0,0,0,0,0,0,0,0,0,0,0,0,0,0,0,31,31,0.0,M2018-12-23D,Race(5),,
9,0,0,0,0,0,0,0,0,0,0,0,0,0,0,0,0,41,41,0.0,M2018-12-23D,Race(5),,
10,0,0,0,0,0,0,1,1,0,0,2,2,0,0,3,3,19,19,0.0,M2018-12-23D,Race(5),,
11,0,2,3,5,0,9,1,10,0,2,0,2,0,13,4,17,10,10,2.0,M2018-12-23D,Race(5),,
12,0,0,3,3,0,0,0,0,0,0,0,0,0,0,3,3,16,16,0.0,M2018-12-23D,Race(5),,
13,0,3,0,3,0,0,0,0,0,0,0,0,0,3,0,3,18,18,0.0,M2018-12-23D,Race(5),,
14,4,0,0,4,0,0,8,8,0,1,4,5,4,1,12,17,9.5,9.5,3.0,M2018-12-23D,Race(5),,
1,0,5,3,8,3,5,2,10,5,5,1,11,8,15,6,29,6.5,6.5,0.0,M2018-12-23D,Race(6),,
2,0,0,0,0,0,0,0,0,1,0,0,1,1,0,0,1,71,67,0.0,M2018-12-23D,Race(6),,
3,0,2,0,2,0,0,1,1,0,0,2,2,0,2,3,5,41,41,0.0,M2018-12-23D,Race(6),,
4,10,3,5,18,9,3,1,13,1,0,1,2,20,6,7,33,6.5,6.5,2.0,M2018-12-23D,Race(6),,
5,0,2,0,2,0,0,0,0,0,1,0,1,0,3,0,3,51,51,0.0,M2018-12-23D,Race(6),,
6,6,3,9,18,8,5,5,18,9,7,4,20,23,15,18,56,3.3,3.3,0.0,M2018-12-23D,Race(6),,
7,0,0,0,0,0,0,0,0,0,0,0,0,0,0,0,0,61,61,0.0,M2018-12-23D,Race(6),,
8,2,0,0,2,0,10,1,11,1,1,3,5,3,11,4,18,12,12,0.0,M2018-12-23D,Race(6),,
9,0,5,0,5,0,0,8,8,0,0,1,1,0,5,9,14,41,41,0.0,M2018-12-23D,Race(6),,
10,7,0,8,15,5,5,6,16,5,6,7,18,17,11,21,49,4.2,4.2,1.0,M2018-12-23D,Race(6),,
11,0,0,0,0,0,0,0,0,0,0,0,0,0,0,0,0,71,67,0.0,M2018-12-23D,Race(6),,
12,0,0,0,0,0,0,0,0,0,0,0,0,0,0,0,0,101,101,0.0,M2018-12-23D,Race(6),,
13,0,0,0,0,0,0,0,0,0,2,1,3,0,2,1,3,21,21,0.0,M2018-12-23D,Race(6),,
14,5,10,5,20,5,2,6,13,4,4,6,14,14,16,17,47,5,5,3.0,M2018-12-23D,Race(6),,
1,0,4,3,7,8,3,6,17,2,5,8,15,10,12,17,39,10,10,0.0,M2018-12-23D,Race(7),,
2,4,0,3,7,4,1,6,11,3,4,8,15,11,5,17,33,5.5,5,3.0,M2018-12-23D,Race(7),,
3,0,0,0,0,0,0,0,0,0,1,0,1,0,1,0,1,31,31,0.0,M2018-12-23D,Race(7),,
4,0,7,11,18,1,4,5,10,1,5,5,11,2,16,21,39,8,8,0.0,M2018-12-23D,Race(7),,
5,16,3,9,28,9,7,3,19,12,6,2,20,37,16,14,67,3,3,1.0,M2018-12-23D,Race(7),,
6,10,14,4,28,8,7,10,25,8,5,3,16,26,26,17,69,2.9,2.9,0.0,M2018-12-23D,Race(7),,
7,0,2,0,2,0,8,0,8,0,0,0,0,0,10,0,10,18,18,2.0,M2018-12-23D,Race(7),,
8,0,0,0,0,0,0,0,0,0,0,0,0,0,0,0,0,12,12,0.0,M2018-12-23D,Race(7),,
9,0,0,0,0,0,0,0,0,0,0,0,0,0,0,0,0,15,15,0.0,M2018-12-23D,Race(7),,
1,0,0,0,0,0,8,0,8,1,1,0,2,1,9,0,10,16,16,0.0,M2018-12-23D,Race(8),,
2,0,0,0,0,0,0,0,0,0,0,0,0,0,0,0,0,71,71,0.0,M2018-12-23D,Race(8),,
3,2,2,0,4,2,1,1,4,7,4,2,13,11,7,3,21,9,9,0.0,M2018-12-23D,Race(8),,
4,4,2,0,6,3,1,3,7,2,0,2,4,9,3,5,17,12,12,0.0,M2018-12-23D,Race(8),,
5,0,0,0,0,0,0,0,0,1,0,1,2,1,0,1,2,13,15,0.0,M2018-12-23D,Race(8),,
6,8,3,6,17,6,3,9,18,8,4,7,19,22,10,22,54,8.5,8.5,1.0,M2018-12-23D,Race(8),,
7,0,0,0,0,0,0,0,0,0,0,0,0,0,0,0,0,34,51,0.0,M2018-12-23D,Race(8),,
8,6,10,4,20,5,12,3,20,2,11,5,18,13,33,12,58,2.8,2.8,2.0,M2018-12-23D,Race(8),,
9,3,5,11,19,4,3,4,11,2,4,5,11,9,12,20,41,5,5,0.0,M2018-12-23D,Race(8),,
10,0,2,2,4,8,0,0,8,1,1,1,3,9,3,3,15,15,15,0.0,M2018-12-23D,Race(8),,
11,3,0,2,5,1,2,0,3,0,1,0,1,4,3,2,9,21,21,3.0,M2018-12-23D,Race(8),,
12,0,3,2,5,0,0,8,8,1,0,2,3,1,3,12,16,14,14,0.0,M2018-12-23D,Race(8),,
13,2,3,0,5,1,0,2,3,1,0,1,2,4,3,3,10,21,21,0.0,M2018-12-23D,Race(8),,
14,2,0,3,5,0,0,0,0,0,0,0,0,2,0,3,5,31,31,0.0,M2018-12-23D,Race(8),,
1,0,8,6,14,8,2,5,15,1,1,5,7,9,11,16,36,6.5,6.5,0.0,M2018-12-23D,Race(9),,
2,0,10,4,14,0,5,7,12,0,5,8,13,0,20,19,39,7,7,0.0,M2018-12-23D,Race(9),,
3,0,0,0,0,0,0,3,3,1,1,3,5,1,1,6,8,11,11,0.0,M2018-12-23D,Race(9),,
4,7,5,13,25,2,12,3,17,4,12,4,20,13,29,20,62,6.5,6.5,3.0,M2018-12-23D,Race(9),,
5,0,2,0,2,0,0,0,0,0,1,0,1,0,3,0,3,26,26,0.0,M2018-12-23D,Race(9),,
6,23,3,2,28,20,3,0,23,19,6,0,25,62,12,2,76,2.9,2.9,1.0,M2018-12-23D,Race(9),,
7,0,0,0,0,0,0,0,0,0,0,0,0,0,0,0,0,34,34,0.0,M2018-12-23D,Race(9),,
8,0,0,2,2,0,0,9,9,1,0,2,3,1,0,13,14,16,16,0.0,M2018-12-23D,Race(9),,
9,0,0,0,0,0,8,0,8,0,0,0,0,0,8,0,8,34,34,0.0,M2018-12-23D,Race(9),,
10,0,2,0,2,0,0,0,0,0,0,1,1,0,2,1,3,9,9,0.0,M2018-12-23D,Race(9),,
11,0,0,3,3,0,3,0,3,0,0,3,3,0,3,6,9,13,13,2.0,M2018-12-23D,Race(9),,
12,0,0,0,0,0,0,0,0,0,0,0,0,0,0,0,0,16,16,0.0,M2018-12-23D,Race(9),,
1,6,2,5,13,4,2,7,13,6,2,8,16,16,6,20,42,6,6,0.0,M2018-12-26D,Race(1),,
2,0,0,0,0,0,0,0,0,0,0,0,0,0,0,0,0,34,35,0.0,M2018-12-26D,Race(1),,
3,8,2,5,15,12,7,3,22,8,3,4,15,28,12,12,52,4.2,4.2,2.0,M2018-12-26D,Race(1),,
4,0,2,6,8,7,3,4,14,6,2,2,10,13,7,12,32,7.5,7.5,0.0,M2018-12-26D,Race(1),,
5,2,2,3,7,1,2,1,4,2,4,2,8,5,8,6,19,8,8,1.0,M2018-12-26D,Race(1),,
6,6,4,3,13,2,6,0,8,4,6,0,10,12,16,3,31,8.5,8.5,0.0,M2018-12-26D,Race(1),,
7,8,6,2,16,2,6,10,18,0,5,9,14,10,17,21,48,6.5,6.5,0.0,M2018-12-26D,Race(1),,
8,0,0,0,0,0,0,0,0,0,0,0,0,0,0,0,0,17,17,0.0,M2018-12-26D,Race(1),,
9,0,12,6,18,2,4,5,11,0,4,1,5,2,20,12,34,4,4,3.0,M2018-12-26D,Race(1),,
1,0,3,0,3,2,5,5,12,0,2,5,7,2,10,10,22,12,12,0.0,M2018-12-26D,Race(2),,
2,0,0,2,2,0,0,0,0,1,1,0,2,1,1,2,4,12,12,0.0,M2018-12-26D,Race(2),,
3,0,0,0,0,0,0,0,0,0,0,1,1,0,0,1,1,101,91,0.0,M2018-12-26D,Race(2),,
4,0,0,0,0,0,0,1,1,0,1,0,1,0,1,1,2,13,11,0.0,M2018-12-26D,Race(2),,
5,17,6,0,23,14,9,3,26,9,13,1,23,40,28,4,72,4.2,4.2,0.0,M2018-12-26D,Race(2),,
6,0,7,3,10,3,9,6,18,4,5,5,14,7,21,14,42,7.5,7.5,0.0,M2018-12-26D,Race(2),,
7,3,9,3,15,6,3,7,16,9,1,4,14,18,13,14,45,4,4,3.0,M2018-12-26D,Race(2),,
8,0,0,0,0,1,1,2,4,0,0,1,1,1,1,3,5,19,17,0.0,M2018-12-26D,Race(2),,
9,5,2,10,17,3,3,5,11,3,3,8,14,11,8,23,42,4.6,4.6,1.0,M2018-12-26D,Race(2),,
10,5,3,12,20,1,0,1,2,1,0,1,2,7,3,14,24,7.5,7.5,2.0,M2018-12-26D,Race(2),,
1,5,13,7,25,9,5,1,15,6,2,5,13,20,20,13,53,5,5,3.0,M2018-12-26D,Race(3),,
2,0,3,0,3,0,2,2,4,0,1,0,1,0,6,2,8,34,34,0.0,M2018-12-26D,Race(3),,
3,3,3,4,10,5,0,4,9,5,3,4,12,13,6,12,31,9,9,0.0,M2018-12-26D,Race(3),,
4,6,0,5,11,5,5,3,13,4,6,2,12,15,11,10,36,9,9,0.0,M2018-12-26D,Race(3),,
5,0,0,0,0,0,0,0,0,0,0,0,0,0,0,0,0,13,13,0.0,M2018-12-26D,Race(3),,
6,0,0,0,0,0,0,0,0,0,0,1,1,0,0,1,1,31,31,0.0,M2018-12-26D,Race(3),,
7,4,0,0,4,2,1,3,6,1,2,2,5,7,3,5,15,7.5,7.5,0.0,M2018-12-26D,Race(3),,
8,7,7,3,17,6,9,9,24,4,8,7,19,17,24,19,60,3.6,3.6,1.0,M2018-12-26D,Race(3),,
9,3,4,8,15,3,5,5,13,5,2,2,9,11,11,15,37,7.5,7.5,2.0,M2018-12-26D,Race(3),,
10,0,0,3,3,0,1,3,4,0,0,2,2,0,1,8,9,12,12,0.0,M2018-12-26D,Race(3),,
11,2,0,0,2,0,2,0,2,0,0,1,1,2,2,1,5,15,15,0.0,M2018-12-26D,Race(3),,
12,0,0,0,0,0,0,0,0,0,0,0,0,0,0,0,0,34,34,0.0,M2018-12-26D,Race(3),,
1,0,15,7,22,4,7,4,15,2,5,8,15,6,27,19,52,9.5,9.5,0.0,M2018-12-26D,Race(4),,
2,27,3,0,30,26,4,0,30,23,1,0,24,76,8,0,84,1.5,1.5,2.0,M2018-12-26D,Race(4),,
3,0,2,7,9,0,7,5,12,0,8,3,11,0,17,15,32,16,16,0.0,M2018-12-26D,Race(4),,
4,0,0,0,0,0,1,2,3,0,2,0,2,0,3,2,5,19,19,0.0,M2018-12-26D,Race(4),,
5,3,6,8,17,0,10,9,19,1,7,7,15,4,23,24,51,7,7,1.0,M2018-12-26D,Race(4),,
6,0,0,0,0,0,0,0,0,0,1,2,3,0,1,2,3,26,26,0.0,M2018-12-26D,Race(4),,
7,0,2,2,4,0,0,4,4,0,1,3,4,0,3,9,12,21,21,0.0,M2018-12-26D,Race(4),,
8,0,0,6,6,0,0,0,0,0,0,0,0,0,0,6,6,17,17,0.0,M2018-12-26D,Race(4),,
9,0,0,0,0,0,0,2,2,0,0,0,0,0,0,2,2,61,61,0.0,M2018-12-26D,Race(4),,
10,0,2,0,2,0,0,2,2,0,0,3,3,0,2,5,7,21,21,0.0,M2018-12-26D,Race(4),,
11,0,0,0,0,0,1,2,3,0,1,0,1,0,2,2,4,26,26,3.0,M2018-12-26D,Race(4),,
12,0,0,0,0,0,0,0,0,0,0,0,0,0,0,0,0,61,61,0.0,M2018-12-26D,Race(4),,
1,18,3,0,21,13,8,4,25,11,10,3,24,42,21,7,70,3.9,3.9,0.0,M2018-12-26D,Race(5),,
2,0,0,0,0,0,0,1,1,0,0,1,1,0,0,2,2,17,17,0.0,M2018-12-26D,Race(5),,
3,0,4,0,4,2,5,4,11,0,1,1,2,2,10,5,17,11,11,0.0,M2018-12-26D,Race(5),,
4,2,8,3,13,7,2,3,12,4,4,2,10,13,14,8,35,4.8,4.8,2.0,M2018-12-26D,Race(5),,
5,3,0,8,11,0,0,3,3,2,0,2,4,5,0,13,18,7.5,7.5,1.0,M2018-12-26D,Race(5),,
6,2,10,0,12,0,10,8,18,1,5,7,13,3,25,15,43,15,15,0.0,M2018-12-26D,Race(5),,
7,0,0,8,8,4,0,0,4,4,2,2,8,8,2,10,20,10,10,0.0,M2018-12-26D,Race(5),,
8,5,0,9,14,4,4,5,13,4,2,6,12,13,6,20,39,9,9,0.0,M2018-12-26D,Race(5),,
9,0,0,0,0,0,0,0,0,0,0,0,0,0,0,0,0,19,19,0.0,M2018-12-26D,Race(5),,
10,0,3,2,5,0,0,0,0,0,1,1,2,0,4,3,7,10,10,0.0,M2018-12-26D,Race(5),,
11,0,0,0,0,0,0,0,0,0,0,0,0,0,0,0,0,41,41,0.0,M2018-12-26D,Race(5),,
12,0,2,0,2,0,1,2,3,0,1,1,2,0,4,3,7,8,8,3.0,M2018-12-26D,Race(5),,
1,9,0,2,11,3,2,3,8,3,3,2,8,15,5,7,27,6,6,0.0,M2018-12-26D,Race(6),,
2,0,4,3,7,0,1,1,2,1,2,2,5,1,7,6,14,15,15,0.0,M2018-12-26D,Race(6),,
3,2,9,7,18,2,7,6,15,2,9,2,13,6,25,15,46,6,6,1.0,M2018-12-26D,Race(6),,
4,6,3,9,18,12,5,5,22,9,3,6,18,27,11,20,58,5,5,2.0,M2018-12-26D,Race(6),,
5,0,2,0,2,2,2,0,4,1,1,0,2,3,5,0,8,17,17,0.0,M2018-12-26D,Race(6),,
6,5,3,3,11,0,2,4,6,1,1,4,6,6,6,11,23,4.7,4.7,0.0,M2018-12-26D,Race(6),,
7,0,0,0,0,0,0,0,0,0,0,0,0,0,0,0,0,34,34,0.0,M2018-12-26D,Race(6),,
8,0,0,0,0,0,0,2,2,1,0,2,3,1,0,4,5,21,21,0.0,M2018-12-26D,Race(6),,
9,0,3,3,6,0,3,4,7,1,2,1,4,1,8,8,17,12,12,0.0,M2018-12-26D,Race(6),,
10,8,6,3,17,11,8,5,24,7,5,7,19,26,19,15,60,3.9,3.9,3.0,M2018-12-26D,Race(6),,
11,0,0,0,0,0,0,0,0,0,0,0,0,0,0,0,0,61,61,0.0,M2018-12-26D,Race(6),,
12,0,0,0,0,0,0,0,0,0,0,0,0,0,0,0,0,21,21,0.0,M2018-12-26D,Race(6),,
1,0,0,2,2,0,1,5,6,0,0,5,5,0,1,12,13,21,21,0.0,M2018-12-26D,Race(7),,
2,0,0,6,6,5,4,10,19,9,3,4,16,14,7,20,41,10,10,0.0,M2018-12-26D,Race(7),,
3,0,0,0,0,0,0,0,0,0,0,0,0,0,0,0,0,61,61,0.0,M2018-12-26D,Race(7),,
4,0,10,7,17,2,2,2,6,0,1,5,6,2,13,14,29,8,8,0.0,M2018-12-26D,Race(7),,
5,7,8,5,20,13,9,3,25,9,11,2,22,29,28,10,67,3.1,3.1,2.0,M2018-12-26D,Race(7),,
6,0,0,0,0,3,0,1,4,2,0,0,2,5,0,1,6,8.5,8.5,0.0,M2018-12-26D,Race(7),,
7,13,7,2,22,7,5,2,14,5,4,2,11,25,16,6,47,4,4,1.0,M2018-12-26D,Race(7),,
8,0,3,0,3,0,2,2,4,0,1,2,3,0,6,4,10,21,21,0.0,M2018-12-26D,Race(7),,
9,8,2,3,13,0,2,2,4,1,0,2,3,9,4,7,20,8.5,8.5,0.0,M2018-12-26D,Race(7),,
10,2,0,3,5,0,5,2,7,0,6,2,8,2,11,7,20,10,10,0.0,M2018-12-26D,Race(7),,
11,0,0,2,2,0,0,0,0,0,0,0,0,0,0,2,2,34,34,0.0,M2018-12-26D,Race(7),,
12,0,0,0,0,0,0,1,1,0,0,2,2,0,0,3,3,26,26,3.0,M2018-12-26D,Race(7),,
1,0,0,0,0,0,0,0,0,0,0,0,0,0,0,0,0,34,34,0.0,M2018-12-26D,Race(8),,
2,3,8,7,18,9,13,5,27,8,12,2,22,20,33,14,67,6,6,0.0,M2018-12-26D,Race(8),,
3,5,0,2,7,2,2,4,8,2,2,4,8,9,4,10,23,10,10,0.0,M2018-12-26D,Race(8),,
4,15,10,5,30,15,8,1,24,14,9,2,25,44,27,8,79,2.25,2.25,2.0,M2018-12-26D,Race(8),,
5,2,0,0,2,0,0,3,3,0,0,1,1,2,0,4,6,21,21,1.0,M2018-12-26D,Race(8),,
6,0,2,0,2,0,0,0,0,0,0,0,0,0,2,0,2,26,26,0.0,M2018-12-26D,Race(8),,
7,0,2,3,5,0,2,4,6,0,0,0,0,0,4,7,11,13,13,0.0,M2018-12-26D,Race(8),,
8,0,0,0,0,0,0,0,0,1,0,2,3,1,0,2,3,31,31,0.0,M2018-12-26D,Race(8),,
9,2,3,2,7,0,0,4,4,0,0,7,7,2,3,13,18,7,7,3.0,M2018-12-26D,Race(8),,
10,3,3,8,14,2,3,9,14,0,1,7,8,5,7,24,36,9,9,0.0,M2018-12-26D,Race(8),,
11,0,0,0,0,0,0,0,0,0,0,0,0,0,0,0,0,31,31,0.0,M2018-12-26D,Race(8),,
12,0,2,3,5,0,0,0,0,0,0,0,0,0,2,3,5,13,13,0.0,M2018-12-26D,Race(8),,
1,10,18,0,28,10,8,1,19,11,8,2,21,31,34,3,68,3.5,3.4,0.0,M2018-12-29D,Race(1),,
2,20,6,2,28,10,10,2,22,10,10,3,23,40,26,7,73,1.9,1.9,3.0,M2018-12-29D,Race(1),,
3,0,2,3,5,4,1,0,5,3,1,0,4,7,4,3,14,20,17,0.0,M2018-12-29D,Race(1),,
4,0,0,0,0,0,0,0,0,0,2,0,2,0,2,0,2,31,26,1.0,M2018-12-29D,Race(1),,
5,0,0,3,3,4,0,5,9,1,0,4,5,5,0,12,17,12,12,0.0,M2018-12-29D,Race(1),,
6,0,0,0,0,0,0,4,4,0,1,4,5,0,1,8,9,13,13,0.0,M2018-12-29D,Race(1),,
7,0,0,2,2,0,0,0,0,1,0,0,1,1,0,2,3,61,61,0.0,M2018-12-29D,Race(1),,
8,0,4,17,21,2,3,10,15,0,4,11,15,2,11,38,51,6.5,6.5,2.0,M2018-12-29D,Race(1),,
9,0,0,3,3,0,8,8,16,0,0,2,2,0,8,13,21,17,17,0.0,M2018-12-29D,Race(1),,
1,0,2,0,2,0,1,0,1,0,1,0,1,0,4,0,4,15,15,0.0,M2018-12-29D,Race(10),,
2,0,0,0,0,0,0,0,0,0,0,2,2,0,0,2,2,51,51,0.0,M2018-12-29D,Race(10),,
3,0,0,0,0,0,4,5,9,0,4,5,9,0,8,10,18,12,12,0.0,M2018-12-29D,Race(10),,
4,5,2,11,18,0,2,8,10,2,3,8,13,7,7,27,41,8.5,8.5,0.0,M2018-12-29D,Race(10),,
5,20,5,5,30,19,3,1,23,19,5,0,24,58,13,6,77,2.1,2.1,2.0,M2018-12-29D,Race(10),,
6,0,0,0,0,0,0,0,0,0,1,0,1,0,1,0,1,71,67,0.0,M2018-12-29D,Race(10),,
7,2,0,2,4,0,0,0,0,2,0,1,3,4,0,3,7,51,51,0.0,M2018-12-29D,Race(10),,
8,0,3,0,3,0,0,2,2,0,0,2,2,0,3,4,7,21,21,0.0,M2018-12-29D,Race(10),,
9,3,18,5,26,7,15,7,29,3,12,4,19,13,45,16,74,3.5,3.5,1.0,M2018-12-29D,Race(10),,
10,0,0,2,2,0,0,0,0,0,0,0,0,0,0,2,2,51,51,0.0,M2018-12-29D,Race(10),,
11,0,0,0,0,0,0,0,0,0,0,0,0,0,0,0,0,81,81,0.0,M2018-12-29D,Race(10),,
12,0,0,2,2,0,0,0,0,0,0,2,2,0,0,4,4,26,26,0.0,M2018-12-29D,Race(10),,
13,0,0,3,3,4,5,4,13,0,0,0,0,4,5,7,16,17,17,3.0,M2018-12-29D,Race(10),,
14,0,0,0,0,0,0,3,3,0,0,2,2,0,0,5,5,26,26,0.0,M2018-12-29D,Race(10),,
1,12,2,5,19,4,3,4,11,5,1,3,9,21,6,12,39,6,6,0.0,M2018-12-29D,Race(2),,
2,0,0,0,0,0,0,0,0,0,0,0,0,0,0,0,0,34,41,0.0,M2018-12-29D,Race(2),,
3,0,0,0,0,0,2,0,2,2,2,0,4,2,4,0,6,23,23,0.0,M2018-12-29D,Race(2),,
4,0,7,6,13,3,3,3,9,1,4,3,8,4,14,12,30,8,8,2.0,M2018-12-29D,Race(2),,
5,9,3,8,20,8,2,0,10,6,2,2,10,23,7,10,40,4.2,4.2,0.0,M2018-12-29D,Race(2),,
6,0,0,4,4,8,8,8,24,0,3,0,3,8,11,12,31,10,10,0.0,M2018-12-29D,Race(2),,
7,0,0,0,0,0,0,0,0,0,0,0,0,0,0,0,0,51,51,0.0,M2018-12-29D,Race(2),,
8,2,0,0,2,0,0,0,0,0,0,0,0,2,0,0,2,26,26,0.0,M2018-12-29D,Race(2),,
9,0,0,0,0,0,0,0,0,0,0,0,0,0,0,0,0,34,31,0.0,M2018-12-29D,Race(2),,
10,2,2,2,6,0,1,2,3,1,3,9,13,3,6,13,22,5.5,5.5,3.0,M2018-12-29D,Race(2),,
11,0,13,2,15,5,3,5,13,8,4,5,17,13,20,12,45,5.5,5.5,1.0,M2018-12-29D,Race(2),,
12,5,3,3,11,2,8,8,18,3,7,4,14,10,18,15,43,7,7,0.0,M2018-12-29D,Race(2),,
1,17,4,0,21,9,5,6,20,11,6,6,23,37,15,12,64,3.9,3.9,0.0,M2018-12-29D,Race(3),,
2,0,0,0,0,0,0,0,0,0,0,0,0,0,0,0,0,91,81,0.0,M2018-12-29D,Race(3),,
3,0,2,5,7,8,8,9,25,0,0,1,1,8,10,15,33,11,11,0.0,M2018-12-29D,Race(3),,
4,6,11,9,26,11,8,2,21,12,8,2,22,29,27,13,69,3,3,0.0,M2018-12-29D,Race(3),,
5,3,0,0,3,0,1,0,1,0,0,0,0,3,1,0,4,15,14,0.0,M2018-12-29D,Race(3),,
6,4,0,5,9,2,4,4,10,1,5,5,11,7,9,14,30,7,7,2.0,M2018-12-29D,Race(3),,
7,0,2,3,5,0,0,2,2,1,0,1,2,1,2,6,9,13,13,3.0,M2018-12-29D,Race(3),,
8,0,6,2,8,0,2,3,5,1,5,5,11,1,13,10,24,7.5,7.5,0.0,M2018-12-29D,Race(3),,
9,0,0,0,0,0,0,1,1,0,0,3,3,0,0,4,4,34,34,0.0,M2018-12-29D,Race(3),,
10,0,0,0,0,0,0,0,0,0,0,0,0,0,0,0,0,71,67,0.0,M2018-12-29D,Race(3),,
11,0,5,6,11,0,2,3,5,0,1,3,4,0,8,12,20,9,9,0.0,M2018-12-29D,Race(3),,
12,0,0,0,0,0,0,0,0,0,1,0,1,0,1,0,1,41,41,1.0,M2018-12-29D,Race(3),,
1,0,0,0,0,1,0,0,1,0,0,0,0,1,0,0,1,26,26,2.0,M2018-12-29D,Race(4),,
2,6,2,2,10,2,0,1,3,4,0,3,7,12,2,6,20,15,15,1.0,M2018-12-29D,Race(4),,
3,5,5,3,13,9,11,12,32,4,3,5,12,18,19,20,57,5.5,5.5,0.0,M2018-12-29D,Race(4),,
4,0,0,0,0,0,0,1,1,2,0,2,4,2,0,3,5,71,67,0.0,M2018-12-29D,Race(4),,
5,0,0,0,0,0,0,0,0,0,1,0,1,0,1,0,1,26,26,0.0,M2018-12-29D,Race(4),,
6,6,6,5,17,5,7,4,16,5,8,4,17,16,21,13,50,4.8,4.8,0.0,M2018-12-29D,Race(4),,
7,9,7,9,25,8,8,4,20,6,10,4,20,23,25,17,65,3,3,0.0,M2018-12-29D,Race(4),,
8,2,0,0,2,1,0,2,3,1,0,0,1,4,0,2,6,14,14,3.0,M2018-12-29D,Race(4),,
9,0,8,6,14,3,2,4,9,4,3,5,12,7,13,15,35,7.5,7.5,0.0,M2018-12-29D,Race(4),,
10,0,0,3,3,1,0,2,3,0,0,2,2,1,0,7,8,13,13,0.0,M2018-12-29D,Race(4),,
11,0,2,0,2,0,1,0,1,0,1,0,1,0,4,0,4,26,26,0.0,M2018-12-29D,Race(4),,
12,2,0,2,4,0,0,0,0,0,0,0,0,2,0,2,4,21,21,0.0,M2018-12-29D,Race(4),,
13,0,0,0,0,0,0,0,0,0,0,0,0,0,0,0,0,101,101,0.0,M2018-12-29D,Race(4),,
14,0,0,0,0,0,1,0,1,0,0,1,1,0,1,1,2,26,26,0.0,M2018-12-29D,Race(4),,
1,0,0,5,5,0,1,1,2,0,0,2,2,0,1,8,9,13,13,0.0,M2018-12-29D,Race(5),,
2,2,2,6,10,1,3,3,7,1,3,2,6,4,8,11,23,6,6,3.0,M2018-12-29D,Race(5),,
3,17,13,0,30,16,4,1,21,19,3,0,22,52,20,1,73,2.45,2.45,2.0,M2018-12-29D,Race(5),,
4,0,0,3,3,0,0,4,4,0,0,5,5,0,0,12,12,26,26,1.0,M2018-12-29D,Race(5),,
5,3,0,0,3,0,0,0,0,0,0,0,0,3,0,0,3,18,18,0.0,M2018-12-29D,Race(5),,
6,0,0,0,0,0,0,0,0,0,1,1,2,0,1,1,2,34,34,0.0,M2018-12-29D,Race(5),,
7,0,0,0,0,0,0,0,0,0,0,0,0,0,0,0,0,126,126,0.0,M2018-12-29D,Race(5),,
8,0,3,0,3,0,0,0,0,0,0,2,2,0,3,2,5,34,34,0.0,M2018-12-29D,Race(5),,
9,0,2,2,4,0,0,0,0,0,0,0,0,0,2,2,4,13,13,0.0,M2018-12-29D,Race(5),,
10,0,2,3,5,0,0,0,0,0,0,0,0,0,2,3,5,26,26,0.0,M2018-12-29D,Race(5),,
11,0,0,0,0,0,1,0,1,0,1,1,2,0,2,1,3,21,21,0.0,M2018-12-29D,Race(5),,
12,8,8,7,23,5,10,10,25,3,10,7,20,16,28,24,68,4.4,4.4,0.0,M2018-12-29D,Race(5),,
13,0,0,2,2,0,1,0,1,0,0,0,0,0,1,2,3,17,17,0.0,M2018-12-29D,Race(5),,
14,0,0,2,2,0,0,0,0,0,0,1,1,0,0,3,3,26,26,0.0,M2018-12-29D,Race(5),,
1,3,0,0,3,0,1,2,3,0,0,1,1,3,1,3,7,12,11,0.0,M2018-12-29D,Race(6),,
2,2,10,3,15,7,10,8,25,1,5,4,10,10,25,15,50,8.5,8.5,0.0,M2018-12-29D,Race(6),,
3,3,0,6,9,6,5,5,16,5,4,3,12,14,9,14,37,7,7,0.0,M2018-12-29D,Race(6),,
4,0,0,0,0,1,0,1,2,1,0,0,1,2,0,1,3,23,21,0.0,M2018-12-29D,Race(6),,
5,0,0,0,0,0,1,0,1,0,1,1,2,0,2,1,3,18,17,0.0,M2018-12-29D,Race(6),,
6,0,0,0,0,0,0,0,0,0,2,0,2,0,2,0,2,61,41,0.0,M2018-12-29D,Race(6),,
7,0,2,0,2,0,3,0,3,0,3,2,5,0,8,2,10,9.5,10,3.0,M2018-12-29D,Race(6),,
8,0,3,0,3,0,1,2,3,0,1,4,5,0,5,6,11,26,21,2.0,M2018-12-29D,Race(6),,
9,4,3,8,15,2,3,8,13,1,4,7,12,7,10,23,40,7.5,7.5,0.0,M2018-12-29D,Race(6),,
10,0,0,0,0,0,0,0,0,0,0,0,0,0,0,0,0,126,101,0.0,M2018-12-29D,Race(6),,
11,15,10,5,30,14,5,1,20,18,3,1,22,47,18,7,72,2.8,2.8,1.0,M2018-12-29D,Race(6),,
12,3,0,2,5,0,0,1,1,0,1,0,1,3,1,3,7,19,19,0.0,M2018-12-29D,Race(6),,
13,0,2,6,8,0,1,2,3,0,2,3,5,0,5,11,16,12,12,0.0,M2018-12-29D,Race(6),,
14,0,0,0,0,0,0,0,0,0,0,0,0,0,0,0,0,26,26,0.0,M2018-12-29D,Race(6),,
1,2,2,14,18,7,6,8,21,7,5,8,20,16,13,30,59,5,5,0.0,M2018-12-29D,Race(7),,
2,3,0,2,5,0,1,3,4,1,2,3,6,4,3,8,15,17,17,0.0,M2018-12-29D,Race(7),,
3,0,0,3,3,0,1,0,1,1,0,1,2,1,1,4,6,16,16,0.0,M2018-12-29D,Race(7),,
4,12,11,7,30,8,8,4,20,10,10,2,22,30,29,13,72,2.7,2.7,3.0,M2018-12-29D,Race(7),,
5,3,0,0,3,0,0,0,0,0,0,1,1,3,0,1,4,26,26,0.0,M2018-12-29D,Race(7),,
6,8,15,2,25,10,9,12,31,6,8,8,22,24,32,22,78,2.7,2.7,1.0,M2018-12-29D,Race(7),,
7,2,0,2,4,0,2,0,2,0,1,1,2,2,3,3,8,21,21,0.0,M2018-12-29D,Race(7),,
8,0,0,0,0,5,3,3,11,1,0,0,1,6,3,3,12,18,18,2.0,M2018-12-29D,Race(7),,
9,0,0,0,0,0,0,0,0,0,0,0,0,0,0,0,0,51,51,0.0,M2018-12-29D,Race(7),,
10,0,0,0,0,0,0,0,0,0,0,0,0,0,0,0,0,41,41,0.0,M2018-12-29D,Race(7),,
11,0,2,0,2,0,0,0,0,0,0,2,2,0,2,2,4,21,21,0.0,M2018-12-29D,Race(7),,
1,0,0,0,0,0,1,1,2,0,2,0,2,0,3,1,4,19,19,2.0,M2018-12-29D,Race(8),,
2,6,0,6,12,5,3,3,11,9,1,2,12,20,4,11,35,5.5,5.5,0.0,M2018-12-29D,Race(8),,
3,0,0,0,0,0,0,1,1,0,0,1,1,0,0,2,2,34,34,0.0,M2018-12-29D,Race(8),,
4,3,2,0,5,7,3,3,13,3,1,1,5,13,6,4,23,8,8,3.0,M2018-12-29D,Race(8),,
5,2,2,0,4,1,0,0,1,2,0,0,2,5,2,0,7,21,21,0.0,M2018-12-29D,Race(8),,
6,0,0,0,0,4,4,4,12,0,0,0,0,4,4,4,12,,,0.0,M2018-12-29D,Race(8),,
7,3,0,4,7,7,8,5,20,5,5,1,11,15,13,10,38,13,13,0.0,M2018-12-29D,Race(8),,
8,3,3,0,6,0,1,4,5,1,5,5,11,4,9,9,22,9,9,0.0,M2018-12-29D,Race(8),,
9,8,5,4,17,3,3,1,7,2,5,3,10,13,13,8,34,4.2,4.2,1.0,M2018-12-29D,Race(8),,
10,0,13,8,21,2,3,4,9,2,2,6,10,4,18,18,40,6,6,0.0,M2018-12-29D,Race(8),,
11,0,2,0,2,0,0,1,1,0,0,2,2,0,2,3,5,16,16,0.0,M2018-12-29D,Race(8),,
12,0,0,2,2,0,0,0,0,0,0,0,0,0,0,2,2,26,26,0.0,M2018-12-29D,Race(8),,
13,0,0,0,0,0,0,0,0,0,0,0,0,0,0,0,0,41,41,0.0,M2018-12-29D,Race(8),,
14,5,3,6,14,0,3,2,5,1,2,3,6,6,8,11,25,7,7,0.0,M2018-12-29D,Race(8),,
1,0,5,5,10,3,1,6,10,3,0,3,6,6,6,14,26,6.5,8,0.0,M2018-12-29D,Race(9),,
2,13,10,5,28,11,7,4,22,10,9,3,22,34,26,12,72,2.8,2.7,2.0,M2018-12-29D,Race(9),,
3,0,0,0,0,0,0,0,0,0,0,0,0,0,0,0,0,26,26,0.0,M2018-12-29D,Race(9),,
4,15,10,5,30,7,11,1,19,11,12,2,25,33,33,8,74,3.5,3.4,0.0,M2018-12-29D,Race(9),,
5,0,0,0,0,0,0,0,0,1,0,0,1,1,0,0,1,16,16,1.0,M2018-12-29D,Race(9),,
6,0,0,0,0,0,0,0,0,0,2,1,3,0,2,1,3,61,41,0.0,M2018-12-29D,Race(9),,
7,0,3,0,3,0,2,1,3,0,0,3,3,0,5,4,9,13,14,0.0,M2018-12-29D,Race(9),,
8,0,0,0,0,0,0,0,0,0,0,0,0,0,0,0,0,101,101,0.0,M2018-12-29D,Race(9),,
9,2,0,9,11,5,5,12,22,1,1,12,14,8,6,33,47,13,13,0.0,M2018-12-29D,Race(9),,
10,0,0,0,0,0,0,0,0,0,0,0,0,0,0,0,0,51,41,0.0,M2018-12-29D,Race(9),,
11,0,0,0,0,0,1,1,2,0,2,1,3,0,3,2,5,13,12,0.0,M2018-12-29D,Race(9),,
12,0,2,6,8,4,3,5,12,0,0,1,1,4,5,12,21,9,8.5,3.0,M2018-12-29D,Race(9),,
1,0,3,4,7,0,0,8,8,0,0,1,1,0,3,13,16,12,12,0.0,M2019-01-01D,Race(1),,
2,3,0,0,3,0,8,7,15,0,8,6,14,3,16,13,32,8.5,8.5,0.0,M2019-01-01D,Race(1),,
3,18,4,6,28,18,9,2,29,17,3,3,23,53,16,11,80,2.5,2.5,1.0,M2019-01-01D,Race(1),,
4,2,2,0,4,2,0,0,2,1,0,0,1,5,2,0,7,15,15,0.0,M2019-01-01D,Race(1),,
5,2,7,6,15,1,7,5,13,2,11,4,17,5,25,15,45,7.5,7.5,0.0,M2019-01-01D,Race(1),,
6,0,0,0,0,0,0,0,0,0,0,0,0,0,0,0,0,11,11,2.0,M2019-01-01D,Race(1),,
7,0,0,2,2,0,0,0,0,0,1,0,1,0,1,2,3,41,41,0.0,M2019-01-01D,Race(1),,
8,5,6,7,18,1,6,6,13,5,3,9,17,11,15,22,48,3.7,3.7,0.0,M2019-01-01D,Race(1),,
9,0,8,5,13,8,0,2,10,1,0,3,4,9,8,10,27,8.5,8.5,3.0,M2019-01-01D,Race(1),,
1,0,0,0,0,0,8,1,9,0,0,1,1,0,8,2,10,14,14,0.0,M2019-01-01D,Race(10),,
2,0,0,0,0,0,0,0,0,0,0,0,0,0,0,0,0,101,101,0.0,M2019-01-01D,Race(10),,
3,0,3,0,3,0,0,0,0,1,0,1,2,1,3,1,5,51,51,0.0,M2019-01-01D,Race(10),,
4,3,0,0,3,0,0,0,0,0,1,0,1,3,1,0,4,51,51,0.0,M2019-01-01D,Race(10),,
5,15,3,0,18,0,3,6,9,4,1,7,12,19,7,13,39,5.5,5.5,2.0,M2019-01-01D,Race(10),,
6,2,8,15,25,11,7,6,24,5,11,3,19,18,26,24,68,6,6,0.0,M2019-01-01D,Race(10),,
7,5,10,7,22,13,6,3,22,6,7,8,21,24,23,18,65,2.5,2.5,1.0,M2019-01-01D,Race(10),,
8,5,6,6,17,6,3,6,15,9,4,5,18,20,13,17,50,4.6,4.6,3.0,M2019-01-01D,Race(10),,
9,0,0,0,0,0,0,0,0,0,0,0,0,0,0,0,0,0,0,0.0,M2019-01-01D,Race(10),,
10,0,0,0,0,0,0,0,0,0,0,0,0,0,0,0,0,21,21,0.0,M2019-01-01D,Race(10),,
11,0,0,2,2,0,3,8,11,1,2,1,4,1,5,11,17,17,17,0.0,M2019-01-01D,Race(10),,
12,0,0,0,0,0,0,0,0,0,0,0,0,0,0,0,0,18,18,0.0,M2019-01-01D,Race(10),,
13,0,0,0,0,0,0,0,0,0,0,0,0,0,0,0,0,101,101,0.0,M2019-01-01D,Race(10),,
14,0,0,0,0,0,0,0,0,0,0,0,0,0,0,0,0,81,81,0.0,M2019-01-01D,Race(10),,
1,0,4,0,4,0,8,2,10,0,1,2,3,0,13,4,17,26,26,0.0,M2019-01-01D,Race(11),,
2,12,5,4,21,4,7,7,18,6,9,2,17,22,21,13,56,7.5,7.5,0.0,M2019-01-01D,Race(11),,
3,0,0,0,0,0,0,0,0,0,0,0,0,0,0,0,0,18,18,3.0,M2019-01-01D,Race(11),,
4,9,8,7,24,16,5,2,23,15,8,3,26,40,21,12,73,2.9,2.9,1.0,M2019-01-01D,Race(11),,
5,0,0,5,5,0,0,0,0,0,1,0,1,0,1,5,6,12,12,2.0,M2019-01-01D,Race(11),,
6,0,0,0,0,0,0,0,0,0,0,0,0,0,0,0,0,101,101,0.0,M2019-01-01D,Race(11),,
7,0,0,0,0,0,0,0,0,0,0,1,1,0,0,1,1,17,17,0.0,M2019-01-01D,Race(11),,
8,0,0,0,0,0,0,0,0,0,0,0,0,0,0,0,0,34,35,0.0,M2019-01-01D,Race(11),,
9,3,11,8,22,10,7,7,24,5,4,12,21,18,22,27,67,3.6,3.6,0.0,M2019-01-01D,Race(11),,
10,0,0,0,0,0,0,0,0,0,0,1,1,0,0,1,1,81,81,0.0,M2019-01-01D,Race(11),,
11,0,0,6,6,0,0,8,8,0,0,0,0,0,0,14,14,16,16,0.0,M2019-01-01D,Race(11),,
12,6,2,0,8,0,3,4,7,0,3,5,8,6,8,9,23,7,7,0.0,M2019-01-01D,Race(11),,
13,0,0,0,0,0,0,0,0,0,0,0,0,0,0,0,0,81,81,0.0,M2019-01-01D,Race(11),,
14,0,0,0,0,0,0,0,0,0,0,0,0,0,0,0,0,101,101,0.0,M2019-01-01D,Race(11),,
1,3,4,0,7,0,4,3,7,0,7,4,11,3,15,7,25,7.5,7.5,0.0,M2019-01-01D,Race(2),,
2,13,5,4,22,10,5,2,17,11,4,3,18,34,14,9,57,2.7,2.7,3.0,M2019-01-01D,Race(2),,
3,0,3,4,7,1,9,4,14,3,2,5,10,4,14,13,31,14,14,0.0,M2019-01-01D,Race(2),,
4,6,3,12,21,10,6,4,20,7,8,5,20,23,17,21,61,6,6,2.0,M2019-01-01D,Race(2),,
5,5,10,3,18,1,4,6,11,3,3,5,11,9,17,14,40,7,7,0.0,M2019-01-01D,Race(2),,
6,3,3,5,11,8,0,3,11,2,0,3,5,13,3,11,27,7,7,1.0,M2019-01-01D,Race(2),,
7,0,0,0,0,0,0,0,0,0,0,0,0,0,0,0,0,21,21,0.0,M2019-01-01D,Race(2),,
8,0,0,0,0,0,0,0,0,0,0,0,0,0,0,0,0,21,21,0.0,M2019-01-01D,Race(2),,
9,0,0,0,0,0,0,0,0,0,0,0,0,0,0,0,0,26,26,0.0,M2019-01-01D,Race(2),,
10,0,2,0,2,0,2,8,10,0,2,1,3,0,6,9,15,9,9,0.0,M2019-01-01D,Race(2),,
11,0,0,2,2,0,0,0,0,0,0,0,0,0,0,2,2,41,41,0.0,M2019-01-01D,Race(2),,
1,19,5,6,30,15,2,2,19,15,3,2,20,49,10,10,69,3.3,3.3,1.0,M2019-01-01D,Race(3),,
2,3,9,3,15,0,4,6,10,0,1,5,6,3,14,14,31,9,9,0.0,M2019-01-01D,Race(3),,
3,0,2,0,2,9,5,3,17,1,5,4,10,10,12,7,29,10,10,0.0,M2019-01-01D,Race(3),,
4,0,0,0,0,0,0,1,1,0,1,2,3,0,1,3,4,21,21,0.0,M2019-01-01D,Race(3),,
5,0,0,0,0,0,0,0,0,0,0,0,0,0,0,0,0,51,51,0.0,M2019-01-01D,Race(3),,
6,2,9,7,18,3,7,5,15,3,10,4,17,8,26,16,50,3.6,3.6,0.0,M2019-01-01D,Race(3),,
7,0,0,0,0,0,0,0,0,1,0,0,1,1,0,0,1,81,81,0.0,M2019-01-01D,Race(3),,
8,0,0,0,0,0,8,0,8,0,1,1,2,0,9,1,10,31,31,0.0,M2019-01-01D,Race(3),,
9,6,0,9,15,3,2,3,8,6,2,4,12,15,4,16,35,5.5,5.5,3.0,M2019-01-01D,Race(3),,
10,0,5,0,5,0,0,8,8,0,0,0,0,0,5,8,13,21,21,0.0,M2019-01-01D,Race(3),,
11,0,0,2,2,0,2,2,4,0,3,4,7,0,5,8,13,7,7,2.0,M2019-01-01D,Race(3),,
12,0,0,3,3,0,0,0,0,0,0,0,0,0,0,3,3,41,41,0.0,M2019-01-01D,Race(3),,
1,0,3,0,3,0,0,0,0,0,0,0,0,0,3,0,3,14,14,0.0,M2019-01-01D,Race(4),,
2,15,3,10,28,13,4,5,22,14,7,4,25,42,14,19,75,3.8,3.8,2.0,M2019-01-01D,Race(4),,
3,0,0,0,0,0,0,0,0,0,1,0,1,0,1,0,1,81,81,0.0,M2019-01-01D,Race(4),,
4,0,0,0,0,0,1,3,4,0,2,3,5,0,3,6,9,18,18,0.0,M2019-01-01D,Race(4),,
5,8,7,10,25,6,8,5,19,7,9,7,23,21,24,22,67,2.5,2.5,1.0,M2019-01-01D,Race(4),,
6,0,0,0,0,0,0,2,2,0,0,0,0,0,0,2,2,34,34,0.0,M2019-01-01D,Race(4),,
7,7,15,8,30,11,8,7,26,5,7,10,22,23,30,25,78,4.2,4.2,0.0,M2019-01-01D,Race(4),,
8,0,0,2,2,0,1,8,9,0,0,2,2,0,1,12,13,15,15,0.0,M2019-01-01D,Race(4),,
9,0,0,0,0,0,0,0,0,0,0,0,0,0,0,0,0,34,34,0.0,M2019-01-01D,Race(4),,
10,0,0,0,0,0,8,0,8,0,0,0,0,0,8,0,8,17,17,3.0,M2019-01-01D,Race(4),,
11,0,2,0,2,0,0,0,0,0,0,0,0,0,2,0,2,19,19,0.0,M2019-01-01D,Race(4),,
12,0,0,0,0,0,0,0,0,0,0,0,0,0,0,0,0,51,51,0.0,M2019-01-01D,Race(4),,
1,0,0,0,0,0,0,8,8,1,0,0,1,1,0,8,9,21,21,0.0,M2019-01-01D,Race(5),,
2,0,0,0,0,0,0,0,0,0,0,0,0,0,0,0,0,81,81,0.0,M2019-01-01D,Race(5),,
3,5,2,6,13,0,11,5,16,2,3,4,9,7,16,15,38,6,6,3.0,M2019-01-01D,Race(5),,
4,9,11,7,27,6,10,4,20,3,13,5,21,18,34,16,68,3.8,3.8,0.0,M2019-01-01D,Race(5),,
5,0,0,0,0,0,0,0,0,0,1,1,2,0,1,1,2,34,34,0.0,M2019-01-01D,Race(5),,
6,6,7,12,25,16,5,2,23,15,5,3,23,37,17,17,71,3.6,3.6,1.0,M2019-01-01D,Race(5),,
7,10,8,5,23,8,4,11,23,5,4,10,19,23,16,26,65,3,3,2.0,M2019-01-01D,Race(5),,
8,0,2,0,2,0,0,0,0,0,0,1,1,0,2,1,3,17,17,0.0,M2019-01-01D,Race(5),,
9,0,0,0,0,0,0,0,0,0,0,1,1,0,0,1,1,26,26,0.0,M2019-01-01D,Race(5),,
10,0,0,0,0,0,0,0,0,0,0,0,0,0,0,0,0,81,81,0.0,M2019-01-01D,Race(5),,
11,0,0,0,0,0,0,0,0,0,0,0,0,0,0,0,0,61,61,0.0,M2019-01-01D,Race(5),,
12,0,0,0,0,0,0,0,0,0,0,1,1,0,0,1,1,31,31,0.0,M2019-01-01D,Race(5),,
13,0,0,0,0,0,0,0,0,0,0,0,0,0,0,0,0,101,101,0.0,M2019-01-01D,Race(5),,
1,0,2,3,5,5,5,3,13,5,3,0,8,10,10,6,26,6.5,6.5,0.0,M2019-01-01D,Race(6),,
2,0,2,0,2,0,0,1,1,0,0,0,0,0,2,1,3,26,26,0.0,M2019-01-01D,Race(6),,
3,0,0,2,2,0,3,1,4,0,2,0,2,0,5,3,8,10,10,0.0,M2019-01-01D,Race(6),,
4,0,6,5,11,0,0,2,2,1,2,4,7,1,8,11,20,9,9,3.0,M2019-01-01D,Race(6),,
5,0,5,0,5,8,2,3,13,0,0,5,5,8,7,8,23,11,11,0.0,M2019-01-01D,Race(6),,
6,0,0,0,0,0,0,0,0,2,0,0,2,2,0,0,2,61,61,0.0,M2019-01-01D,Race(6),,
7,16,2,5,23,10,7,3,20,5,11,4,20,31,20,12,63,5.5,5.5,0.0,M2019-01-01D,Race(6),,
8,0,0,0,0,0,0,1,1,0,0,2,2,0,0,3,3,31,31,0.0,M2019-01-01D,Race(6),,
9,0,2,12,14,1,8,1,10,0,4,5,9,1,14,18,33,13,13,0.0,M2019-01-01D,Race(6),,
10,0,0,3,3,0,1,8,9,0,2,1,3,0,3,12,15,11,11,0.0,M2019-01-01D,Race(6),,
11,2,3,0,5,0,0,2,2,0,0,0,0,2,3,2,7,16,16,2.0,M2019-01-01D,Race(6),,
12,12,8,0,20,6,4,5,15,13,2,2,17,31,14,7,52,2.9,2.9,1.0,M2019-01-01D,Race(6),,
1,12,7,6,25,11,6,4,21,10,6,4,20,33,19,14,66,4.2,4.2,0.0,M2019-01-01D,Race(7),,
2,0,0,3,3,0,0,1,1,0,1,2,3,0,1,6,7,18,18,0.0,M2019-01-01D,Race(7),,
3,0,0,0,0,0,0,0,0,0,0,0,0,0,0,0,0,10,10,0.0,M2019-01-01D,Race(7),,
4,3,15,2,20,0,4,3,7,4,3,5,12,7,22,10,39,7,7,3.0,M2019-01-01D,Race(7),,
5,0,5,3,8,8,2,1,11,1,1,2,4,9,8,6,23,9,9,0.0,M2019-01-01D,Race(7),,
6,5,0,0,5,1,2,3,6,2,0,1,3,8,2,4,14,10,10,0.0,M2019-01-01D,Race(7),,
7,0,3,0,3,0,8,0,8,0,0,1,1,0,11,1,12,26,26,2.0,M2019-01-01D,Race(7),,
8,0,0,0,0,0,0,0,0,0,2,1,3,0,2,1,3,34,34,0.0,M2019-01-01D,Race(7),,
9,10,0,12,22,6,5,4,15,7,6,4,17,23,11,20,54,3.5,3.5,1.0,M2019-01-01D,Race(7),,
10,0,0,0,0,0,0,1,1,0,0,2,2,0,0,3,3,19,19,0.0,M2019-01-01D,Race(7),,
11,0,0,4,4,4,3,5,12,2,7,3,12,6,10,12,28,9.5,9.5,0.0,M2019-01-01D,Race(7),,
12,0,0,0,0,0,0,8,8,0,0,1,1,0,0,9,9,26,26,0.0,M2019-01-01D,Race(7),,
1,0,0,0,0,0,0,8,8,1,0,1,2,1,0,9,10,18,18,0.0,M2019-01-01D,Race(8),,
2,0,0,5,5,0,0,0,0,0,0,1,1,0,0,6,6,21,21,0.0,M2019-01-01D,Race(8),,
3,2,0,0,2,0,9,2,11,1,0,2,3,3,9,4,16,9,9,0.0,M2019-01-01D,Race(8),,
4,0,0,0,0,0,0,3,3,0,1,3,4,0,1,6,7,18,18,0.0,M2019-01-01D,Race(8),,
5,22,6,0,28,13,5,5,23,14,5,4,23,49,16,9,74,1.9,1.9,1.0,M2019-01-01D,Race(8),,
6,2,5,5,12,9,4,3,16,2,7,4,13,13,16,12,41,11,11,0.0,M2019-01-01D,Race(8),,
7,2,5,12,19,0,6,7,13,3,7,5,15,5,18,24,47,10,10,3.0,M2019-01-01D,Race(8),,
8,0,0,0,0,0,0,0,0,0,0,0,0,0,0,0,0,61,61,0.0,M2019-01-01D,Race(8),,
9,0,0,0,0,0,0,0,0,0,0,0,0,0,0,0,0,51,51,0.0,M2019-01-01D,Race(8),,
10,0,5,0,5,0,0,0,0,0,0,2,2,0,5,2,7,13,13,0.0,M2019-01-01D,Race(8),,
11,2,9,8,19,8,6,2,16,5,6,4,15,15,21,14,50,5,5,2.0,M2019-01-01D,Race(8),,
1,0,5,7,12,2,3,5,10,2,2,4,8,4,10,16,30,17,17,0.0,M2019-01-01D,Race(9),,
2,2,2,3,7,1,1,2,4,0,1,1,2,3,4,6,13,17,17,0.0,M2019-01-01D,Race(9),,
3,3,2,2,7,0,2,1,3,2,3,4,9,5,7,7,19,21,21,0.0,M2019-01-01D,Race(9),,
4,0,0,0,0,0,1,3,4,0,2,2,4,0,3,5,8,12,12,0.0,M2019-01-01D,Race(9),,
5,0,5,2,7,0,3,3,6,0,2,6,8,0,10,11,21,8,10,0.0,M2019-01-01D,Race(9),,
6,0,0,3,3,8,1,0,9,0,2,1,3,8,3,4,15,41,41,0.0,M2019-01-01D,Race(9),,
7,0,0,0,0,0,8,0,8,0,0,1,1,0,8,1,9,41,41,0.0,M2019-01-01D,Race(9),,
8,3,11,3,17,0,9,6,15,2,12,5,19,5,32,14,51,6,6,3.0,M2019-01-01D,Race(9),,
9,22,5,0,27,19,2,0,21,20,2,1,23,61,9,1,71,1.75,1.75,1.0,M2019-01-01D,Race(9),,
10,0,0,2,2,0,0,8,8,0,0,1,1,0,0,11,11,26,26,0.0,M2019-01-01D,Race(9),,
11,0,0,5,5,0,0,1,1,0,0,0,0,0,0,6,6,26,26,2.0,M2019-01-01D,Race(9),,
12,0,0,3,3,0,0,1,1,0,0,0,0,0,0,4,4,14,13,0.0,M2019-01-01D,Race(9),,
1,5,2,2,9,8,0,0,8,0,0,1,1,13,2,3,18,10,10,0.0,M2019-01-06D,Race(1),,
2,0,0,2,2,1,4,3,8,1,3,0,4,2,7,5,14,17,17,0.0,M2019-01-06D,Race(1),,
3,0,5,6,11,1,3,1,5,2,4,3,9,3,12,10,25,12,12,0.0,M2019-01-06D,Race(1),,
4,0,2,8,10,2,0,0,2,0,0,0,0,2,2,8,12,13,13,0.0,M2019-01-06D,Race(1),,
5,0,0,0,0,0,0,2,2,2,0,3,5,2,0,5,7,19,19,0.0,M2019-01-06D,Race(1),,
6,3,0,0,3,0,8,0,8,0,1,0,1,3,9,0,12,15,15,0.0,M2019-01-06D,Race(1),,
7,16,12,2,30,12,6,3,21,14,9,1,24,42,27,6,75,2.5,2.5,3.0,M2019-01-06D,Race(1),,
8,0,0,3,3,1,1,6,8,1,1,6,8,2,2,15,19,12,12,0.0,M2019-01-06D,Race(1),,
9,2,0,0,2,0,1,8,9,1,1,4,6,3,2,12,17,13,13,0.0,M2019-01-06D,Race(1),,
10,0,0,0,0,0,0,0,0,0,0,0,0,0,0,0,0,26,26,2.0,M2019-01-06D,Race(1),,
11,0,0,0,0,0,0,0,0,0,0,0,0,0,0,0,0,41,41,0.0,M2019-01-06D,Race(1),,
12,4,9,7,20,5,7,7,19,5,7,8,20,14,23,22,59,4.2,4.2,1.0,M2019-01-06D,Race(1),,
1,0,2,5,7,8,1,0,9,1,3,1,5,9,6,6,21,19,19,3.0,M2019-01-06D,Race(10),,
2,5,0,6,11,8,3,3,14,4,6,3,13,17,9,12,38,9,9,0.0,M2019-01-06D,Race(10),,
3,7,0,4,11,1,4,2,7,0,1,2,3,8,5,8,21,7.5,7.5,2.0,M2019-01-06D,Race(10),,
4,0,0,3,3,0,3,3,6,0,3,4,7,0,6,10,16,12,12,0.0,M2019-01-06D,Race(10),,
5,0,6,0,6,0,0,0,0,0,0,1,1,0,6,1,7,17,17,0.0,M2019-01-06D,Race(10),,
6,0,0,3,3,0,8,0,8,0,1,0,1,0,9,3,12,34,34,0.0,M2019-01-06D,Race(10),,
7,0,0,0,0,0,0,0,0,0,0,1,1,0,0,1,1,34,34,0.0,M2019-01-06D,Race(10),,
8,3,5,2,10,6,6,6,18,10,5,2,17,19,16,10,45,7,7,0.0,M2019-01-06D,Race(10),,
9,15,10,5,30,7,3,5,15,11,3,5,19,33,16,15,64,2.8,2.8,0.0,M2019-01-06D,Race(10),,
10,0,0,0,0,0,0,8,8,0,0,2,2,0,0,10,10,19,19,0.0,M2019-01-06D,Race(10),,
11,0,0,0,0,0,0,0,0,0,0,0,0,0,0,0,0,41,41,0.0,M2019-01-06D,Race(10),,
12,0,7,2,9,0,2,3,5,0,4,5,9,0,13,10,23,7.5,7.5,0.0,M2019-01-06D,Race(10),,
13,0,0,0,0,0,0,0,0,0,0,0,0,0,0,0,0,19,19,1.0,M2019-01-06D,Race(10),,
14,0,0,0,0,0,0,0,0,0,0,0,0,0,0,0,0,26,26,0.0,M2019-01-06D,Race(10),,
1,0,5,8,13,5,5,4,14,2,3,4,9,7,13,16,36,6.5,6.5,3.0,M2019-01-06D,Race(2),,
2,23,7,0,30,12,5,3,20,15,4,2,21,50,16,5,71,2.4,2.4,1.0,M2019-01-06D,Race(2),,
3,5,11,3,19,8,4,4,16,2,4,3,9,15,19,10,44,6.5,6.5,0.0,M2019-01-06D,Race(2),,
4,0,0,0,0,0,1,2,3,0,0,0,0,0,1,2,3,19,19,0.0,M2019-01-06D,Race(2),,
5,0,0,14,14,2,4,1,7,3,9,3,15,5,13,18,36,7,7,0.0,M2019-01-06D,Race(2),,
6,0,0,0,0,0,0,0,0,1,0,0,1,1,0,0,1,41,41,0.0,M2019-01-06D,Race(2),,
7,0,3,0,3,1,1,4,6,0,2,2,4,1,6,6,13,15,15,0.0,M2019-01-06D,Race(2),,
8,0,2,3,5,2,2,4,8,2,2,7,11,4,6,14,24,19,19,0.0,M2019-01-06D,Race(2),,
9,0,2,0,2,0,0,8,8,1,0,1,2,1,2,9,12,21,21,2.0,M2019-01-06D,Race(2),,
10,0,0,2,2,0,0,0,0,0,0,0,0,0,0,2,2,34,34,0.0,M2019-01-06D,Race(2),,
11,2,0,0,2,0,8,0,8,0,1,0,1,2,9,0,11,21,21,0.0,M2019-01-06D,Race(2),,
12,0,0,0,0,0,0,0,0,0,0,0,0,0,0,0,0,51,51,0.0,M2019-01-06D,Race(2),,
13,0,0,0,0,0,0,0,0,0,0,3,3,0,0,3,3,15,15,0.0,M2019-01-06D,Race(2),,
14,0,0,0,0,0,0,0,0,0,0,0,0,0,0,0,0,41,41,0.0,M2019-01-06D,Race(2),,
1,17,8,5,30,6,11,12,29,9,7,7,23,32,26,24,82,2.5,2.5,0.0,M2019-01-06D,Race(3),,
2,8,14,8,30,11,6,12,29,4,11,9,24,23,31,29,83,3.5,3.5,0.0,M2019-01-06D,Race(3),,
3,0,2,3,5,0,8,1,9,0,2,5,7,0,12,9,21,8.5,8.5,0.0,M2019-01-06D,Race(3),,
4,0,0,3,3,0,0,0,0,0,0,0,0,0,0,3,3,21,21,1.0,M2019-01-06D,Race(3),,
5,5,6,11,22,13,5,5,23,13,6,5,24,31,17,21,69,2.8,2.8,2.0,M2019-01-06D,Race(3),,
6,0,0,0,0,0,0,0,0,0,0,0,0,0,0,0,0,34,35,0.0,M2019-01-06D,Race(3),,
1,0,8,9,17,9,4,2,15,7,7,1,15,16,19,12,47,6.5,6.5,0.0,M2019-01-06D,Race(4),,
2,2,0,0,2,0,0,8,8,0,0,3,3,2,0,11,13,18,18,0.0,M2019-01-06D,Race(4),,
3,3,0,10,13,0,3,8,11,1,6,8,15,4,9,26,39,11,11,0.0,M2019-01-06D,Race(4),,
4,0,0,0,0,0,0,0,0,0,0,0,0,0,0,0,0,41,41,0.0,M2019-01-06D,Race(4),,
5,4,3,0,7,2,0,1,3,1,1,5,7,7,4,6,17,7.5,7.5,0.0,M2019-01-06D,Race(4),,
6,0,0,0,0,1,0,0,1,0,0,0,0,1,0,0,1,61,61,0.0,M2019-01-06D,Race(4),,
7,13,4,3,20,8,11,2,21,15,7,0,22,36,22,5,63,2.7,2.7,0.0,M2019-01-06D,Race(4),,
8,0,0,0,0,8,0,0,8,0,2,0,2,8,2,0,10,34,34,0.0,M2019-01-06D,Race(4),,
9,2,2,3,7,0,0,0,0,0,0,1,1,2,2,4,8,8,8,2.0,M2019-01-06D,Race(4),,
10,0,8,3,11,2,8,8,18,1,2,7,10,3,18,18,39,7,7,3.0,M2019-01-06D,Race(4),,
11,0,3,0,3,0,0,0,0,0,0,0,0,0,3,0,3,26,26,0.0,M2019-01-06D,Race(4),,
12,6,2,2,10,0,1,1,2,1,1,1,3,7,4,4,15,9,8.5,1.0,M2019-01-06D,Race(4),,
1,7,4,7,18,4,4,4,12,4,5,6,15,15,13,17,45,4.6,5,0.0,M2019-01-06D,Race(5),,
2,2,0,2,4,0,1,1,2,1,0,2,3,3,1,5,9,21,21,0.0,M2019-01-06D,Race(5),,
3,4,10,5,19,7,6,5,18,7,3,5,15,18,19,15,52,4.6,4.6,0.0,M2019-01-06D,Race(5),,
4,3,0,2,5,1,8,0,9,3,1,1,5,7,9,3,19,5.5,5.5,3.0,M2019-01-06D,Race(5),,
5,11,7,3,21,9,4,6,19,7,6,6,19,27,17,15,59,5,5,0.0,M2019-01-06D,Race(5),,
6,0,0,0,0,0,0,0,0,0,0,0,0,0,0,0,0,16,15,0.0,M2019-01-06D,Race(5),,
7,0,0,0,0,0,0,0,0,0,1,0,1,0,1,0,1,26,26,0.0,M2019-01-06D,Race(5),,
8,0,0,3,3,1,1,1,3,1,3,1,5,2,4,5,11,16,15,2.0,M2019-01-06D,Race(5),,
9,0,0,0,0,0,0,1,1,0,0,1,1,0,0,2,2,23,23,1.0,M2019-01-06D,Race(5),,
10,0,0,0,0,0,0,8,8,1,0,1,2,1,0,9,10,34,35,0.0,M2019-01-06D,Race(5),,
11,0,6,5,11,0,2,0,2,0,2,1,3,0,10,6,16,9.5,9.5,0.0,M2019-01-06D,Race(5),,
12,3,3,3,9,8,4,4,16,2,5,2,9,13,12,9,34,9.5,9.5,0.0,M2019-01-06D,Race(5),,
1,0,3,0,3,0,3,4,7,2,2,5,9,2,8,9,19,13,13,0.0,M2019-01-06D,Race(6),,
2,0,0,0,0,0,0,0,0,0,0,0,0,0,0,0,0,126,126,0.0,M2019-01-06D,Race(6),,
3,7,5,3,15,4,2,4,10,5,4,5,14,16,11,12,39,5,5,0.0,M2019-01-06D,Race(6),,
4,0,2,2,4,0,0,9,9,0,2,2,4,0,4,13,17,8.5,8.5,0.0,M2019-01-06D,Race(6),,
5,8,5,7,20,11,4,2,17,7,5,6,18,26,14,15,55,5.5,5.5,0.0,M2019-01-06D,Race(6),,
6,0,10,7,17,9,6,3,18,3,6,2,11,12,22,12,46,10,10,3.0,M2019-01-06D,Race(6),,
7,0,0,0,0,0,0,0,0,0,1,0,1,0,1,0,1,81,81,2.0,M2019-01-06D,Race(6),,
8,0,2,0,2,0,0,0,0,0,0,1,1,0,2,1,3,16,16,0.0,M2019-01-06D,Race(6),,
9,0,3,6,9,0,9,2,11,1,0,1,2,1,12,9,22,11,11,1.0,M2019-01-06D,Race(6),,
10,0,0,0,0,0,0,0,0,0,0,0,0,0,0,0,0,61,61,0.0,M2019-01-06D,Race(6),,
11,0,0,0,0,0,0,0,0,0,0,1,1,0,0,1,1,16,16,0.0,M2019-01-06D,Race(6),,
12,15,0,5,20,6,6,6,18,8,6,3,17,29,12,14,55,3,3,0.0,M2019-01-06D,Race(6),,
13,0,0,0,0,0,0,0,0,0,0,0,0,0,0,0,0,41,41,0.0,M2019-01-06D,Race(6),,
14,0,0,0,0,0,0,0,0,0,0,0,0,0,0,0,0,81,81,0.0,M2019-01-06D,Race(6),,
1,21,4,2,27,13,5,4,22,13,5,4,22,47,14,10,71,2.5,2.6,0.0,M2019-01-06D,Race(7),,
2,2,5,3,10,6,6,7,19,6,6,7,19,14,17,17,48,7.5,8,1.0,M2019-01-06D,Race(7),,
3,0,0,0,0,0,0,0,0,0,0,0,0,0,0,0,0,34,34,2.0,M2019-01-06D,Race(7),,
4,3,0,2,5,0,3,1,4,0,3,1,4,3,6,4,13,10,10,0.0,M2019-01-06D,Race(7),,
5,0,3,3,6,2,2,1,5,2,2,1,5,4,7,5,16,10,10,0.0,M2019-01-06D,Race(7),,
6,0,3,0,3,0,1,4,5,0,1,4,5,0,5,8,13,7.5,7.5,0.0,M2019-01-06D,Race(7),,
7,0,6,8,14,1,3,3,7,1,3,3,7,2,12,14,28,13,10,0.0,M2019-01-06D,Race(7),,
8,2,0,3,5,1,4,2,7,1,4,2,7,4,8,7,19,15,14,0.0,M2019-01-06D,Race(7),,
9,0,0,0,0,0,0,0,0,0,0,0,0,0,0,0,0,61,61,0.0,M2019-01-06D,Race(7),,
10,0,2,2,4,1,1,1,3,1,1,1,3,2,4,4,10,16,21,3.0,M2019-01-06D,Race(7),,
11,2,3,7,12,2,1,2,5,2,1,2,5,6,5,11,22,7,7,0.0,M2019-01-06D,Race(7),,
12,0,4,0,4,0,0,1,1,0,0,1,1,0,4,2,6,20,21,0.0,M2019-01-06D,Race(7),,
1,4,0,6,10,6,5,4,15,3,6,5,14,13,11,15,39,6.5,6.5,0.0,M2019-01-06D,Race(8),,
2,8,5,0,13,5,8,2,15,5,3,1,9,18,16,3,37,5.5,5.5,1.0,M2019-01-06D,Race(8),,
3,3,0,2,5,2,2,2,6,2,4,0,6,7,6,4,17,9,8.5,0.0,M2019-01-06D,Race(8),,
4,7,7,8,22,4,2,2,8,6,2,2,10,17,11,12,40,8.5,8.5,0.0,M2019-01-06D,Race(8),,
5,0,0,0,0,0,0,0,0,0,0,0,0,0,0,0,0,31,26,0.0,M2019-01-06D,Race(8),,
6,0,3,0,3,1,3,9,13,2,2,0,4,3,8,9,20,11,10,0.0,M2019-01-06D,Race(8),,
7,0,5,7,12,3,0,2,5,5,2,2,9,8,7,11,26,11,11,0.0,M2019-01-06D,Race(8),,
8,0,0,0,0,0,0,0,0,0,0,0,0,0,0,0,0,31,26,0.0,M2019-01-06D,Race(8),,
9,0,0,0,0,0,0,0,0,0,0,0,0,0,0,0,0,34,31,0.0,M2019-01-06D,Race(8),,
10,0,0,4,4,1,2,2,5,1,5,3,9,2,7,9,18,9,8.5,0.0,M2019-01-06D,Race(8),,
11,2,3,3,8,0,0,0,0,0,0,0,0,2,3,3,8,17,17,2.0,M2019-01-06D,Race(8),,
12,6,7,0,13,0,8,4,12,2,2,8,12,8,17,12,37,5,6,3.0,M2019-01-06D,Race(8),,
13,0,0,0,0,8,0,3,11,0,0,5,5,8,0,8,16,15,14,0.0,M2019-01-06D,Race(8),,
14,0,0,0,0,0,0,0,0,0,0,0,0,0,0,0,0,81,81,0.0,M2019-01-06D,Race(8),,
1,0,0,0,0,0,0,0,0,0,0,0,0,0,0,0,0,151,151,0.0,M2019-01-06D,Race(9),,
2,0,0,0,0,0,0,0,0,1,0,0,1,1,0,0,1,19,19,0.0,M2019-01-06D,Race(9),,
3,3,0,0,3,0,9,5,14,0,3,9,12,3,12,14,29,19,19,0.0,M2019-01-06D,Race(9),,
4,0,0,0,0,0,0,0,0,0,0,0,0,0,0,0,0,56,26,0.0,M2019-01-06D,Race(9),,
5,0,5,2,7,0,3,5,8,2,5,4,11,2,13,11,26,11,11,0.0,M2019-01-06D,Race(9),,
6,0,0,0,0,0,0,0,0,0,1,0,1,0,1,0,1,61,61,0.0,M2019-01-06D,Race(9),,
7,0,0,0,0,0,0,0,0,0,0,0,0,0,0,0,0,41,41,0.0,M2019-01-06D,Race(9),,
8,7,0,11,18,0,0,0,0,0,1,1,2,7,1,12,20,11,11,3.0,M2019-01-06D,Race(9),,
9,0,0,3,3,0,0,0,0,0,0,1,1,0,0,4,4,34,34,0.0,M2019-01-06D,Race(9),,
10,0,5,6,11,8,4,7,19,0,2,6,8,8,11,19,38,9,9,0.0,M2019-01-06D,Race(9),,
11,0,0,0,0,0,0,0,0,0,0,0,0,0,0,0,0,61,61,0.0,M2019-01-06D,Race(9),,
12,15,10,0,25,22,1,0,23,22,2,1,25,59,13,1,73,1.7,1.7,1.0,M2019-01-06D,Race(9),,
13,0,0,3,3,0,0,8,8,0,1,1,2,0,1,12,13,26,26,0.0,M2019-01-06D,Race(9),,
14,5,10,5,20,0,13,5,18,1,11,3,15,6,34,13,53,7,7,2.0,M2019-01-06D,Race(9),,
1,4,0,0,4,1,0,0,1,1,1,0,2,6,1,0,7,7.5,7.5,0.0,M2019-01-09D,Race(1),,
2,0,0,3,3,0,1,1,2,1,1,1,3,1,2,5,8,14,14,1.0,M2019-01-09D,Race(1),,
3,0,0,0,0,0,1,0,1,0,0,0,0,0,1,0,1,41,41,0.0,M2019-01-09D,Race(1),,
4,2,16,8,26,1,13,5,19,6,12,3,21,9,41,16,66,5,5,0.0,M2019-01-09D,Race(1),,
5,15,6,2,23,21,7,6,34,14,5,5,24,50,18,13,81,2.8,2.8,0.0,M2019-01-09D,Race(1),,
6,0,0,0,0,0,0,1,1,0,0,2,2,0,0,3,3,19,19,0.0,M2019-01-09D,Race(1),,
7,2,0,10,12,1,2,8,11,0,5,10,15,3,7,28,38,12,12,2.0,M2019-01-09D,Race(1),,
8,0,0,0,0,0,1,0,1,1,0,0,1,1,1,0,2,12,12,0.0,M2019-01-09D,Race(1),,
9,0,2,0,2,0,0,0,0,0,0,0,0,0,2,0,2,26,26,0.0,M2019-01-09D,Race(1),,
10,5,6,5,16,6,5,9,20,3,2,3,8,14,13,17,44,6,6,3.0,M2019-01-09D,Race(1),,
11,0,0,2,2,0,0,0,0,0,0,2,2,0,0,4,4,26,26,0.0,M2019-01-09D,Race(1),,
12,2,0,0,2,0,0,0,0,0,0,0,0,2,0,0,2,21,21,0.0,M2019-01-09D,Race(1),,
1,13,7,5,25,13,9,8,30,11,8,4,23,37,24,17,78,3.6,3.6,1.0,M2019-01-09D,Race(2),,
2,0,0,0,0,0,0,2,2,0,1,2,3,0,1,4,5,19,19,0.0,M2019-01-09D,Race(2),,
3,0,0,5,5,1,0,0,1,1,0,1,2,2,0,6,8,17,17,0.0,M2019-01-09D,Race(2),,
4,2,16,2,20,1,11,6,18,5,9,5,19,8,36,13,57,3.7,3.7,0.0,M2019-01-09D,Race(2),,
5,0,0,0,0,0,0,0,0,0,0,0,0,0,0,0,0,51,51,0.0,M2019-01-09D,Race(2),,
6,0,0,0,0,0,1,1,2,0,0,1,1,0,1,2,3,26,26,0.0,M2019-01-09D,Race(2),,
7,0,0,0,0,0,0,0,0,0,0,0,0,0,0,0,0,19,19,2.0,M2019-01-09D,Race(2),,
8,0,5,6,11,0,1,3,4,0,1,6,7,0,7,15,22,8,8,0.0,M2019-01-09D,Race(2),,
9,0,0,0,0,0,1,0,1,1,1,0,2,1,2,0,3,26,26,0.0,M2019-01-09D,Race(2),,
10,13,2,12,27,15,7,8,30,8,5,4,17,36,14,24,74,3.6,3.6,3.0,M2019-01-09D,Race(2),,
11,2,0,0,2,0,0,2,2,0,1,3,4,2,1,5,8,14,14,0.0,M2019-01-09D,Race(2),,
12,0,0,0,0,0,0,0,0,0,0,0,0,0,0,0,0,71,67,0.0,M2019-01-09D,Race(2),,
1,15,4,0,19,15,6,8,29,13,3,5,21,43,13,13,69,4.4,4.4,3.0,M2019-01-09D,Race(3),,
2,0,3,3,6,0,2,0,2,1,3,1,5,1,8,4,13,11,11,0.0,M2019-01-09D,Race(3),,
3,5,0,2,7,1,4,2,7,0,1,0,1,6,5,4,15,10,10,0.0,M2019-01-09D,Race(3),,
4,3,0,2,5,1,1,1,3,2,3,0,5,6,4,3,13,12,12,0.0,M2019-01-09D,Race(3),,
5,0,10,5,15,0,8,9,17,2,6,8,16,2,24,22,48,5.5,5.5,0.0,M2019-01-09D,Race(3),,
6,0,0,3,3,6,3,2,11,4,0,4,8,10,3,9,22,16,16,2.0,M2019-01-09D,Race(3),,
7,0,0,3,3,1,0,1,2,1,1,1,3,2,1,5,8,11,11,0.0,M2019-01-09D,Race(3),,
8,0,0,2,2,0,0,1,1,0,0,1,1,0,0,4,4,13,13,0.0,M2019-01-09D,Race(3),,
9,7,5,8,20,5,5,4,14,2,8,2,12,14,18,14,46,4.6,4.6,1.0,M2019-01-09D,Race(3),,
10,0,0,0,0,1,1,2,4,0,0,0,0,1,1,2,4,15,15,0.0,M2019-01-09D,Race(3),,
11,0,3,0,3,0,0,0,0,0,0,0,0,0,3,0,3,21,21,0.0,M2019-01-09D,Race(3),,
12,0,5,2,7,0,0,0,0,0,0,0,0,0,5,2,7,19,19,0.0,M2019-01-09D,Race(3),,
1,0,0,0,0,0,0,0,0,0,1,0,1,0,1,0,1,81,81,0.0,M2019-01-09D,Race(4),,
2,0,7,9,16,0,6,7,13,1,8,7,16,1,21,23,45,8.5,8.5,0.0,M2019-01-09D,Race(4),,
3,0,2,2,4,0,2,4,6,2,1,5,8,2,5,11,18,13,13,0.0,M2019-01-09D,Race(4),,
4,0,0,0,0,0,0,0,0,0,0,1,1,0,0,1,1,71,67,3.0,M2019-01-09D,Race(4),,
5,3,0,0,3,0,0,0,0,0,0,3,3,3,0,3,6,12,12,0.0,M2019-01-09D,Race(4),,
6,2,3,6,11,2,5,6,13,0,7,4,11,4,15,16,35,7.5,7.5,0.0,M2019-01-09D,Race(4),,
7,4,9,10,23,8,11,8,27,1,8,3,12,13,28,21,62,7,7,2.0,M2019-01-09D,Race(4),,
8,0,0,0,0,0,0,0,0,0,0,0,0,0,0,0,0,71,67,0.0,M2019-01-09D,Race(4),,
9,0,0,0,0,0,0,0,0,0,0,0,0,0,0,0,0,34,34,0.0,M2019-01-09D,Race(4),,
10,21,9,0,30,20,6,5,31,22,1,2,25,63,16,7,86,1.6,1.6,1.0,M2019-01-09D,Race(4),,
11,0,0,3,3,0,0,0,0,0,0,0,0,0,0,3,3,61,61,0.0,M2019-01-09D,Race(4),,
12,0,0,0,0,0,0,0,0,0,0,1,1,0,0,1,1,31,31,0.0,M2019-01-09D,Race(4),,
1,0,0,2,2,0,0,1,1,0,0,2,2,0,0,5,5,14,14,0.0,M2019-01-09D,Race(5),,
2,3,0,3,6,0,0,1,1,1,0,0,1,4,0,4,8,14,14,0.0,M2019-01-09D,Race(5),,
3,0,2,0,2,0,0,0,0,0,0,0,0,0,2,0,2,11,11,0.0,M2019-01-09D,Race(5),,
4,2,5,0,7,5,9,9,23,3,4,10,17,10,18,19,47,16,16,1.0,M2019-01-09D,Race(5),,
5,0,3,6,9,0,0,2,2,0,0,0,0,0,3,8,11,13,13,0.0,M2019-01-09D,Race(5),,
6,0,0,3,3,0,1,0,1,0,0,0,0,0,1,3,4,11,11,0.0,M2019-01-09D,Race(5),,
7,0,10,7,17,4,11,9,24,1,14,5,20,5,35,21,61,5,5,0.0,M2019-01-09D,Race(5),,
8,2,0,5,7,1,1,3,5,1,1,2,4,4,2,10,16,13,13,3.0,M2019-01-09D,Race(5),,
9,23,7,0,30,20,7,5,32,19,4,2,25,62,18,7,87,2.25,2.25,2.0,M2019-01-09D,Race(5),,
10,0,0,0,0,0,1,0,1,1,1,2,4,1,2,2,5,15,15,0.0,M2019-01-09D,Race(5),,
11,0,3,4,7,0,0,0,0,0,2,3,5,0,5,7,12,21,21,0.0,M2019-01-09D,Race(5),,
1,18,7,2,27,20,8,6,34,14,7,3,24,52,22,11,85,3.6,3.6,0.0,M2019-01-09D,Race(6),,
2,7,18,5,30,9,14,9,32,6,9,8,23,22,41,22,85,4.4,4.4,0.0,M2019-01-09D,Race(6),,
3,0,0,6,6,0,2,5,7,0,5,1,6,0,7,12,19,10,10,0.0,M2019-01-09D,Race(6),,
4,0,3,2,5,0,2,3,5,1,1,4,6,1,6,9,16,10,10,0.0,M2019-01-09D,Race(6),,
5,0,0,3,3,0,2,2,4,0,2,4,6,0,4,9,13,6.5,6.5,0.0,M2019-01-09D,Race(6),,
6,2,0,4,6,0,0,2,2,2,1,5,8,4,1,11,16,5.5,5.5,1.0,M2019-01-09D,Race(6),,
7,0,0,0,0,0,0,0,0,0,0,0,0,0,0,0,0,51,51,0.0,M2019-01-09D,Race(6),,
8,0,0,0,0,0,0,0,0,0,1,0,1,0,1,0,1,41,41,2.0,M2019-01-09D,Race(6),,
9,3,2,6,11,0,2,1,3,3,0,1,4,6,4,8,18,7,7,3.0,M2019-01-09D,Race(6),,
10,0,0,2,2,1,0,2,3,0,0,0,0,1,0,4,5,14,14,0.0,M2019-01-09D,Race(6),,
1,15,5,8,28,9,5,5,19,7,3,2,12,31,13,15,59,3.8,3.8,0.0,M2019-01-09D,Race(7),,
2,6,8,9,23,13,7,10,30,12,7,5,24,31,22,24,77,4,4,3.0,M2019-01-09D,Race(7),,
3,0,0,0,0,0,2,2,4,1,1,1,3,1,3,3,7,19,19,0.0,M2019-01-09D,Race(7),,
4,0,0,0,0,0,0,0,0,1,0,0,1,1,0,0,1,17,17,0.0,M2019-01-09D,Race(7),,
5,0,0,0,0,0,0,0,0,0,0,0,0,0,0,0,0,41,41,0.0,M2019-01-09D,Race(7),,
6,0,5,0,5,6,5,3,14,3,4,4,11,9,14,7,30,6.5,6.5,2.0,M2019-01-09D,Race(7),,
7,0,5,2,7,0,7,4,11,1,8,6,15,1,20,12,33,11,11,1.0,M2019-01-09D,Race(7),,
8,0,0,0,0,0,0,0,0,0,0,0,0,0,0,0,0,18,18,0.0,M2019-01-09D,Race(7),,
9,0,0,0,0,0,0,2,2,0,0,3,3,0,0,5,5,10,10,0.0,M2019-01-09D,Race(7),,
10,0,4,0,4,2,3,1,6,1,2,1,4,3,9,2,14,13,13,0.0,M2019-01-09D,Race(7),,
11,0,0,2,2,0,0,0,0,0,0,1,1,0,0,3,3,21,21,0.0,M2019-01-09D,Race(7),,
12,9,3,9,21,0,1,3,4,0,1,3,4,9,5,15,29,8,8,0.0,M2019-01-09D,Race(7),,
1,0,5,0,5,0,4,0,4,1,2,0,3,1,11,0,12,13,13,0.0,M2019-01-09D,Race(8),,
2,0,2,0,2,0,0,1,1,1,0,1,2,1,2,2,5,26,26,0.0,M2019-01-09D,Race(8),,
3,0,0,0,0,0,0,0,0,0,1,0,1,0,1,0,1,41,41,0.0,M2019-01-09D,Race(8),,
4,0,9,8,17,3,7,6,16,2,8,6,16,5,24,20,49,10,10,2.0,M2019-01-09D,Race(8),,
5,22,3,2,27,22,6,4,32,21,3,1,25,65,12,7,84,1.8,1.8,1.0,M2019-01-09D,Race(8),,
6,0,0,3,3,0,1,0,1,0,1,0,1,0,2,3,5,16,16,3.0,M2019-01-09D,Race(8),,
7,5,8,8,21,1,6,10,17,0,11,6,17,6,25,24,55,5.5,5.5,0.0,M2019-01-09D,Race(8),,
8,0,3,9,12,4,4,8,16,1,0,10,11,5,7,27,39,8,8,0.0,M2019-01-09D,Race(8),,
9,3,0,0,3,0,1,0,1,0,0,0,0,3,1,0,4,17,17,0.0,M2019-01-09D,Race(8),,
10,0,0,0,0,0,1,1,2,0,0,0,0,0,1,1,2,26,26,0.0,M2019-01-09D,Race(8),,
11,0,0,0,0,0,0,0,0,0,0,0,0,0,0,0,0,71,67,0.0,M2019-01-09D,Race(8),,
12,0,0,0,0,0,0,0,0,0,0,0,0,0,0,0,0,51,51,0.0,M2019-01-09D,Race(8),,
1,3,2,0,5,0,8,4,12,0,0,6,6,3,10,10,23,16,17,0.0,M2019-01-12D,Race(1),,
2,22,0,5,27,19,1,2,22,18,2,5,25,59,3,12,74,2.05,2.1,2.0,M2019-01-12D,Race(1),,
3,0,3,2,5,0,2,4,6,0,0,3,3,0,5,9,14,19,19,0.0,M2019-01-12D,Race(1),,
4,0,2,0,2,0,1,0,1,1,4,0,5,1,7,0,8,12,12,0.0,M2019-01-12D,Race(1),,
5,0,0,0,0,0,0,0,0,0,0,0,0,0,0,0,0,41,35,0.0,M2019-01-12D,Race(1),,
6,0,0,0,0,0,0,8,8,0,0,3,3,0,0,11,11,26,27,0.0,M2019-01-12D,Race(1),,
7,0,7,3,10,0,2,5,7,1,2,2,5,1,11,10,22,9,9,1.0,M2019-01-12D,Race(1),,
8,3,3,5,11,8,0,3,11,2,3,6,11,13,6,14,33,6.5,6.5,3.0,M2019-01-12D,Race(1),,
9,2,13,15,30,2,15,3,20,4,15,1,20,8,43,19,70,4.4,4,0.0,M2019-01-12D,Race(1),,
10,0,0,0,0,0,0,0,0,0,0,0,0,0,0,0,0,34,35,0.0,M2019-01-12D,Race(1),,
1,0,0,3,3,0,1,1,2,1,0,2,3,1,1,6,8,13,13,0.0,M2019-01-12D,Race(10),,
2,0,0,0,0,8,0,2,10,0,1,4,5,8,1,6,15,18,18,0.0,M2019-01-12D,Race(10),,
3,0,0,0,0,0,8,1,9,2,0,1,3,2,8,2,12,21,21,0.0,M2019-01-12D,Race(10),,
4,0,0,0,0,0,0,0,0,0,2,0,2,0,2,0,2,26,26,0.0,M2019-01-12D,Race(10),,
5,0,0,0,0,0,0,0,0,0,0,0,0,0,0,0,0,35,35,0.0,M2019-01-12D,Race(10),,
6,0,0,0,0,0,0,0,0,2,0,2,4,2,0,2,4,19,19,2.0,M2019-01-12D,Race(10),,
7,5,0,3,8,0,3,3,6,0,3,3,6,5,6,9,20,15,15,0.0,M2019-01-12D,Race(10),,
8,0,5,4,9,3,1,9,13,2,1,10,13,5,7,23,35,6.5,6.5,0.0,M2019-01-12D,Race(10),,
9,0,0,0,0,0,0,0,0,0,0,0,0,0,0,0,0,41,41,0.0,M2019-01-12D,Race(10),,
10,2,0,0,2,0,0,0,0,0,0,0,0,2,0,0,2,35,35,0.0,M2019-01-12D,Race(10),,
11,4,3,6,13,1,2,0,3,2,2,2,6,7,7,8,22,,,0.0,M2019-01-12D,Race(10),,
12,8,11,6,25,5,8,2,15,6,10,1,17,19,29,9,57,7.5,7.5,0.0,M2019-01-12D,Race(10),,
13,0,3,0,3,0,1,8,9,0,0,0,0,0,4,8,12,17,17,3.0,M2019-01-12D,Race(10),,
14,11,8,8,27,12,5,3,20,11,7,1,19,34,20,12,66,2.4,2.4,1.0,M2019-01-12D,Race(10),,
1,7,7,5,19,11,4,4,19,11,3,3,17,29,14,12,55,6,6,0.0,M2019-01-12D,Race(2),,
2,9,7,7,23,0,7,3,10,5,9,3,17,14,23,13,50,4.2,4.2,3.0,M2019-01-12D,Race(2),,
3,0,0,0,0,0,0,1,1,0,0,1,1,0,0,2,2,41,41,0.0,M2019-01-12D,Race(2),,
4,3,0,0,3,0,8,6,14,2,3,7,12,5,11,13,29,7.5,7.5,0.0,M2019-01-12D,Race(2),,
5,0,3,13,16,1,3,4,8,3,4,5,12,4,10,22,36,6,6,0.0,M2019-01-12D,Race(2),,
6,0,0,0,0,8,0,1,9,0,0,0,0,8,0,1,9,13,13,0.0,M2019-01-12D,Race(2),,
7,0,4,0,4,0,0,0,0,0,0,2,2,0,4,2,6,26,26,0.0,M2019-01-12D,Race(2),,
8,0,0,0,0,0,0,0,0,0,1,0,1,0,1,0,1,17,17,0.0,M2019-01-12D,Race(2),,
9,0,0,0,0,0,0,0,0,0,0,0,0,0,0,0,0,17,17,0.0,M2019-01-12D,Race(2),,
10,9,9,5,23,9,7,2,18,5,6,3,14,23,22,10,55,4.2,4.2,1.0,M2019-01-12D,Race(2),,
11,2,0,0,2,0,0,0,0,0,0,0,0,2,0,0,2,67,67,0.0,M2019-01-12D,Race(2),,
12,0,0,0,0,0,0,8,8,0,0,1,1,0,0,9,9,21,21,2.0,M2019-01-12D,Race(2),,
13,0,0,0,0,0,0,0,0,0,0,0,0,0,0,0,0,61,61,0.0,M2019-01-12D,Race(2),,
1,7,10,3,20,11,3,5,19,10,8,3,21,28,21,11,60,3.4,3.4,1.0,M2019-01-12D,Race(3),,
2,6,3,7,16,2,8,3,13,4,6,2,12,12,17,12,41,7.5,7.5,0.0,M2019-01-12D,Race(3),,
3,5,0,0,5,2,2,3,7,3,3,2,8,10,5,5,20,11,11,0.0,M2019-01-12D,Race(3),,
4,0,0,0,0,0,0,0,0,0,0,0,0,0,0,0,0,26,26,0.0,M2019-01-12D,Race(3),,
5,3,10,0,13,8,1,1,10,1,2,5,8,12,13,6,31,10,10,0.0,M2019-01-12D,Race(3),,
6,6,3,5,14,4,5,4,13,6,3,5,14,16,11,14,41,4.8,4.8,0.0,M2019-01-12D,Race(3),,
7,0,0,5,5,1,8,2,11,0,2,3,5,1,10,10,21,11,11,3.0,M2019-01-12D,Race(3),,
8,0,0,2,2,0,0,0,0,0,0,0,0,0,0,2,2,34,34,0.0,M2019-01-12D,Race(3),,
9,0,0,0,0,0,0,0,0,0,2,1,3,0,2,1,3,15,15,0.0,M2019-01-12D,Race(3),,
10,0,0,0,0,0,0,0,0,0,0,0,0,0,0,0,0,41,41,0.0,M2019-01-12D,Race(3),,
11,0,0,0,0,0,1,8,9,1,0,2,3,1,1,10,12,11,11,0.0,M2019-01-12D,Race(3),,
12,0,0,0,0,0,0,0,0,0,0,0,0,0,0,0,0,,,0.0,M2019-01-12D,Race(3),,
13,3,4,8,15,1,1,3,5,1,0,3,4,5,5,14,24,8.5,8.5,2.0,M2019-01-12D,Race(3),,
1,6,10,7,23,14,4,3,21,18,1,4,23,38,15,14,67,2.6,2.6,3.0,M2019-01-12D,Race(4),,
2,0,5,11,16,2,9,5,16,0,3,7,10,2,17,23,42,7,7,0.0,M2019-01-12D,Race(4),,
3,0,0,0,0,0,0,0,0,1,0,0,1,1,0,0,1,41,41,0.0,M2019-01-12D,Race(4),,
4,0,0,0,0,0,0,0,0,0,0,0,0,0,0,0,0,41,41,0.0,M2019-01-12D,Race(4),,
5,0,0,0,0,0,0,0,0,0,0,0,0,0,0,0,0,3,3,0.0,M2019-01-12D,Race(4),,
6,0,0,0,0,0,0,0,0,0,1,0,1,0,1,0,1,19,19,0.0,M2019-01-12D,Race(4),,
7,5,6,0,11,8,2,3,13,1,1,5,7,14,9,8,31,8.5,8.5,2.0,M2019-01-12D,Race(4),,
8,0,0,0,0,0,3,8,11,0,5,1,6,0,8,9,17,15,15,0.0,M2019-01-12D,Race(4),,
9,5,0,2,7,0,0,0,0,0,0,0,0,5,0,2,7,11,11,0.0,M2019-01-12D,Race(4),,
10,10,5,3,18,4,8,6,18,5,7,6,18,19,20,15,54,6,6,1.0,M2019-01-12D,Race(4),,
11,2,4,7,13,1,3,4,8,1,8,3,12,4,15,14,33,7.5,7.5,0.0,M2019-01-12D,Race(4),,
12,2,0,0,2,0,0,0,0,0,0,0,0,2,0,0,2,34,34,0.0,M2019-01-12D,Race(4),,
13,0,0,0,0,0,0,0,0,0,0,0,0,0,0,0,0,67,67,0.0,M2019-01-12D,Race(4),,
1,2,0,0,2,0,8,0,8,1,2,0,3,3,10,0,13,10,10,0.0,M2019-01-12D,Race(5),,
2,0,0,16,16,0,8,7,15,0,4,6,10,0,12,29,41,14,14,3.0,M2019-01-12D,Race(5),,
3,0,0,0,0,0,0,0,0,1,0,1,2,1,0,1,2,151,151,0.0,M2019-01-12D,Race(5),,
4,14,13,0,27,17,3,2,22,19,4,3,26,50,20,5,75,1.85,1.85,2.0,M2019-01-12D,Race(5),,
5,3,7,3,13,0,4,5,9,1,6,4,11,4,17,12,33,11,11,0.0,M2019-01-12D,Race(5),,
6,2,3,5,10,13,3,3,19,3,4,7,14,18,10,15,43,7,7,0.0,M2019-01-12D,Race(5),,
7,0,0,0,0,0,0,0,0,0,0,0,0,0,0,0,0,81,81,0.0,M2019-01-12D,Race(5),,
8,6,7,0,13,0,1,9,10,0,3,3,6,6,11,12,29,7,7,0.0,M2019-01-12D,Race(5),,
9,0,0,4,4,0,0,0,0,0,0,0,0,0,0,4,4,81,81,0.0,M2019-01-12D,Race(5),,
10,0,0,0,0,0,0,0,0,0,0,0,0,0,0,0,0,101,101,0.0,M2019-01-12D,Race(5),,
11,0,0,0,0,0,0,0,0,0,1,0,1,0,1,0,1,21,21,1.0,M2019-01-12D,Race(5),,
12,0,0,0,0,0,0,0,0,0,0,0,0,0,0,0,0,35,35,0.0,M2019-01-12D,Race(5),,
13,3,0,2,5,0,2,3,5,1,2,2,5,4,4,7,15,13,13,0.0,M2019-01-12D,Race(5),,
1,4,0,0,4,2,0,0,2,2,0,0,2,8,0,0,8,26,26,3.0,M2019-01-12D,Race(6),,
2,0,5,0,5,2,2,3,7,5,4,3,12,7,11,6,24,7.5,7.5,0.0,M2019-01-12D,Race(6),,
3,11,10,2,23,10,4,2,16,6,8,4,18,27,22,8,57,4,4,0.0,M2019-01-12D,Race(6),,
4,2,0,0,2,0,0,0,0,0,0,1,1,2,0,1,3,15,15,0.0,M2019-01-12D,Race(6),,
5,3,3,7,13,1,5,2,8,1,3,2,6,5,11,11,27,11,11,2.0,M2019-01-12D,Race(6),,
6,0,2,0,2,0,0,0,0,0,2,0,2,0,4,0,4,17,17,0.0,M2019-01-12D,Race(6),,
7,5,5,5,15,3,2,2,7,3,0,0,3,11,7,7,25,10,10,0.0,M2019-01-12D,Race(6),,
8,0,0,5,5,0,0,0,0,0,0,0,0,0,0,5,5,8,8,0.0,M2019-01-12D,Race(6),,
9,0,0,0,0,8,1,1,10,1,1,0,2,9,2,1,12,19,19,0.0,M2019-01-12D,Race(6),,
10,0,0,2,2,0,0,0,0,0,0,0,0,0,0,2,2,34,34,0.0,M2019-01-12D,Race(6),,
11,0,2,9,11,1,8,7,16,4,1,8,13,5,11,24,40,11,11,0.0,M2019-01-12D,Race(6),,
12,2,0,0,2,0,3,8,11,0,4,2,6,2,7,10,19,7,7,0.0,M2019-01-12D,Race(6),,
13,3,3,0,6,2,4,4,10,4,3,6,13,9,10,10,29,10,10,1.0,M2019-01-12D,Race(6),,
1,3,5,4,12,6,4,2,12,2,3,5,10,11,12,11,34,7.5,7.5,3.0,M2019-01-12D,Race(7),,
2,0,4,0,4,0,0,1,1,1,1,1,3,1,5,2,8,12,12,0.0,M2019-01-12D,Race(7),,
3,0,3,0,3,3,3,3,9,4,6,4,14,7,12,7,26,9,9,1.0,M2019-01-12D,Race(7),,
4,0,3,13,16,0,3,2,5,0,1,3,4,0,7,18,25,10,10,0.0,M2019-01-12D,Race(7),,
5,10,7,6,23,4,2,4,10,6,4,5,15,20,13,15,48,3.6,3.6,0.0,M2019-01-12D,Race(7),,
6,7,6,2,15,8,4,6,18,11,6,3,20,26,16,11,53,5,5,0.0,M2019-01-12D,Race(7),,
7,0,0,0,0,0,0,0,0,0,0,0,0,0,0,0,0,41,41,0.0,M2019-01-12D,Race(7),,
8,0,0,0,0,0,2,8,10,0,1,0,1,0,3,8,11,17,17,0.0,M2019-01-12D,Race(7),,
9,7,0,0,7,0,0,0,0,1,0,1,2,8,0,1,9,15,15,0.0,M2019-01-12D,Race(7),,
10,0,0,0,0,0,0,0,0,0,0,0,0,0,0,0,0,26,26,0.0,M2019-01-12D,Race(7),,
11,0,0,2,2,0,8,0,8,0,0,0,0,0,8,2,10,12,12,2.0,M2019-01-12D,Race(7),,
12,3,2,3,8,8,3,3,14,1,4,4,9,12,9,10,31,10,10,0.0,M2019-01-12D,Race(7),,
1,3,4,2,9,1,3,2,6,4,5,0,9,8,12,4,24,6.5,6.5,0.0,M2019-01-12D,Race(8),,
2,0,0,0,0,0,0,0,0,0,1,0,1,0,1,0,1,51,51,0.0,M2019-01-12D,Race(8),,
3,0,0,0,0,0,0,1,1,0,1,2,3,0,1,3,4,35,35,0.0,M2019-01-12D,Race(8),,
4,0,0,0,0,1,0,2,3,0,1,3,4,1,1,5,7,11,11,0.0,M2019-01-12D,Race(8),,
5,0,0,0,0,0,0,8,8,1,2,2,5,1,2,10,13,21,21,0.0,M2019-01-12D,Race(8),,
6,0,0,2,2,1,0,0,1,0,0,0,0,1,0,2,3,19,19,0.0,M2019-01-12D,Race(8),,
7,6,3,9,18,6,2,6,14,6,1,6,13,18,6,21,45,8,8,2.0,M2019-01-12D,Race(8),,
8,0,0,0,0,0,0,0,0,0,0,0,0,0,0,0,0,51,51,0.0,M2019-01-12D,Race(8),,
9,0,4,0,4,0,1,0,1,0,1,0,1,0,6,0,6,15,15,0.0,M2019-01-12D,Race(8),,
10,0,3,10,13,1,2,0,3,2,2,3,7,3,7,13,23,7,7,0.0,M2019-01-12D,Race(8),,
11,3,0,0,3,8,0,0,8,1,2,1,4,12,2,1,15,15,15,0.0,M2019-01-12D,Race(8),,
12,0,0,0,0,0,8,0,8,0,0,0,0,0,8,0,8,101,101,0.0,M2019-01-12D,Race(8),,
13,16,5,5,26,6,6,5,17,8,3,7,18,30,14,17,61,3,3,1.0,M2019-01-12D,Race(8),,
14,2,11,2,15,5,7,5,17,4,7,2,13,11,25,9,45,8,8,3.0,M2019-01-12D,Race(8),,
1,9,2,8,19,3,1,3,7,5,0,4,9,17,3,15,35,8,8,0.0,M2019-01-12D,Race(9),,
2,9,7,6,22,6,8,5,19,5,11,4,20,20,26,15,61,5.5,5.5,0.0,M2019-01-12D,Race(9),,
3,0,0,0,0,0,1,0,1,0,2,0,2,0,3,0,3,34,34,0.0,M2019-01-12D,Race(9),,
4,0,0,0,0,3,2,4,9,6,2,4,12,9,4,8,21,15,15,0.0,M2019-01-12D,Race(9),,
5,0,0,0,0,0,0,1,1,0,1,2,3,0,1,3,4,15,15,3.0,M2019-01-12D,Race(9),,
6,0,0,0,0,8,0,2,10,0,1,2,3,8,1,4,13,14,14,0.0,M2019-01-12D,Race(9),,
7,0,6,0,6,0,0,3,3,1,3,0,4,1,9,3,13,12,12,2.0,M2019-01-12D,Race(9),,
8,9,5,0,14,1,3,3,7,2,6,4,12,12,14,7,33,4.6,4.6,0.0,M2019-01-12D,Race(9),,
9,0,5,2,7,1,1,8,10,1,0,4,5,2,6,14,22,10,10,0.0,M2019-01-12D,Race(9),,
10,0,0,3,3,0,8,0,8,0,0,0,0,0,8,3,11,23,23,0.0,M2019-01-12D,Race(9),,
11,0,0,0,0,0,0,0,0,0,0,0,0,0,0,0,0,67,67,0.0,M2019-01-12D,Race(9),,
12,0,0,0,0,0,0,0,0,0,0,1,1,0,0,1,1,34,34,0.0,M2019-01-12D,Race(9),,
13,0,0,0,0,0,0,0,0,0,0,0,0,0,0,0,0,101,101,0.0,M2019-01-12D,Race(9),,
14,3,5,11,19,7,5,0,12,6,0,1,7,16,10,12,38,4.2,4.2,1.0,M2019-01-12D,Race(9),,
1,5,16,7,28,8,9,4,21,10,9,3,22,23,34,14,71,3.2,3.2,0.0,M2019-01-16D,Race(1),,
2,0,2,0,2,0,2,2,4,0,1,3,4,0,5,5,10,12,12,0.0,M2019-01-16D,Race(1),,
3,2,0,3,5,0,1,1,2,0,1,0,1,2,2,4,8,9.5,12,0.0,M2019-01-16D,Race(1),,
4,21,7,2,30,13,7,2,22,13,6,4,23,47,20,8,75,2.2,2.2,1.0,M2019-01-16D,Race(1),,
5,0,0,10,10,5,5,6,16,2,3,4,9,7,8,20,35,9,9,2.0,M2019-01-16D,Race(1),,
6,2,3,2,7,0,1,5,6,0,3,6,9,2,7,13,22,8,8,3.0,M2019-01-16D,Race(1),,
7,0,2,6,8,4,5,10,19,1,3,4,8,5,10,20,35,10,10,0.0,M2019-01-16D,Race(1),,
1,16,4,2,22,14,7,6,27,11,3,3,17,41,14,11,66,4.4,4.4,0.0,M2019-01-16D,Race(2),,
2,0,0,0,0,0,0,0,0,0,0,0,0,0,0,0,0,17,17,0.0,M2019-01-16D,Race(2),,
3,5,6,5,16,2,3,5,10,5,3,4,12,12,12,14,38,4,4,0.0,M2019-01-16D,Race(2),,
4,4,8,5,17,10,10,7,27,5,5,3,13,19,23,15,57,7,7,1.0,M2019-01-16D,Race(2),,
5,0,0,0,0,1,0,3,4,2,1,3,6,3,1,6,10,17,17,3.0,M2019-01-16D,Race(2),,
6,2,2,0,4,0,1,1,2,0,2,1,3,2,5,2,9,19,19,0.0,M2019-01-16D,Race(2),,
7,0,0,2,2,0,0,0,0,0,1,1,2,0,1,3,4,31,31,0.0,M2019-01-16D,Race(2),,
8,0,8,7,15,2,1,1,4,0,2,2,4,2,11,10,23,7,7,0.0,M2019-01-16D,Race(2),,
9,3,0,0,3,0,1,2,3,1,0,3,4,4,1,5,10,7.5,7.5,0.0,M2019-01-16D,Race(2),,
10,0,2,9,11,1,7,5,13,2,9,6,17,3,18,20,41,5.5,5.5,2.0,M2019-01-16D,Race(2),,
11,0,0,0,0,0,0,0,0,0,0,0,0,0,0,0,0,51,51,0.0,M2019-01-16D,Race(2),,
1,0,0,3,3,0,1,0,1,1,0,0,1,1,1,3,5,26,26,0.0,M2019-01-16D,Race(3),,
2,2,5,4,11,1,2,5,8,1,2,5,8,4,9,14,27,7,7,0.0,M2019-01-16D,Race(3),,
3,0,7,13,20,3,4,3,10,6,8,2,16,9,19,18,46,7,7,0.0,M2019-01-16D,Race(3),,
4,5,8,7,20,1,7,3,11,0,4,8,12,6,19,18,43,5.5,5.5,0.0,M2019-01-16D,Race(3),,
5,0,0,0,0,0,0,1,1,0,0,0,0,0,0,1,1,23,23,0.0,M2019-01-16D,Race(3),,
6,21,3,0,24,14,7,7,28,14,5,2,21,49,15,9,73,2.6,2.6,0.0,M2019-01-16D,Race(3),,
7,0,0,0,0,0,1,2,3,0,1,1,2,0,2,3,5,16,16,2.0,M2019-01-16D,Race(3),,
8,2,2,3,7,9,6,6,21,1,0,2,3,12,8,11,31,6,6,1.0,M2019-01-16D,Race(3),,
9,0,5,0,5,2,2,3,7,2,6,6,14,4,13,9,26,8.5,8.5,3.0,M2019-01-16D,Race(3),,
10,0,0,0,0,0,0,0,0,0,0,0,0,0,0,0,0,126,126,0.0,M2019-01-16D,Race(3),,
11,0,0,0,0,0,0,0,0,1,0,0,1,1,0,0,1,101,101,0.0,M2019-01-16D,Race(3),,
1,0,9,11,20,10,11,8,29,6,6,1,13,16,26,20,62,7,7,2.0,M2019-01-16D,Race(4),,
2,2,0,0,2,0,3,2,5,1,3,2,6,3,6,4,13,14,14,0.0,M2019-01-16D,Race(4),,
3,2,9,0,11,2,2,3,7,2,1,2,5,6,12,5,23,5.5,5.5,0.0,M2019-01-16D,Race(4),,
4,0,0,0,0,0,1,0,1,0,0,0,0,0,1,0,1,17,17,0.0,M2019-01-16D,Race(4),,
5,8,2,8,18,4,3,3,10,6,5,3,14,18,10,14,42,5.5,5.5,0.0,M2019-01-16D,Race(4),,
6,4,2,2,8,3,3,4,10,3,4,4,11,10,9,10,29,8,8,1.0,M2019-01-16D,Race(4),,
7,6,2,2,10,9,5,7,21,6,4,4,14,21,11,13,45,5,5,0.0,M2019-01-16D,Race(4),,
8,0,0,2,2,0,0,2,2,0,0,3,3,0,0,7,7,12,12,0.0,M2019-01-16D,Race(4),,
9,6,6,5,17,1,1,1,3,2,2,4,8,9,9,10,28,6.5,6.5,3.0,M2019-01-16D,Race(4),,
10,2,0,0,2,1,1,0,2,0,1,1,2,3,2,1,6,14,14,0.0,M2019-01-16D,Race(4),,
11,0,0,0,0,0,0,0,0,0,0,2,2,0,0,2,2,34,35,0.0,M2019-01-16D,Race(4),,
1,7,7,16,30,6,9,8,23,7,6,5,18,20,22,29,71,4,4,1.0,M2019-01-16D,Race(5),,
2,0,3,2,5,0,3,4,7,2,6,7,15,2,12,13,27,8.5,8.5,0.0,M2019-01-16D,Race(5),,
3,0,0,0,0,1,0,4,5,2,1,2,5,3,1,6,10,10,10,0.0,M2019-01-16D,Race(5),,
4,0,0,0,0,1,0,0,1,0,1,0,1,1,1,0,2,10,10,0.0,M2019-01-16D,Race(5),,
5,0,0,5,5,0,0,0,0,0,0,0,0,0,0,5,5,21,21,0.0,M2019-01-16D,Race(5),,
6,3,8,4,15,15,8,5,28,10,1,4,15,28,17,13,58,4.8,4.8,3.0,M2019-01-16D,Race(5),,
7,3,5,0,8,0,0,1,1,0,0,2,2,3,5,3,11,19,19,0.0,M2019-01-16D,Race(5),,
8,3,2,0,5,0,0,1,1,1,3,3,7,4,5,4,13,10,10,2.0,M2019-01-16D,Race(5),,
9,3,0,0,3,0,0,0,0,0,0,0,0,3,0,0,3,19,19,0.0,M2019-01-16D,Race(5),,
10,2,0,0,2,0,0,1,1,0,0,0,0,2,0,1,3,23,23,0.0,M2019-01-16D,Race(5),,
11,0,0,0,0,0,0,0,0,0,0,0,0,0,0,0,0,10,10,0.0,M2019-01-16D,Race(5),,
12,9,5,3,17,7,10,6,23,4,8,3,15,20,23,12,55,8,8,0.0,M2019-01-16D,Race(5),,
1,14,6,7,27,11,11,6,28,14,5,3,22,39,22,16,77,3,3,0.0,M2019-01-16D,Race(6),,
2,0,0,0,0,0,0,0,0,0,0,0,0,0,0,0,0,101,101,0.0,M2019-01-16D,Race(6),,
3,3,4,9,16,2,2,6,10,2,3,8,13,7,9,23,39,9,9,0.0,M2019-01-16D,Race(6),,
4,0,2,0,2,1,0,0,1,1,2,0,3,2,4,0,6,15,15,0.0,M2019-01-16D,Race(6),,
5,0,0,0,0,0,0,0,0,0,1,1,2,0,1,1,2,21,21,0.0,M2019-01-16D,Race(6),,
6,2,7,0,9,3,1,0,4,3,2,2,7,8,10,2,20,15,15,0.0,M2019-01-16D,Race(6),,
7,5,2,7,14,6,6,10,22,1,4,4,9,12,12,21,45,4.6,4.6,1.0,M2019-01-16D,Race(6),,
8,0,3,0,3,0,0,1,1,0,1,1,2,0,4,2,6,13,13,0.0,M2019-01-16D,Race(6),,
9,0,0,0,0,0,0,0,0,0,0,0,0,0,0,0,0,101,101,0.0,M2019-01-16D,Race(6),,
10,6,3,7,16,6,10,7,23,5,8,6,19,17,21,20,58,5,5,2.0,M2019-01-16D,Race(6),,
11,0,0,0,0,0,0,0,0,0,0,1,1,0,0,1,1,13,13,0.0,M2019-01-16D,Race(6),,
12,0,3,0,3,1,0,0,1,0,0,0,0,1,3,0,4,12,12,3.0,M2019-01-16D,Race(6),,
1,4,6,0,10,9,10,7,26,11,8,3,22,24,24,10,58,7.5,7.5,0.0,M2019-01-16D,Race(7),,
2,0,0,7,7,1,0,2,3,0,2,0,2,1,2,9,12,8.5,8.5,0.0,M2019-01-16D,Race(7),,
3,0,0,0,0,0,0,0,0,0,0,0,0,0,0,0,0,8.5,8.5,0.0,M2019-01-16D,Race(7),,
4,12,2,5,19,3,5,4,12,1,3,11,15,16,10,20,46,4,4,0.0,M2019-01-16D,Race(7),,
5,0,0,0,0,0,0,0,0,0,0,0,0,0,0,0,0,51,51,0.0,M2019-01-16D,Race(7),,
6,0,2,0,2,0,0,0,0,0,0,0,0,0,2,0,2,10,10,0.0,M2019-01-16D,Race(7),,
7,2,4,0,6,0,1,2,3,0,1,2,3,2,6,4,12,16,16,0.0,M2019-01-16D,Race(7),,
8,0,6,10,16,6,7,5,18,9,8,3,20,15,21,18,54,7,7,3.0,M2019-01-16D,Race(7),,
9,2,3,0,5,2,0,0,2,0,0,1,1,4,3,1,8,15,15,2.0,M2019-01-16D,Race(7),,
10,0,0,0,0,0,0,0,0,0,0,0,0,0,0,0,0,26,26,1.0,M2019-01-16D,Race(7),,
11,5,0,0,5,0,0,1,1,1,1,1,3,6,1,2,9,26,26,0.0,M2019-01-16D,Race(7),,
12,5,7,8,20,9,7,9,25,3,3,5,11,17,17,22,56,4.8,4.8,0.0,M2019-01-16D,Race(7),,
1,0,0,0,0,0,0,0,0,0,0,0,0,0,0,0,0,26,26,0.0,M2019-01-16D,Race(8),,
2,11,8,4,23,10,16,8,34,10,11,3,24,31,35,15,81,3,3,2.0,M2019-01-16D,Race(8),,
3,8,9,5,22,17,5,8,30,14,5,4,23,39,19,17,75,3.6,3.6,0.0,M2019-01-16D,Race(8),,
4,0,2,2,4,2,2,2,6,1,1,2,4,3,5,6,14,12,12,0.0,M2019-01-16D,Race(8),,
5,0,3,0,3,0,0,0,0,0,0,1,1,0,3,1,4,19,19,1.0,M2019-01-16D,Race(8),,
6,0,0,0,0,0,0,0,0,0,1,0,1,0,1,0,1,41,41,0.0,M2019-01-16D,Race(8),,
7,7,0,12,19,0,6,8,14,0,5,10,15,7,11,30,48,6.5,6.5,0.0,M2019-01-16D,Race(8),,
8,0,2,4,6,0,0,0,0,0,0,1,1,0,2,5,7,12,12,0.0,M2019-01-16D,Race(8),,
9,0,3,0,3,0,0,1,1,0,0,1,1,0,3,2,5,13,13,0.0,M2019-01-16D,Race(8),,
10,2,0,3,5,1,1,2,4,1,3,2,6,4,4,7,15,11,11,0.0,M2019-01-16D,Race(8),,
11,2,3,0,5,0,0,1,1,0,0,2,2,2,3,3,8,17,17,3.0,M2019-01-16D,Race(8),,
12,0,0,0,0,0,0,0,0,0,0,0,0,0,0,0,0,41,41,0.0,M2019-01-16D,Race(8),,
1,12,6,8,26,12,6,8,26,2,5,3,10,26,17,19,62,6,6,0.0,M2019-01-23D,Race(1),,
2,0,7,7,14,0,7,7,14,6,3,3,12,6,17,17,40,9,9,3.0,M2019-01-23D,Race(1),,
3,2,0,5,7,2,0,5,7,2,4,2,8,6,4,12,22,16,16,0.0,M2019-01-23D,Race(1),,
4,13,7,7,27,13,7,7,27,9,8,3,20,35,22,17,74,3.2,3.2,1.0,M2019-01-23D,Race(1),,
5,0,0,0,0,0,0,0,0,0,0,0,0,0,0,0,0,34,34,0.0,M2019-01-23D,Race(1),,
6,3,8,3,14,3,8,3,14,7,4,11,22,13,20,17,50,3.2,3.2,0.0,M2019-01-23D,Race(1),,
7,0,0,0,0,0,0,0,0,0,1,0,1,0,1,0,1,26,26,0.0,M2019-01-23D,Race(1),,
8,0,0,0,0,0,0,0,0,0,1,2,3,0,1,2,3,9,9,2.0,M2019-01-23D,Race(1),,
9,0,0,0,0,0,0,0,0,0,0,1,1,0,0,1,1,13,13,0.0,M2019-01-23D,Race(1),,
10,0,0,0,0,0,0,0,0,0,0,0,0,0,0,0,0,81,81,0.0,M2019-01-23D,Race(1),,
11,0,2,0,2,0,2,0,2,0,0,1,1,0,4,1,5,16,16,0.0,M2019-01-23D,Race(1),,
1,13,12,2,27,13,12,2,27,14,4,2,20,40,28,6,74,4.8,4.8,0.0,M2019-01-23D,Race(2),,
2,0,0,2,2,0,0,2,2,4,3,3,10,4,3,7,14,13,13,3.0,M2019-01-23D,Race(2),,
3,0,0,0,0,0,0,0,0,0,0,1,1,0,0,1,1,16,21,0.0,M2019-01-23D,Race(2),,
4,0,0,0,0,0,0,0,0,0,1,1,2,0,1,1,2,11,11,0.0,M2019-01-23D,Race(2),,
5,0,2,0,2,0,2,0,2,0,0,1,1,0,4,1,5,26,26,0.0,M2019-01-23D,Race(2),,
6,5,0,7,12,5,0,7,12,0,2,2,4,10,2,16,28,7,7,1.0,M2019-01-23D,Race(2),,
7,10,7,11,28,10,7,11,28,7,10,5,22,27,24,27,78,3.6,3.6,0.0,M2019-01-23D,Race(2),,
8,0,0,0,0,0,0,0,0,0,0,0,0,0,0,0,0,16,16,0.0,M2019-01-23D,Race(2),,
9,0,0,0,0,0,0,0,0,0,0,2,2,0,0,2,2,13,13,2.0,M2019-01-23D,Race(2),,
10,0,0,0,0,0,0,0,0,0,0,0,0,0,0,0,0,51,51,0.0,M2019-01-23D,Race(2),,
11,2,9,5,16,2,9,5,16,1,6,8,15,5,24,18,47,5.5,5.5,0.0,M2019-01-23D,Race(2),,
12,0,0,3,3,0,0,3,3,0,0,1,1,0,0,7,7,13,13,0.0,M2019-01-23D,Race(2),,
1,0,0,0,0,0,0,0,0,1,0,1,2,1,0,1,2,41,41,0.0,M2019-01-23D,Race(3),,
2,8,4,6,18,8,4,6,18,6,0,1,7,22,8,13,43,4.6,4.6,2.0,M2019-01-23D,Race(3),,
3,0,0,0,0,0,0,0,0,0,0,0,0,0,0,0,0,71,67,0.0,M2019-01-23D,Race(3),,
4,5,5,2,12,5,5,2,12,1,6,3,10,11,16,7,34,14,14,3.0,M2019-01-23D,Race(3),,
5,0,0,0,0,0,0,0,0,0,0,3,3,0,0,3,3,8.5,8.5,0.0,M2019-01-23D,Race(3),,
6,0,3,3,6,0,3,3,6,2,7,0,9,2,13,6,21,12,12,0.0,M2019-01-23D,Race(3),,
7,0,0,5,5,0,0,5,5,3,0,1,4,3,0,11,14,21,21,0.0,M2019-01-23D,Race(3),,
8,5,3,7,15,5,3,7,15,2,2,5,9,12,8,19,39,7,7,0.0,M2019-01-23D,Race(3),,
9,0,3,2,5,0,3,2,5,3,6,2,11,3,12,6,21,8.5,8.5,0.0,M2019-01-23D,Race(3),,
10,0,4,2,6,0,4,2,6,4,2,3,9,4,10,7,21,8.5,8.5,0.0,M2019-01-23D,Race(3),,
11,12,6,3,21,12,6,3,21,4,3,7,14,28,15,13,56,4,4,1.0,M2019-01-23D,Race(3),,
12,0,2,0,2,0,2,0,2,0,0,0,0,0,4,0,4,11,11,0.0,M2019-01-23D,Race(3),,
1,0,0,3,3,0,0,3,3,1,4,4,9,1,4,10,15,15,15,0.0,M2019-01-23D,Race(4),,
2,9,0,0,9,9,0,0,9,4,3,0,7,22,3,0,25,6,6,0.0,M2019-01-23D,Race(4),,
3,3,10,2,15,3,10,2,15,1,5,3,9,7,25,7,39,6.5,6.5,0.0,M2019-01-23D,Race(4),,
4,3,4,8,15,3,4,8,15,2,0,1,3,8,8,17,33,12,12,0.0,M2019-01-23D,Race(4),,
5,3,0,8,11,3,0,8,11,6,1,6,13,12,1,22,35,5.5,5.5,3.0,M2019-01-23D,Race(4),,
6,2,0,2,4,2,0,2,4,0,0,0,0,4,0,4,8,14,14,0.0,M2019-01-23D,Race(4),,
7,3,0,0,3,3,0,0,3,0,0,0,0,6,0,0,6,19,19,1.0,M2019-01-23D,Race(4),,
8,5,13,7,25,5,13,7,25,2,2,2,6,12,28,16,56,5,5,2.0,M2019-01-23D,Race(4),,
9,0,0,0,0,0,0,0,0,0,0,1,1,0,0,1,1,15,15,0.0,M2019-01-23D,Race(4),,
10,0,0,0,0,0,0,0,0,0,0,2,2,0,0,2,2,11,11,0.0,M2019-01-23D,Race(4),,
11,0,0,0,0,0,0,0,0,0,0,0,0,0,0,0,0,81,81,0.0,M2019-01-23D,Race(4),,
12,2,3,0,5,2,3,0,5,2,8,2,12,6,14,2,22,6.5,6.5,0.0,M2019-01-23D,Race(4),,
1,5,5,4,14,5,5,4,14,4,1,4,9,14,11,12,37,7.5,7.5,0.0,M2019-01-23D,Race(5),,
2,0,0,2,2,0,0,2,2,1,2,0,3,1,2,4,7,31,31,0.0,M2019-01-23D,Race(5),,
3,0,0,0,0,0,0,0,0,0,1,0,1,0,1,0,1,31,31,3.0,M2019-01-23D,Race(5),,
4,0,0,3,3,0,0,3,3,1,0,1,2,1,0,7,8,16,16,0.0,M2019-01-23D,Race(5),,
5,0,3,6,9,0,3,6,9,0,0,0,0,0,6,12,18,15,15,0.0,M2019-01-23D,Race(5),,
6,0,2,6,8,0,2,6,8,3,4,6,13,3,8,18,29,8.5,8.5,2.0,M2019-01-23D,Race(5),,
7,19,8,0,27,19,8,0,27,11,9,1,21,49,25,1,75,2.2,2.2,0.0,M2019-01-23D,Race(5),,
8,0,10,4,14,0,10,4,14,2,5,4,11,2,25,12,39,7,7,0.0,M2019-01-23D,Race(5),,
9,3,0,0,3,3,0,0,3,0,0,1,1,6,0,1,7,18,18,0.0,M2019-01-23D,Race(5),,
10,0,0,0,0,0,0,0,0,0,1,2,3,0,1,2,3,34,34,0.0,M2019-01-23D,Race(5),,
11,3,2,5,10,3,2,5,10,4,3,7,14,10,7,17,34,7,7,1.0,M2019-01-23D,Race(5),,
12,0,0,0,0,0,0,0,0,0,0,0,0,0,0,0,0,34,34,0.0,M2019-01-23D,Race(5),,
1,2,0,6,8,2,0,6,8,1,6,6,13,5,6,18,29,10,10,0.0,M2019-01-23D,Race(6),,
2,3,3,0,6,3,3,0,6,2,2,3,7,8,8,3,19,11,11,2.0,M2019-01-23D,Race(6),,
3,0,2,8,10,0,2,8,10,1,1,2,4,1,5,18,24,11,11,0.0,M2019-01-23D,Race(6),,
4,4,8,9,21,4,8,9,21,10,2,3,15,18,18,21,57,3.8,3.8,1.0,M2019-01-23D,Race(6),,
5,0,0,0,0,0,0,0,0,0,0,0,0,0,0,0,0,15,15,0.0,M2019-01-23D,Race(6),,
6,2,0,0,2,2,0,0,2,0,0,0,0,4,0,0,4,26,26,0.0,M2019-01-23D,Race(6),,
7,0,3,2,5,0,3,2,5,0,0,0,0,0,6,4,10,7.5,7.5,0.0,M2019-01-23D,Race(6),,
8,5,0,0,5,5,0,0,5,1,1,1,3,11,1,1,13,10,10,0.0,M2019-01-23D,Race(6),,
9,0,5,3,8,0,5,3,8,1,5,2,8,1,15,8,24,13,13,0.0,M2019-01-23D,Race(6),,
10,8,3,2,13,8,3,2,13,8,6,5,19,24,12,9,45,5.5,5.5,3.0,M2019-01-23D,Race(6),,
11,6,6,0,12,6,6,0,12,2,2,3,7,14,14,3,31,7.5,7.5,0.0,M2019-01-23D,Race(6),,
12,0,0,0,0,0,0,0,0,0,0,1,1,0,0,1,1,51,51,0.0,M2019-01-23D,Race(6),,
1,15,8,2,25,15,8,2,25,19,3,1,23,49,19,5,73,2.4,2.4,0.0,M2019-01-23D,Race(7),,
2,0,0,0,0,0,0,0,0,0,0,0,0,0,0,0,0,31,31,0.0,M2019-01-23D,Race(7),,
3,2,0,2,4,2,0,2,4,0,0,1,1,4,0,5,9,15,15,0.0,M2019-01-23D,Race(7),,
4,0,2,3,5,0,2,3,5,0,3,3,6,0,7,9,16,6,6,3.0,M2019-01-23D,Race(7),,
5,3,6,11,20,3,6,11,20,2,14,3,19,8,26,25,59,7.5,7.5,1.0,M2019-01-23D,Race(7),,
6,2,9,9,20,2,9,9,20,3,1,8,12,7,19,26,52,11,11,0.0,M2019-01-23D,Race(7),,
7,2,0,0,2,2,0,0,2,0,1,0,1,4,1,0,5,15,15,0.0,M2019-01-23D,Race(7),,
8,0,0,0,0,0,0,0,0,0,0,1,1,0,0,1,1,23,23,0.0,M2019-01-23D,Race(7),,
9,3,5,0,8,3,5,0,8,1,2,1,4,7,12,1,20,7.5,7.5,0.0,M2019-01-23D,Race(7),,
10,0,0,0,0,0,0,0,0,1,1,5,7,1,1,5,7,15,15,0.0,M2019-01-23D,Race(7),,
11,0,0,0,0,0,0,0,0,0,1,0,1,0,1,0,1,34,34,2.0,M2019-01-23D,Race(7),,
12,3,0,3,6,3,0,3,6,0,0,3,3,6,0,9,15,19,19,0.0,M2019-01-23D,Race(7),,
1,0,0,0,0,0,0,0,0,0,0,0,0,0,0,0,0,26,26,0.0,M2019-01-23D,Race(8),,
2,2,0,0,2,2,0,0,2,2,0,3,5,6,0,3,9,12,12,0.0,M2019-01-23D,Race(8),,
3,4,0,16,20,4,0,16,20,6,8,4,18,14,8,36,58,7,7,0.0,M2019-01-23D,Race(8),,
4,10,9,2,21,10,9,2,21,2,7,4,13,22,25,8,55,3.6,3.6,1.0,M2019-01-23D,Race(8),,
5,11,7,8,26,11,7,8,26,8,8,1,17,30,22,17,69,4.2,4.2,3.0,M2019-01-23D,Race(8),,
6,0,0,2,2,0,0,2,2,1,0,0,1,1,0,4,5,31,31,0.0,M2019-01-23D,Race(8),,
7,0,3,0,3,0,3,0,3,1,1,0,2,1,7,0,8,11,11,0.0,M2019-01-23D,Race(8),,
8,0,0,0,0,0,0,0,0,0,0,0,0,0,0,0,0,26,26,0.0,M2019-01-23D,Race(8),,
9,0,0,0,0,0,0,0,0,0,0,0,0,0,0,0,0,19,19,0.0,M2019-01-23D,Race(8),,
10,3,9,2,14,3,9,2,14,4,1,5,10,10,19,9,38,4.8,4.8,2.0,M2019-01-23D,Race(8),,
11,0,0,0,0,0,0,0,0,0,0,1,1,0,0,1,1,19,19,0.0,M2019-01-23D,Race(8),,
12,0,2,0,2,0,2,0,2,0,0,0,0,0,4,0,4,23,23,0.0,M2019-01-23D,Race(8),,
1,5,2,0,7,3,8,2,13,4,1,1,6,12,11,3,26,6,6,0.0,M2019-01-27D,Race(1),,
2,2,4,2,8,0,2,8,10,1,3,4,8,3,9,14,26,10,10,2.0,M2019-01-27D,Race(1),,
3,3,8,5,16,0,3,8,11,2,3,6,11,5,14,19,38,5,5,3.0,M2019-01-27D,Race(1),,
4,2,2,3,7,8,3,1,12,2,2,3,7,12,7,7,26,9,9,0.0,M2019-01-27D,Race(1),,
5,7,6,10,23,11,7,1,19,12,5,2,19,30,18,13,61,4.8,4.8,0.0,M2019-01-27D,Race(1),,
6,5,0,5,10,2,2,5,9,2,3,3,8,9,5,13,27,5,5,1.0,M2019-01-27D,Race(1),,
7,6,8,5,19,6,5,5,16,3,8,7,18,15,21,17,53,3.8,3.8,0.0,M2019-01-27D,Race(1),,
8,0,0,0,0,0,0,0,0,0,1,0,1,0,1,0,1,21,21,0.0,M2019-01-27D,Race(1),,
1,0,0,0,0,0,1,0,1,0,0,0,0,0,1,0,1,61,61,0.0,M2019-01-27D,Race(10),,
2,6,14,7,27,11,5,4,20,15,1,5,21,32,20,16,68,4.6,4.2,1.0,M2019-01-27D,Race(10),,
3,0,0,0,0,0,0,0,0,0,0,0,0,0,0,0,0,34,31,0.0,M2019-01-27D,Race(10),,
4,0,0,0,0,0,0,0,0,0,1,0,1,0,1,0,1,61,61,0.0,M2019-01-27D,Race(10),,
5,0,0,0,0,0,0,0,0,0,0,0,0,0,0,0,0,19,19,0.0,M2019-01-27D,Race(10),,
6,0,0,2,2,0,0,3,3,0,0,3,3,0,0,8,8,13,13,0.0,M2019-01-27D,Race(10),,
7,0,0,0,0,0,8,1,9,0,0,1,1,0,8,2,10,23,21,0.0,M2019-01-27D,Race(10),,
8,0,2,3,5,8,3,5,16,0,4,6,10,8,9,14,31,8.5,8,0.0,M2019-01-27D,Race(10),,
9,0,0,2,2,0,0,8,8,0,0,1,1,0,0,11,11,17,17,0.0,M2019-01-27D,Race(10),,
10,17,4,3,24,8,5,0,13,10,9,1,20,35,18,4,57,3.2,3.3,2.0,M2019-01-27D,Race(10),,
11,0,0,0,0,0,0,0,0,0,0,0,0,0,0,0,0,71,71,0.0,M2019-01-27D,Race(10),,
12,0,0,0,0,0,0,0,0,0,1,0,1,0,1,0,1,18,17,3.0,M2019-01-27D,Race(10),,
13,0,2,3,5,0,0,0,0,0,0,0,0,0,2,3,5,26,26,0.0,M2019-01-27D,Race(10),,
14,7,8,10,25,3,8,9,20,1,10,9,20,11,26,28,65,4.6,4.6,0.0,M2019-01-27D,Race(10),,
1,3,12,0,15,3,3,10,16,4,3,1,8,10,18,11,39,5.5,5.5,0.0,M2019-01-27D,Race(2),,
2,0,0,0,0,0,0,0,0,0,0,0,0,0,0,0,0,101,101,0.0,M2019-01-27D,Race(2),,
3,2,2,6,10,9,5,5,19,7,4,8,19,18,11,19,48,7,7,0.0,M2019-01-27D,Race(2),,
4,3,2,4,9,8,4,5,17,2,7,4,13,13,13,13,39,4,4,0.0,M2019-01-27D,Race(2),,
5,0,0,0,0,0,0,0,0,0,1,0,1,0,1,0,1,41,41,0.0,M2019-01-27D,Race(2),,
6,12,0,5,17,3,8,3,14,3,6,6,15,18,14,14,46,4.6,4.6,2.0,M2019-01-27D,Race(2),,
7,2,2,6,10,5,1,2,8,5,2,2,9,12,5,10,27,11,11,1.0,M2019-01-27D,Race(2),,
8,2,6,5,13,2,1,0,3,4,0,0,4,8,7,5,20,6.5,6.5,0.0,M2019-01-27D,Race(2),,
9,3,6,2,11,0,8,5,13,1,2,4,7,4,16,11,31,11,11,0.0,M2019-01-27D,Race(2),,
10,0,0,0,0,0,0,0,0,0,0,0,0,0,0,0,0,51,51,0.0,M2019-01-27D,Race(2),,
11,3,0,0,3,0,0,0,0,0,1,0,1,3,1,0,4,21,21,0.0,M2019-01-27D,Race(2),,
12,0,0,0,0,0,0,0,0,0,0,1,1,0,0,1,1,51,51,0.0,M2019-01-27D,Race(2),,
13,0,0,2,2,0,0,0,0,0,0,0,0,0,0,2,2,51,51,0.0,M2019-01-27D,Race(2),,
14,0,0,0,0,0,0,0,0,0,0,0,0,0,0,0,0,34,34,3.0,M2019-01-27D,Race(2),,
1,26,2,2,30,22,1,0,23,24,1,0,25,72,4,2,78,1.36,1.35,1.0,M2019-01-27D,Race(3),,
2,0,0,2,2,0,4,6,10,0,6,4,10,0,10,12,22,15,15,3.0,M2019-01-27D,Race(3),,
3,4,3,2,9,0,1,7,8,0,0,7,7,4,4,16,24,8,8,0.0,M2019-01-27D,Race(3),,
4,0,4,5,9,0,8,2,10,1,1,5,7,1,13,12,26,15,15,0.0,M2019-01-27D,Race(3),,
5,0,8,5,13,0,3,10,13,1,6,4,11,1,17,19,37,9,9,0.0,M2019-01-27D,Race(3),,
6,0,10,11,21,8,13,5,26,0,12,6,18,8,35,22,65,9,9,2.0,M2019-01-27D,Race(3),,
7,0,0,0,0,0,0,0,0,0,0,0,0,0,0,0,0,51,51,0.0,M2019-01-27D,Race(3),,
8,0,3,3,6,0,0,0,0,0,0,0,0,0,3,3,6,17,17,0.0,M2019-01-27D,Race(3),,
1,2,2,0,4,0,8,1,9,0,0,0,0,2,10,1,13,18,18,2.0,M2019-01-27D,Race(4),,
2,9,3,2,14,10,5,4,19,10,5,5,20,29,13,11,53,4.6,4.6,1.0,M2019-01-27D,Race(4),,
3,0,0,0,0,0,0,0,0,0,0,0,0,0,0,0,0,31,31,0.0,M2019-01-27D,Race(4),,
4,4,6,6,16,0,4,4,8,0,3,9,12,4,13,19,36,5.5,5.5,0.0,M2019-01-27D,Race(4),,
5,2,2,0,4,0,0,1,1,1,4,1,6,3,6,2,11,14,14,3.0,M2019-01-27D,Race(4),,
6,0,5,6,11,3,2,3,8,7,2,4,13,10,9,13,32,9,9,0.0,M2019-01-27D,Race(4),,
7,3,2,4,9,8,1,1,10,0,0,0,0,11,3,5,19,21,21,0.0,M2019-01-27D,Race(4),,
8,0,0,0,0,0,0,0,0,1,0,0,1,1,0,0,1,61,61,0.0,M2019-01-27D,Race(4),,
9,2,5,10,17,8,3,3,14,8,7,2,17,18,15,15,48,5.5,5.5,0.0,M2019-01-27D,Race(4),,
10,5,3,0,8,0,5,4,9,0,4,1,5,5,12,5,22,6.5,6.5,0.0,M2019-01-27D,Race(4),,
11,3,2,0,5,1,2,1,4,0,1,3,4,4,5,4,13,14,14,0.0,M2019-01-27D,Race(4),,
12,0,0,2,2,0,0,0,0,0,0,0,0,0,0,2,2,34,34,0.0,M2019-01-27D,Race(4),,
13,0,0,0,0,0,0,8,8,0,0,1,1,0,0,9,9,9,9,0.0,M2019-01-27D,Race(4),,
14,0,0,0,0,0,0,0,0,0,0,0,0,0,0,0,0,61,61,0.0,M2019-01-27D,Race(4),,
1,4,6,0,10,0,7,1,8,3,10,2,15,7,23,3,33,5.5,5.5,0.0,M2019-01-27D,Race(5),,
2,3,5,7,15,0,1,2,3,1,0,1,2,4,6,10,20,9,9,3.0,M2019-01-27D,Race(5),,
3,10,7,8,25,10,2,5,17,12,3,3,18,32,12,16,60,4.6,4.6,1.0,M2019-01-27D,Race(5),,
4,2,2,0,4,0,0,3,3,0,1,5,6,2,3,8,13,13,13,0.0,M2019-01-27D,Race(5),,
5,0,0,0,0,0,0,0,0,0,1,0,1,0,1,0,1,41,41,0.0,M2019-01-27D,Race(5),,
6,0,0,0,0,0,0,0,0,0,0,0,0,0,0,0,0,81,81,0.0,M2019-01-27D,Race(5),,
7,0,0,0,0,0,0,0,0,0,0,0,0,0,0,0,0,101,101,0.0,M2019-01-27D,Race(5),,
8,0,0,0,0,0,1,8,9,0,2,0,2,0,3,8,11,21,21,0.0,M2019-01-27D,Race(5),,
9,0,0,0,0,0,0,0,0,0,0,0,0,0,0,0,0,16,16,0.0,M2019-01-27D,Race(5),,
10,6,3,2,11,13,7,5,25,4,4,5,13,23,14,12,49,4.4,4.4,0.0,M2019-01-27D,Race(5),,
11,0,7,13,20,7,4,5,16,4,3,8,15,11,14,26,51,4.4,4.4,2.0,M2019-01-27D,Race(5),,
12,5,0,0,5,0,8,1,9,2,2,2,6,7,10,3,20,10,10,0.0,M2019-01-27D,Race(5),,
1,0,0,0,0,0,0,0,0,0,0,0,0,0,0,0,0,26,26,0.0,M2019-01-27D,Race(6),,
2,2,0,3,5,0,0,8,8,2,0,2,4,4,0,13,17,21,21,0.0,M2019-01-27D,Race(6),,
3,0,4,3,7,0,2,1,3,1,2,1,4,1,8,5,14,12,12,0.0,M2019-01-27D,Race(6),,
4,20,5,3,28,20,3,0,23,19,5,1,25,59,13,4,76,1.8,1.8,0.0,M2019-01-27D,Race(6),,
5,0,4,5,9,0,8,0,8,0,0,2,2,0,12,7,19,16,16,3.0,M2019-01-27D,Race(6),,
6,0,0,0,0,0,0,0,0,0,0,0,0,0,0,0,0,51,51,0.0,M2019-01-27D,Race(6),,
7,0,15,7,22,2,10,9,21,3,8,7,18,5,33,23,61,6.5,6.5,1.0,M2019-01-27D,Race(6),,
8,0,0,4,4,0,2,4,6,1,1,5,7,1,3,13,17,17,17,0.0,M2019-01-27D,Race(6),,
9,0,2,0,2,0,0,0,0,0,0,0,0,0,2,0,2,26,26,0.0,M2019-01-27D,Race(6),,
10,0,0,0,0,0,0,0,0,0,0,0,0,0,0,0,0,81,81,0.0,M2019-01-27D,Race(6),,
11,0,0,2,2,0,0,2,2,0,0,3,3,0,0,7,7,21,21,0.0,M2019-01-27D,Race(6),,
12,8,0,3,11,8,5,6,19,0,5,5,10,16,10,14,40,5.5,5.5,2.0,M2019-01-27D,Race(6),,
1,3,0,17,20,0,0,6,6,0,3,5,8,3,3,28,34,7.5,7.5,0.0,M2019-01-27D,Race(7),,
2,7,18,2,27,1,17,1,19,6,12,5,23,14,47,8,69,3.3,3.3,1.0,M2019-01-27D,Race(7),,
3,17,5,6,28,19,2,1,22,17,7,2,26,53,14,9,76,2.3,2.3,0.0,M2019-01-27D,Race(7),,
4,0,7,5,12,1,9,11,21,1,3,6,10,2,19,22,43,5,5,0.0,M2019-01-27D,Race(7),,
5,0,0,0,0,0,0,0,0,0,0,0,0,0,0,0,0,31,31,0.0,M2019-01-27D,Race(7),,
6,0,0,0,0,0,0,0,0,0,0,0,0,0,0,0,0,41,41,3.0,M2019-01-27D,Race(7),,
7,3,0,0,3,1,2,9,12,0,0,3,3,4,2,12,18,10,10,0.0,M2019-01-27D,Race(7),,
8,0,0,0,0,0,0,0,0,0,0,0,0,0,0,0,0,51,51,0.0,M2019-01-27D,Race(7),,
9,0,0,0,0,8,0,2,10,2,1,0,3,10,1,2,13,21,21,2.0,M2019-01-27D,Race(7),,
1,18,2,5,25,16,4,1,21,19,2,1,22,53,8,7,68,3.5,3.5,0.0,M2019-01-27D,Race(8),,
2,0,0,8,8,0,1,1,2,0,0,0,0,0,1,9,10,15,15,0.0,M2019-01-27D,Race(8),,
3,4,10,0,14,8,4,2,14,1,4,4,9,13,18,6,37,9,9,1.0,M2019-01-27D,Race(8),,
4,0,0,0,0,0,1,0,1,0,2,1,3,0,3,1,4,15,15,0.0,M2019-01-27D,Race(8),,
5,5,8,3,16,1,5,2,8,1,5,7,13,7,18,12,37,5,5,0.0,M2019-01-27D,Race(8),,
6,0,8,7,15,1,4,10,15,0,5,6,11,1,17,23,41,5,5,0.0,M2019-01-27D,Race(8),,
7,3,0,7,10,4,2,6,12,5,6,5,16,12,8,18,38,7.5,7.5,3.0,M2019-01-27D,Race(8),,
8,0,0,0,0,0,0,0,0,0,0,0,0,0,0,0,0,71,67,0.0,M2019-01-27D,Race(8),,
9,0,0,0,0,0,0,0,0,0,0,0,0,0,0,0,0,21,21,0.0,M2019-01-27D,Race(8),,
10,0,0,0,0,0,1,8,9,0,1,1,2,0,2,9,11,21,21,0.0,M2019-01-27D,Race(8),,
11,0,2,0,2,0,0,0,0,0,1,0,1,0,3,0,3,17,17,0.0,M2019-01-27D,Race(8),,
12,0,0,0,0,0,0,0,0,0,0,0,0,0,0,0,0,101,101,0.0,M2019-01-27D,Race(8),,
13,0,0,0,0,0,0,0,0,0,0,0,0,0,0,0,0,34,35,2.0,M2019-01-27D,Race(8),,
14,0,0,0,0,0,8,0,8,0,0,1,1,0,8,1,9,34,35,0.0,M2019-01-27D,Race(8),,
1,0,2,0,2,0,8,1,9,2,0,1,3,2,10,2,14,10,10,0.0,M2019-01-27D,Race(9),,
2,0,0,0,0,0,0,0,0,0,1,0,1,0,1,0,1,101,101,0.0,M2019-01-27D,Race(9),,
3,0,0,0,0,0,0,0,0,0,0,0,0,0,0,0,0,151,151,0.0,M2019-01-27D,Race(9),,
4,0,0,0,0,0,3,0,3,2,2,1,5,2,5,1,8,16,16,0.0,M2019-01-27D,Race(9),,
5,0,0,2,2,0,0,0,0,0,0,0,0,0,0,2,2,51,51,0.0,M2019-01-27D,Race(9),,
6,0,5,0,5,0,9,2,11,1,1,2,4,1,15,4,20,21,21,0.0,M2019-01-27D,Race(9),,
7,0,0,0,0,0,0,8,8,1,0,1,2,1,0,9,10,41,41,0.0,M2019-01-27D,Race(9),,
8,2,2,0,4,8,2,1,11,1,3,0,4,11,7,1,19,21,21,0.0,M2019-01-27D,Race(9),,
9,11,6,5,22,5,2,3,10,3,2,5,10,19,10,13,42,7,7,3.0,M2019-01-27D,Race(9),,
10,5,2,6,13,3,0,1,4,3,1,1,5,11,3,8,22,10,10,0.0,M2019-01-27D,Race(9),,
11,0,3,4,7,0,2,2,4,0,1,2,3,0,6,8,14,15,15,0.0,M2019-01-27D,Race(9),,
12,5,6,5,16,2,2,4,8,4,4,6,14,11,12,15,38,7,7,1.0,M2019-01-27D,Race(9),,
13,4,2,5,11,2,5,5,12,1,8,5,14,7,15,15,37,5.5,5.5,0.0,M2019-01-27D,Race(9),,
14,3,2,3,8,10,4,3,17,8,3,2,13,21,9,8,38,2.9,2.9,2.0,M2019-01-27D,Race(9),,
1,3,5,4,12,2,9,7,18,4,5,8,17,9,19,19,47,6,6,1.0,M2019-01-30D,Race(1),,
2,0,0,0,0,0,0,0,0,0,0,0,0,0,0,0,0,71,67,0.0,M2019-01-30D,Race(1),,
3,0,0,0,0,0,0,1,1,0,0,1,1,0,0,2,2,18,26,0.0,M2019-01-30D,Race(1),,
4,0,4,2,6,0,1,0,1,1,1,0,2,1,6,2,9,12,12,0.0,M2019-01-30D,Race(1),,
5,2,0,0,2,0,2,0,2,1,4,1,6,3,6,1,10,26,26,0.0,M2019-01-30D,Race(1),,
6,2,3,5,10,2,3,1,6,2,3,2,7,6,9,8,23,4.8,4.8,3.0,M2019-01-30D,Race(1),,
7,10,6,3,19,14,9,7,30,12,6,3,21,36,21,13,70,3.8,3.8,0.0,M2019-01-30D,Race(1),,
8,0,2,6,8,1,1,7,9,1,1,4,6,2,4,17,23,11,15,0.0,M2019-01-30D,Race(1),,
9,13,7,7,27,10,5,7,22,3,6,4,13,26,18,18,62,3.7,3.7,0.0,M2019-01-30D,Race(1),,
10,0,3,0,3,1,0,0,1,1,0,2,3,2,3,2,7,12,12,2.0,M2019-01-30D,Race(1),,
11,0,0,3,3,0,0,0,0,0,0,0,0,0,0,3,3,41,41,0.0,M2019-01-30D,Race(1),,
12,0,0,0,0,0,0,0,0,1,0,1,2,1,0,1,2,26,26,0.0,M2019-01-30D,Race(1),,
1,20,6,4,30,25,5,0,30,22,2,0,24,67,13,4,84,2,2,0.0,M2019-01-30D,Race(2),,
2,0,5,0,5,0,3,8,11,0,6,3,9,0,14,11,25,14,14,0.0,M2019-01-30D,Race(2),,
3,0,0,0,0,0,0,0,0,0,0,0,0,0,0,0,0,51,51,0.0,M2019-01-30D,Race(2),,
4,0,2,6,8,0,1,1,2,0,3,3,6,0,6,10,16,9.5,9.5,0.0,M2019-01-30D,Race(2),,
5,0,0,0,0,0,0,0,0,0,0,0,0,0,0,0,0,41,41,0.0,M2019-01-30D,Race(2),,
6,6,6,6,18,5,18,9,32,3,10,7,20,14,34,22,70,5,5,1.0,M2019-01-30D,Race(2),,
7,0,2,7,9,0,0,2,2,0,3,5,8,0,5,14,19,11,11,0.0,M2019-01-30D,Race(2),,
8,2,3,0,5,0,1,5,6,0,1,4,5,2,5,9,16,14,14,3.0,M2019-01-30D,Race(2),,
9,0,0,0,0,0,0,0,0,0,0,0,0,0,0,0,0,41,41,2.0,M2019-01-30D,Race(2),,
10,0,0,0,0,0,1,2,3,0,0,1,1,0,1,3,4,23,23,0.0,M2019-01-30D,Race(2),,
11,2,6,7,15,0,2,0,2,0,1,3,4,2,9,10,21,7.5,7.5,0.0,M2019-01-30D,Race(2),,
12,0,0,0,0,0,0,0,0,1,0,0,1,1,0,0,1,71,71,0.0,M2019-01-30D,Race(2),,
1,2,16,2,20,13,8,9,30,11,3,6,20,26,27,17,70,3.7,3.7,2.0,M2019-01-30D,Race(3),,
2,12,0,10,22,12,12,7,31,9,7,3,19,33,19,20,72,5.5,5.5,3.0,M2019-01-30D,Race(3),,
3,0,0,0,0,0,0,1,1,0,0,1,1,0,0,2,2,21,21,0.0,M2019-01-30D,Race(3),,
4,11,5,2,18,1,5,4,10,3,7,4,14,15,17,10,42,5.5,5.5,1.0,M2019-01-30D,Race(3),,
5,0,2,0,2,0,0,2,2,1,2,2,5,1,4,4,9,15,20,0.0,M2019-01-30D,Race(3),,
6,0,2,0,2,0,0,1,1,0,2,2,4,0,4,3,7,14,14,0.0,M2019-01-30D,Race(3),,
7,0,3,5,8,0,1,0,1,0,1,1,2,0,5,6,11,11,11,0.0,M2019-01-30D,Race(3),,
8,0,2,0,2,3,3,1,7,1,2,0,3,4,7,1,12,9.5,10,0.0,M2019-01-30D,Race(3),,
9,2,0,8,10,0,0,5,5,0,2,5,7,2,2,18,22,7.5,7.5,0.0,M2019-01-30D,Race(3),,
10,0,0,0,0,0,0,0,0,0,0,0,0,0,0,0,0,81,81,0.0,M2019-01-30D,Race(3),,
11,0,0,0,0,0,1,0,1,0,0,1,1,0,1,1,2,34,35,0.0,M2019-01-30D,Race(3),,
12,3,0,3,6,1,0,0,1,1,0,1,2,5,0,4,9,9,10,0.0,M2019-01-30D,Race(3),,
1,10,10,6,26,18,7,9,34,18,3,3,24,46,20,18,84,3.2,3.3,0.0,M2019-01-30D,Race(4),,
2,0,2,2,4,0,0,0,0,0,0,0,0,0,2,2,4,71,67,0.0,M2019-01-30D,Race(4),,
3,0,8,10,18,8,10,6,24,3,6,4,13,11,24,20,55,6,6,0.0,M2019-01-30D,Race(4),,
4,8,2,5,15,0,0,0,0,0,0,0,0,8,2,5,15,3.9,3.9,1.0,M2019-01-30D,Race(4),,
5,0,0,0,0,0,0,0,0,0,0,1,1,0,0,1,1,23,23,2.0,M2019-01-30D,Race(4),,
6,0,0,0,0,0,1,2,3,0,0,0,0,0,1,2,3,31,31,0.0,M2019-01-30D,Race(4),,
7,2,0,0,2,0,0,0,0,0,0,0,0,2,0,0,2,17,17,0.0,M2019-01-30D,Race(4),,
8,4,0,3,7,1,3,4,8,2,2,7,11,7,5,14,26,10,11,0.0,M2019-01-30D,Race(4),,
9,0,3,2,5,2,1,2,5,2,2,2,6,4,6,6,16,9,9,0.0,M2019-01-30D,Race(4),,
10,0,0,0,0,0,0,0,0,0,1,0,1,0,1,0,1,34,34,0.0,M2019-01-30D,Race(4),,
11,6,5,2,13,0,3,2,5,0,8,3,11,6,16,7,29,7.5,7.5,3.0,M2019-01-30D,Race(4),,
12,0,0,0,0,0,1,0,1,0,0,1,1,0,1,1,2,34,34,0.0,M2019-01-30D,Race(4),,
1,15,2,7,24,10,8,10,28,10,5,4,19,35,15,21,71,3.4,3.4,1.0,M2019-01-30D,Race(5),,
2,0,9,2,11,1,6,4,11,1,3,4,8,2,18,10,30,7,7,0.0,M2019-01-30D,Race(5),,
3,7,5,2,14,0,0,0,0,0,0,0,0,7,5,2,14,4.8,4.8,0.0,M2019-01-30D,Race(5),,
4,3,3,8,14,13,10,7,30,9,7,4,20,25,20,19,64,5.5,5.5,2.0,M2019-01-30D,Race(5),,
5,0,0,0,0,0,0,0,0,0,0,0,0,0,0,0,0,34,35,0.0,M2019-01-30D,Race(5),,
6,2,11,3,16,3,2,5,10,3,8,7,18,8,21,15,44,7,7,0.0,M2019-01-30D,Race(5),,
7,0,0,0,0,0,0,2,2,0,1,1,2,0,1,3,4,13,13,0.0,M2019-01-30D,Race(5),,
8,0,0,0,0,0,0,0,0,0,0,0,0,0,0,0,0,71,67,3.0,M2019-01-30D,Race(5),,
9,0,0,0,0,0,1,0,1,0,0,0,0,0,1,0,1,31,31,0.0,M2019-01-30D,Race(5),,
10,0,0,2,2,0,0,1,1,1,0,2,3,1,0,5,6,21,21,0.0,M2019-01-30D,Race(5),,
11,0,0,0,0,0,0,0,0,0,0,0,0,0,0,0,0,61,61,0.0,M2019-01-30D,Race(5),,
12,3,0,6,9,1,1,0,2,2,2,4,8,6,3,10,19,11,11,0.0,M2019-01-30D,Race(5),,
1,6,10,2,18,2,10,7,19,4,8,6,18,12,28,15,55,7.5,7.5,0.0,M2019-01-30D,Race(6),,
2,0,0,3,3,0,0,1,1,0,0,2,2,0,0,6,6,19,19,0.0,M2019-01-30D,Race(6),,
3,8,13,9,30,18,9,7,34,16,9,0,25,42,31,16,89,2.3,2.3,1.0,M2019-01-30D,Race(6),,
4,2,5,5,12,0,2,2,4,0,2,1,3,2,9,8,19,10,10,0.0,M2019-01-30D,Race(6),,
5,0,0,0,0,0,0,0,0,1,1,2,4,1,1,2,4,17,17,2.0,M2019-01-30D,Race(6),,
6,0,0,0,0,0,0,0,0,0,0,0,0,0,0,0,0,41,41,0.0,M2019-01-30D,Race(6),,
7,7,0,6,13,1,2,3,6,3,5,6,14,11,7,15,33,0,0,0.0,M2019-01-30D,Race(6),,
8,0,0,0,0,0,0,1,1,1,0,2,3,1,0,3,4,15,15,3.0,M2019-01-30D,Race(6),,
9,7,2,5,14,9,7,9,25,1,1,7,9,17,10,21,48,5.5,5.5,0.0,M2019-01-30D,Race(6),,
10,0,0,0,0,0,0,0,0,0,0,0,0,0,0,0,0,21,21,0.0,M2019-01-30D,Race(6),,
1,2,0,3,5,3,0,1,4,0,1,4,5,5,1,8,14,8.5,8.5,1.0,M2019-01-30D,Race(7),,
2,0,3,4,7,0,4,6,10,3,4,5,12,3,11,15,29,13,13,0.0,M2019-01-30D,Race(7),,
3,0,0,0,0,0,1,0,1,1,1,0,2,1,2,0,3,21,21,0.0,M2019-01-30D,Race(7),,
4,0,0,0,0,2,1,0,3,1,0,1,2,3,1,1,5,9.5,9.5,3.0,M2019-01-30D,Race(7),,
5,0,0,0,0,0,0,0,0,0,0,1,1,0,0,1,1,26,26,0.0,M2019-01-30D,Race(7),,
6,15,6,5,26,6,8,6,20,7,3,5,15,28,17,16,61,3.8,3.8,0.0,M2019-01-30D,Race(7),,
7,0,0,0,0,0,0,0,0,0,0,0,0,0,0,0,0,61,61,0.0,M2019-01-30D,Race(7),,
8,0,0,2,2,1,1,1,3,1,1,0,2,2,2,3,7,13,13,0.0,M2019-01-30D,Race(7),,
9,6,14,5,25,6,4,5,15,4,5,4,13,16,23,14,53,5.5,5.5,0.0,M2019-01-30D,Race(7),,
10,7,5,6,18,11,8,9,28,8,7,2,17,26,20,17,63,4.6,4.6,0.0,M2019-01-30D,Race(7),,
11,0,2,5,7,1,0,2,3,1,4,3,8,2,6,10,18,11,11,0.0,M2019-01-30D,Race(7),,
12,0,0,0,0,0,3,0,3,0,0,1,1,0,3,1,4,15,15,2.0,M2019-01-30D,Race(7),,
1,4,8,5,17,0,1,2,3,1,5,4,10,5,14,11,30,8,8,0.0,M2019-01-30D,Race(8),,
2,0,0,0,0,0,0,0,0,0,0,0,0,0,0,0,0,61,61,0.0,M2019-01-30D,Race(8),,
3,24,2,2,28,21,4,7,32,23,0,1,24,68,6,10,84,1.85,1.85,1.0,M2019-01-30D,Race(8),,
4,0,0,3,3,0,5,6,11,0,5,6,11,0,10,15,25,10,10,0.0,M2019-01-30D,Race(8),,
5,2,0,0,2,2,3,0,5,0,1,1,2,4,4,1,9,15,15,0.0,M2019-01-30D,Race(8),,
6,0,0,0,0,0,0,0,0,0,0,1,1,0,0,1,1,41,41,0.0,M2019-01-30D,Race(8),,
7,0,20,10,30,6,15,10,31,2,13,7,22,8,48,27,83,5.5,5.5,3.0,M2019-01-30D,Race(8),,
8,0,0,3,3,1,2,2,5,0,0,3,3,1,2,8,11,9,9,2.0,M2019-01-30D,Race(8),,
9,0,0,0,0,0,0,2,2,0,0,0,0,0,0,2,2,19,19,0.0,M2019-01-30D,Race(8),,
10,0,0,0,0,0,0,0,0,0,0,0,0,0,0,0,0,0,0,0.0,M2019-01-30D,Race(8),,
11,0,0,0,0,0,0,0,0,0,0,0,0,0,0,0,0,81,81,0.0,M2019-01-30D,Race(8),,
12,0,0,7,7,0,0,1,1,0,2,3,5,0,2,11,13,15,15,0.0,M2019-01-30D,Race(8),,
1,0,0,0,0,0,0,0,0,0,0,1,1,0,0,1,1,31,26,0.0,M2019-02-02D,Race(1),,
2,0,0,0,0,0,0,0,0,0,0,1,1,0,0,1,1,31,31,0.0,M2019-02-02D,Race(1),,
3,9,7,5,21,14,10,5,29,11,3,2,16,34,20,12,66,4,4.2,3.0,M2019-02-02D,Race(1),,
4,0,0,0,0,0,0,0,0,0,1,0,1,0,1,0,1,9.5,9,0.0,M2019-02-02D,Race(1),,
5,2,5,5,12,3,4,5,12,6,6,6,18,11,15,16,42,5.5,5.5,1.0,M2019-02-02D,Race(1),,
6,0,0,0,0,0,0,0,0,0,1,0,1,0,1,0,1,26,26,0.0,M2019-02-02D,Race(1),,
7,3,2,2,7,3,3,4,10,3,6,3,12,9,11,9,29,6,6,0.0,M2019-02-02D,Race(1),,
8,0,10,8,18,1,1,3,5,0,1,3,4,1,12,14,27,11,11,2.0,M2019-02-02D,Race(1),,
9,5,6,4,15,8,10,11,29,4,4,9,17,17,20,24,61,4.4,4.4,0.0,M2019-02-02D,Race(1),,
10,11,0,6,17,1,2,2,5,2,4,1,7,14,6,9,29,5.5,5.5,0.0,M2019-02-02D,Race(1),,
1,3,5,3,11,2,5,5,12,4,3,3,10,9,13,11,33,13,16,3.0,M2019-02-02D,Race(10),,
2,0,3,0,3,0,1,0,1,0,0,0,0,0,4,0,4,41,41,0.0,M2019-02-02D,Race(10),,
3,3,2,2,7,1,2,6,9,1,3,7,11,5,7,15,27,11,11,0.0,M2019-02-02D,Race(10),,
4,0,0,2,2,0,2,1,3,2,2,1,5,2,4,4,10,15,15,0.0,M2019-02-02D,Race(10),,
5,0,0,0,0,0,0,0,0,0,1,0,1,0,1,0,1,23,31,0.0,M2019-02-02D,Race(10),,
6,0,0,8,8,2,0,5,7,2,1,7,10,4,1,20,25,10,10,1.0,M2019-02-02D,Race(10),,
7,11,8,9,28,11,12,7,30,3,15,3,21,25,35,19,79,4,3.8,0.0,M2019-02-02D,Race(10),,
8,0,0,0,0,0,0,2,2,1,0,4,5,1,0,6,7,7,6.5,0.0,M2019-02-02D,Race(10),,
9,0,0,2,2,0,1,0,1,0,0,0,0,0,1,2,3,26,26,0.0,M2019-02-02D,Race(10),,
10,0,2,0,2,0,0,0,0,0,0,0,0,0,2,0,2,71,67,0.0,M2019-02-02D,Race(10),,
11,13,10,4,27,14,7,4,25,13,1,1,15,40,18,9,67,2.2,2.3,2.0,M2019-02-02D,Race(10),,
12,0,0,0,0,0,0,0,0,0,0,0,0,0,0,0,0,61,61,0.0,M2019-02-02D,Race(10),,
13,0,0,0,0,0,0,0,0,0,0,0,0,0,0,0,0,101,101,0.0,M2019-02-02D,Race(10),,
1,6,0,2,8,1,1,1,3,0,1,1,2,7,2,4,13,11,11,3.0,M2019-02-02D,Race(2),,
2,0,2,2,4,0,0,0,0,0,0,0,0,0,2,2,4,26,26,0.0,M2019-02-02D,Race(2),,
3,12,8,10,30,15,9,10,34,10,6,6,22,37,23,26,86,2.25,2.25,0.0,M2019-02-02D,Race(2),,
4,6,5,3,14,1,3,4,8,1,2,4,7,8,10,11,29,8.5,8.5,2.0,M2019-02-02D,Race(2),,
5,0,0,0,0,0,1,0,1,2,0,2,4,2,1,2,5,18,18,0.0,M2019-02-02D,Race(2),,
6,0,0,0,0,0,0,0,0,0,0,1,1,0,0,1,1,34,34,0.0,M2019-02-02D,Race(2),,
7,0,2,0,2,0,0,0,0,0,1,1,2,0,3,1,4,31,31,0.0,M2019-02-02D,Race(2),,
8,0,0,0,0,0,0,0,0,0,1,0,1,0,1,0,1,101,101,0.0,M2019-02-02D,Race(2),,
9,6,2,8,16,10,8,6,24,7,6,2,15,23,16,16,55,10,10,0.0,M2019-02-02D,Race(2),,
10,0,5,3,8,2,0,0,2,2,1,1,4,4,6,4,14,9,9,0.0,M2019-02-02D,Race(2),,
11,0,3,0,3,1,5,5,11,2,3,3,8,3,11,8,22,14,14,0.0,M2019-02-02D,Race(2),,
12,0,0,2,2,0,2,2,4,2,2,2,6,2,4,6,12,12,12,1.0,M2019-02-02D,Race(2),,
13,0,3,0,3,0,1,2,3,0,3,3,6,0,7,5,12,9,9,0.0,M2019-02-02D,Race(2),,
1,0,0,0,0,0,2,1,3,0,2,1,3,0,4,2,6,14,14,0.0,M2019-02-02D,Race(3),,
2,13,2,9,24,17,9,6,32,18,2,6,26,48,13,21,82,3.4,3.4,0.0,M2019-02-02D,Race(3),,
3,2,4,12,18,7,6,10,23,5,5,3,13,14,15,25,54,4.6,4.6,0.0,M2019-02-02D,Race(3),,
4,0,0,0,0,0,0,0,0,0,0,0,0,0,0,0,0,61,61,0.0,M2019-02-02D,Race(3),,
5,0,3,0,3,0,1,0,1,0,1,1,2,0,5,1,6,18,18,0.0,M2019-02-02D,Race(3),,
6,9,11,2,22,3,3,8,14,1,8,10,19,13,22,20,55,4.2,4.2,0.0,M2019-02-02D,Race(3),,
7,6,5,7,18,2,8,5,15,2,7,4,13,10,20,16,46,6,6,0.0,M2019-02-02D,Race(3),,
8,0,0,0,0,0,0,0,0,0,0,0,0,0,0,0,0,101,101,0.0,M2019-02-02D,Race(3),,
9,0,0,0,0,0,0,0,0,0,0,0,0,0,0,0,0,126,126,0.0,M2019-02-02D,Race(3),,
10,0,0,0,0,0,0,0,0,0,0,0,0,0,0,0,0,21,21,0.0,M2019-02-02D,Race(3),,
11,0,0,0,0,0,0,0,0,0,0,0,0,0,0,0,0,126,126,0.0,M2019-02-02D,Race(3),,
12,0,0,0,0,1,0,0,1,0,1,0,1,1,1,0,2,21,21,3.0,M2019-02-02D,Race(3),,
13,0,0,0,0,0,1,0,1,0,0,0,0,0,1,0,1,15,15,2.0,M2019-02-02D,Race(3),,
14,0,5,0,5,0,0,0,0,0,0,1,1,0,5,1,6,18,18,1.0,M2019-02-02D,Race(3),,
1,0,2,2,4,10,4,6,20,6,1,3,10,16,7,11,34,4,5,0.0,M2019-02-02D,Race(4),,
2,8,6,6,20,2,4,8,14,6,5,4,15,16,15,18,49,0,0,0.0,M2019-02-02D,Race(4),,
3,0,0,0,0,0,0,0,0,0,0,0,0,0,0,0,0,81,81,0.0,M2019-02-02D,Race(4),,
4,12,7,6,25,13,12,8,33,12,5,5,22,37,24,19,80,3.6,4.6,0.0,M2019-02-02D,Race(4),,
5,0,3,0,3,0,0,0,0,0,2,0,2,0,5,0,5,31,46,0.0,M2019-02-02D,Race(4),,
6,0,0,6,6,1,3,1,5,0,3,3,6,1,6,10,17,12,13,0.0,M2019-02-02D,Race(4),,
7,0,0,0,0,0,0,1,1,0,0,2,2,0,0,3,3,34,31,0.0,M2019-02-02D,Race(4),,
8,0,0,0,0,0,0,1,1,0,0,2,2,0,0,3,3,23,19,0.0,M2019-02-02D,Race(4),,
9,6,8,3,17,3,5,1,9,1,8,1,10,10,21,5,36,4.2,4.4,0.0,M2019-02-02D,Race(4),,
10,2,2,3,7,0,0,3,3,1,0,3,4,3,2,9,14,14,15,2.0,M2019-02-02D,Race(4),,
11,0,0,0,0,0,1,0,1,0,1,1,2,0,2,1,3,13,16,3.0,M2019-02-02D,Race(4),,
12,2,2,4,8,1,1,1,3,0,1,2,3,3,4,7,14,5,7.5,1.0,M2019-02-02D,Race(4),,
1,18,8,4,30,17,9,5,31,19,5,0,24,54,22,9,85,1.95,1.95,0.0,M2019-02-02D,Race(5),,
2,0,0,0,0,0,0,0,0,0,0,0,0,0,0,0,0,151,151,0.0,M2019-02-02D,Race(5),,
3,0,0,0,0,0,0,0,0,0,0,0,0,0,0,0,0,51,51,0.0,M2019-02-02D,Race(5),,
4,0,0,0,0,0,0,0,0,0,0,0,0,0,0,0,0,91,91,0.0,M2019-02-02D,Race(5),,
5,0,0,0,0,0,0,0,0,0,0,0,0,0,0,0,0,81,81,0.0,M2019-02-02D,Race(5),,
6,2,5,5,12,1,5,3,9,2,4,2,8,5,14,10,29,9,9,3.0,M2019-02-02D,Race(5),,
7,0,0,0,0,0,0,0,0,0,0,0,0,0,0,0,0,101,101,0.0,M2019-02-02D,Race(5),,
8,0,0,0,0,0,0,0,0,0,0,1,1,0,0,1,1,81,81,0.0,M2019-02-02D,Race(5),,
9,3,10,10,23,9,12,11,32,2,10,9,21,14,32,30,76,5,5,0.0,M2019-02-02D,Race(5),,
10,7,5,8,20,3,3,5,11,3,6,10,19,13,14,23,50,4.4,4.5,2.0,M2019-02-02D,Race(5),,
11,0,2,3,5,0,1,4,5,0,1,3,4,0,4,10,14,11,11,1.0,M2019-02-02D,Race(5),,
12,0,0,0,0,0,0,0,0,0,0,0,0,0,0,0,0,81,81,0.0,M2019-02-02D,Race(5),,
13,0,0,0,0,0,0,2,2,0,0,1,1,0,0,3,3,13,13,0.0,M2019-02-02D,Race(5),,
14,0,0,0,0,0,0,0,0,0,0,0,0,0,0,0,0,101,101,0.0,M2019-02-02D,Race(5),,
1,9,6,5,20,1,7,5,13,8,6,3,17,18,19,13,50,8.5,8.5,0.0,M2019-02-02D,Race(6),,
2,6,2,6,14,4,1,1,6,2,2,3,7,12,5,10,27,7.5,7.5,0.0,M2019-02-02D,Race(6),,
3,6,10,4,20,11,9,8,28,3,7,8,18,20,26,20,66,4,4,1.0,M2019-02-02D,Race(6),,
4,2,2,8,12,4,1,6,11,4,3,4,11,10,6,18,34,7.5,7.5,2.0,M2019-02-02D,Race(6),,
5,0,0,0,0,0,0,0,0,0,0,0,0,0,0,0,0,21,21,0.0,M2019-02-02D,Race(6),,
6,0,2,4,6,9,10,7,26,6,4,3,13,15,16,14,45,7,7,0.0,M2019-02-02D,Race(6),,
7,2,0,0,2,0,0,0,0,1,2,1,4,3,2,1,6,8.5,8.5,0.0,M2019-02-02D,Race(6),,
8,2,2,3,7,0,1,0,1,1,1,0,2,3,4,3,10,8,8,0.0,M2019-02-02D,Race(6),,
9,0,6,0,6,1,1,2,4,1,1,1,3,2,8,3,13,9,9,0.0,M2019-02-02D,Race(6),,
10,0,0,0,0,0,0,0,0,0,0,0,0,0,0,0,0,26,26,0.0,M2019-02-02D,Race(6),,
11,3,0,0,3,0,0,1,1,0,0,3,3,3,0,4,7,15,15,3.0,M2019-02-02D,Race(6),,
12,0,0,0,0,0,0,0,0,0,0,0,0,0,0,0,0,41,41,0.0,M2019-02-02D,Race(6),,
1,0,0,0,0,0,0,0,0,0,0,0,0,0,0,0,0,51,51,3.0,M2019-02-02D,Race(7),,
2,0,0,0,0,0,0,0,0,0,0,0,0,0,0,0,0,101,101,0.0,M2019-02-02D,Race(7),,
3,26,4,0,30,23,5,3,31,25,0,1,26,74,9,4,87,1.34,1.35,1.0,M2019-02-02D,Race(7),,
4,0,2,0,2,1,1,0,2,0,1,0,1,1,4,0,5,21,21,0.0,M2019-02-02D,Race(7),,
5,0,11,2,13,0,3,8,11,0,8,8,16,0,22,18,40,18,18,0.0,M2019-02-02D,Race(7),,
6,0,2,0,2,0,1,1,2,0,4,5,9,0,7,6,13,19,19,0.0,M2019-02-02D,Race(7),,
7,0,0,3,3,0,2,3,5,0,0,3,3,0,2,9,11,26,26,0.0,M2019-02-02D,Race(7),,
8,2,8,12,22,5,15,7,27,1,8,4,13,8,31,23,62,7.5,7.5,0.0,M2019-02-02D,Race(7),,
9,0,3,13,16,1,3,6,10,0,4,2,6,1,10,21,32,6.5,6.5,0.0,M2019-02-02D,Race(7),,
10,2,0,0,2,0,0,2,2,0,1,3,4,2,1,5,8,51,51,0.0,M2019-02-02D,Race(7),,
11,0,0,0,0,0,0,0,0,0,0,0,0,0,0,0,0,81,81,0.0,M2019-02-02D,Race(7),,
12,0,0,0,0,0,0,0,0,0,0,0,0,0,0,0,0,41,41,2.0,M2019-02-02D,Race(7),,
1,0,0,10,10,2,5,4,11,1,7,3,11,3,12,17,32,15,15,0.0,M2019-02-02D,Race(8),,
2,0,0,2,2,0,0,0,0,0,0,2,2,0,0,4,4,9.5,9.5,2.0,M2019-02-02D,Race(8),,
3,0,0,0,0,0,0,0,0,0,0,0,0,0,0,0,0,31,31,0.0,M2019-02-02D,Race(8),,
4,22,4,2,28,12,7,10,29,13,5,3,21,47,16,15,78,2.7,2.7,0.0,M2019-02-02D,Race(8),,
5,6,14,5,25,12,15,4,31,9,9,0,18,27,38,9,74,5,5,0.0,M2019-02-02D,Race(8),,
6,0,2,3,5,0,1,2,3,0,1,4,5,0,4,9,13,12,12,0.0,M2019-02-02D,Race(8),,
7,0,0,0,0,0,0,0,0,0,0,0,0,0,0,0,0,21,21,0.0,M2019-02-02D,Race(8),,
8,0,0,0,0,0,0,0,0,0,1,0,1,0,1,0,1,51,51,0.0,M2019-02-02D,Race(8),,
9,0,0,0,0,0,0,0,0,0,0,0,0,0,0,0,0,51,51,0.0,M2019-02-02D,Race(8),,
10,0,2,6,8,1,1,2,4,0,0,4,4,1,3,12,16,8,8,0.0,M2019-02-02D,Race(8),,
11,0,0,0,0,0,0,0,0,0,0,0,0,0,0,0,0,34,35,0.0,M2019-02-02D,Race(8),,
12,0,6,2,8,1,0,4,5,0,1,3,4,1,7,9,17,12,12,1.0,M2019-02-02D,Race(8),,
13,0,0,0,0,0,0,2,2,0,1,0,1,0,1,2,3,18,18,3.0,M2019-02-02D,Race(8),,
14,2,2,0,4,0,1,1,2,0,0,3,3,2,3,4,9,15,15,0.0,M2019-02-02D,Race(8),,
1,0,0,0,0,0,0,0,0,1,0,0,1,1,0,0,1,21,21,0.0,M2019-02-02D,Race(9),,
2,2,6,2,10,7,12,6,25,1,7,1,9,10,25,9,44,10,10,2.0,M2019-02-02D,Race(9),,
3,8,2,10,20,3,4,3,10,3,3,5,11,14,9,18,41,5,5,0.0,M2019-02-02D,Race(9),,
4,0,3,4,7,1,2,1,4,1,2,1,4,2,7,6,15,11,11,0.0,M2019-02-02D,Race(9),,
5,2,2,0,4,0,0,1,1,1,0,0,1,3,2,1,6,31,31,0.0,M2019-02-02D,Race(9),,
6,0,0,0,0,0,0,0,0,0,0,1,1,0,0,1,1,9,9,3.0,M2019-02-02D,Race(9),,
7,0,0,0,0,0,0,0,0,0,0,0,0,0,0,0,0,71,67,0.0,M2019-02-02D,Race(9),,
8,0,0,0,0,0,0,0,0,0,0,0,0,0,0,0,0,31,31,0.0,M2019-02-02D,Race(9),,
9,10,10,3,23,11,6,8,25,10,6,3,19,31,22,14,67,4.8,4.8,1.0,M2019-02-02D,Race(9),,
10,0,0,0,0,0,0,1,1,0,0,0,0,0,0,1,1,31,31,0.0,M2019-02-02D,Race(9),,
11,3,5,6,14,6,1,9,16,4,3,13,20,13,9,28,50,4,4,0.0,M2019-02-02D,Race(9),,
12,0,0,0,0,0,0,0,0,0,0,0,0,0,0,0,0,51,51,0.0,M2019-02-02D,Race(9),,
13,5,2,5,12,2,5,1,8,5,5,2,12,12,12,8,32,6,6,0.0,M2019-02-02D,Race(9),,
1,3,4,5,12,7,8,3,18,3,4,4,11,13,16,12,41,6,6,0.0,M2019-02-07D,Race(1),,
2,6,7,12,25,6,6,3,15,5,11,4,20,17,24,19,60,3.8,3.8,1.0,M2019-02-07D,Race(1),,
3,0,0,3,3,0,0,8,8,0,1,2,3,0,1,13,14,21,21,0.0,M2019-02-07D,Race(1),,
4,0,0,0,0,2,0,4,6,6,0,6,12,8,0,10,18,6,6,0.0,M2019-02-07D,Race(1),,
5,12,5,0,17,2,10,2,14,5,3,0,8,19,18,2,39,4.6,4.6,0.0,M2019-02-07D,Race(1),,
6,0,3,2,5,9,0,1,10,1,1,3,5,10,4,6,20,12,12,3.0,M2019-02-07D,Race(1),,
7,0,0,0,0,0,0,0,0,0,0,0,0,0,0,0,0,31,31,0.0,M2019-02-07D,Race(1),,
8,5,0,0,5,0,0,0,0,0,0,0,0,5,0,0,5,17,17,2.0,M2019-02-07D,Race(1),,
9,4,11,8,23,4,6,9,19,6,6,7,19,14,23,24,61,3.8,3.8,0.0,M2019-02-07D,Race(1),,
1,0,0,0,0,0,0,0,0,1,1,0,2,1,1,0,2,51,41,0.0,M2019-02-07D,Race(10),,
2,0,2,3,5,3,0,5,8,3,2,4,9,6,4,12,22,8,8,0.0,M2019-02-07D,Race(10),,
3,7,12,0,19,4,5,4,13,5,5,3,13,16,22,7,45,5,5,2.0,M2019-02-07D,Race(10),,
4,0,0,0,0,0,0,0,0,0,0,0,0,0,0,0,0,101,101,0.0,M2019-02-07D,Race(10),,
5,0,0,3,3,1,0,8,9,0,0,1,1,1,0,12,13,17,17,0.0,M2019-02-07D,Race(10),,
6,3,9,8,20,0,6,5,11,1,5,5,11,4,20,18,42,7,7,0.0,M2019-02-07D,Race(10),,
7,0,2,5,7,0,8,0,8,0,0,0,0,0,10,5,15,8,9,0.0,M2019-02-07D,Race(10),,
8,0,0,0,0,8,0,0,8,1,0,0,1,9,0,0,9,21,21,3.0,M2019-02-07D,Race(10),,
9,0,0,0,0,0,0,0,0,0,0,0,0,0,0,0,0,101,101,0.0,M2019-02-07D,Race(10),,
10,0,0,0,0,0,0,0,0,0,0,0,0,0,0,0,0,31,31,0.0,M2019-02-07D,Race(10),,
11,0,0,3,3,0,0,0,0,1,0,0,1,1,0,3,4,51,51,0.0,M2019-02-07D,Race(10),,
12,0,2,3,5,3,5,4,12,4,5,9,18,7,12,16,35,11,11,0.0,M2019-02-07D,Race(10),,
13,0,3,0,3,0,0,0,0,0,0,1,1,0,3,1,4,19,19,0.0,M2019-02-07D,Race(10),,
14,20,0,5,25,11,6,4,21,10,8,3,21,41,14,12,67,2.7,2.7,1.0,M2019-02-07D,Race(10),,
1,8,11,2,21,6,8,5,19,10,8,2,20,24,27,9,60,4.2,4.2,0.0,M2019-02-07D,Race(11),,
2,0,0,2,2,8,1,2,11,1,0,2,3,9,1,6,16,19,19,0.0,M2019-02-07D,Race(11),,
3,10,6,7,23,11,9,3,23,9,11,2,22,30,26,12,68,4,4,0.0,M2019-02-07D,Race(11),,
4,0,2,3,5,2,0,1,3,0,1,2,3,2,3,6,11,13,13,0.0,M2019-02-07D,Race(11),,
5,0,0,5,5,1,4,7,12,1,1,9,11,2,5,21,28,6,6,3.0,M2019-02-07D,Race(11),,
6,0,0,0,0,0,0,0,0,1,0,0,1,1,0,0,1,81,81,2.0,M2019-02-07D,Race(11),,
7,0,0,0,0,0,0,0,0,0,0,0,0,0,0,0,0,81,81,0.0,M2019-02-07D,Race(11),,
8,0,0,0,0,0,0,0,0,0,0,1,1,0,0,1,1,41,41,0.0,M2019-02-07D,Race(11),,
9,0,0,0,0,0,0,0,0,0,0,0,0,0,0,0,0,21,21,0.0,M2019-02-07D,Race(11),,
10,0,0,0,0,0,0,0,0,0,0,0,0,0,0,0,0,31,31,0.0,M2019-02-07D,Race(11),,
11,0,0,0,0,0,0,8,8,0,0,1,1,0,0,9,9,41,41,0.0,M2019-02-07D,Race(11),,
12,4,5,5,14,0,8,3,11,0,1,3,4,4,14,11,29,7.5,7.5,1.0,M2019-02-07D,Race(11),,
13,0,0,0,0,0,0,0,0,0,0,0,0,0,0,0,0,21,21,0.0,M2019-02-07D,Race(11),,
14,8,6,6,20,2,0,1,3,4,4,4,12,14,10,11,35,5.5,5.5,0.0,M2019-02-07D,Race(11),,
1,5,9,11,25,17,3,9,29,15,4,3,22,37,16,23,76,2.6,2.6,2.0,M2019-02-07D,Race(2),,
2,9,6,8,23,2,10,6,18,2,6,9,17,13,22,23,58,4,4,1.0,M2019-02-07D,Race(2),,
3,7,8,2,17,3,9,6,18,5,6,5,16,15,23,13,51,5,5,0.0,M2019-02-07D,Race(2),,
4,2,0,0,2,0,0,0,0,0,1,1,2,2,1,1,4,21,21,0.0,M2019-02-07D,Race(2),,
5,3,7,9,19,8,4,5,17,2,6,4,12,13,17,18,48,6,6,3.0,M2019-02-07D,Race(2),,
6,0,0,0,0,0,0,0,0,0,1,0,1,0,1,0,1,41,41,0.0,M2019-02-07D,Race(2),,
7,0,0,0,0,0,0,0,0,0,0,0,0,0,0,0,0,31,31,0.0,M2019-02-07D,Race(2),,
8,2,0,0,2,0,0,0,0,0,0,0,0,2,0,0,2,31,31,0.0,M2019-02-07D,Race(2),,
9,0,0,0,0,0,0,0,0,0,0,0,0,0,0,0,0,21,21,0.0,M2019-02-07D,Race(2),,
10,2,0,0,2,0,4,4,8,1,2,4,7,3,6,8,17,10,10,0.0,M2019-02-07D,Race(2),,
11,0,0,0,0,0,0,0,0,1,0,0,1,1,0,0,1,71,67,0.0,M2019-02-07D,Race(2),,
1,0,0,0,0,3,0,8,11,3,2,1,6,6,2,9,17,7,7,0.0,M2019-02-07D,Race(3),,
2,15,0,8,23,6,5,5,16,7,4,8,19,28,9,21,58,4,4,3.0,M2019-02-07D,Race(3),,
3,3,0,2,5,0,0,0,0,1,0,1,2,4,0,3,7,15,15,1.0,M2019-02-07D,Race(3),,
4,2,13,3,18,3,5,6,14,1,6,5,12,6,24,14,44,6.5,6.5,0.0,M2019-02-07D,Race(3),,
5,0,0,0,0,0,0,0,0,0,0,0,0,0,0,0,0,71,67,0.0,M2019-02-07D,Race(3),,
6,2,0,0,2,8,4,2,14,2,1,2,5,12,5,4,21,10,10,2.0,M2019-02-07D,Race(3),,
7,0,2,2,4,0,8,0,8,2,2,0,4,2,12,2,16,18,17,0.0,M2019-02-07D,Race(3),,
8,2,10,8,20,5,2,5,12,8,2,6,16,15,14,19,48,4.6,4.6,0.0,M2019-02-07D,Race(3),,
9,0,3,2,5,0,0,0,0,0,2,2,4,0,5,4,9,10,10,0.0,M2019-02-07D,Race(3),,
10,6,2,5,13,5,6,4,15,2,6,1,9,13,14,10,37,6.5,6.5,0.0,M2019-02-07D,Race(3),,
11,0,0,0,0,0,0,0,0,0,0,0,0,0,0,0,0,71,71,0.0,M2019-02-07D,Race(3),,
12,0,0,0,0,0,0,0,0,0,1,0,1,0,1,0,1,41,41,0.0,M2019-02-07D,Race(3),,
1,2,8,10,20,8,6,4,18,2,9,5,16,12,23,19,54,5.5,5.5,0.0,M2019-02-07D,Race(4),,
2,12,9,7,28,10,10,2,22,17,6,1,24,39,25,10,74,2.8,2.8,0.0,M2019-02-07D,Race(4),,
3,0,0,0,0,0,0,0,0,0,1,0,1,0,1,0,1,34,34,0.0,M2019-02-07D,Race(4),,
4,9,9,8,26,7,4,7,18,6,5,10,21,22,18,25,65,4,4,2.0,M2019-02-07D,Race(4),,
5,2,2,0,4,0,0,1,1,0,0,3,3,2,2,4,8,17,17,0.0,M2019-02-07D,Race(4),,
6,3,0,3,6,5,1,5,11,1,2,1,4,9,3,9,21,8.5,8.5,3.0,M2019-02-07D,Race(4),,
7,0,0,2,2,0,8,1,9,0,1,1,2,0,9,4,13,17,17,0.0,M2019-02-07D,Race(4),,
8,0,0,0,0,0,0,0,0,0,0,0,0,0,0,0,0,51,51,0.0,M2019-02-07D,Race(4),,
9,0,0,0,0,0,0,8,8,0,0,0,0,0,0,8,8,34,34,0.0,M2019-02-07D,Race(4),,
10,2,0,0,2,0,0,0,0,0,1,0,1,2,1,0,3,17,17,0.0,M2019-02-07D,Race(4),,
11,0,2,0,2,0,1,2,3,0,1,5,6,0,4,7,11,9,9,1.0,M2019-02-07D,Race(4),,
12,0,0,0,0,0,0,0,0,0,0,0,0,0,0,0,0,41,41,0.0,M2019-02-07D,Race(4),,
1,9,0,8,17,0,5,1,6,1,7,1,9,10,12,10,32,6.5,6.5,0.0,M2019-02-07D,Race(5),,
2,13,15,0,28,18,3,2,23,19,2,3,24,50,20,5,75,2,2,1.0,M2019-02-07D,Race(5),,
3,0,11,10,21,8,6,5,19,3,4,6,13,11,21,21,53,8.5,8.5,0.0,M2019-02-07D,Race(5),,
4,0,0,0,0,0,0,0,0,0,1,1,2,0,1,1,2,151,151,0.0,M2019-02-07D,Race(5),,
5,0,0,0,0,2,1,2,5,0,1,0,1,2,2,2,6,21,21,0.0,M2019-02-07D,Race(5),,
6,0,0,2,2,0,0,4,4,0,3,6,9,0,3,12,15,10,10,0.0,M2019-02-07D,Race(5),,
7,0,0,0,0,0,8,0,8,0,0,0,0,0,8,0,8,31,31,0.0,M2019-02-07D,Race(5),,
8,0,0,0,0,0,3,3,6,0,5,3,8,0,8,6,14,21,21,0.0,M2019-02-07D,Race(5),,
9,0,0,0,0,0,0,0,0,0,0,0,0,0,0,0,0,51,51,2.0,M2019-02-07D,Race(5),,
10,0,2,0,2,0,0,1,1,0,0,0,0,0,2,1,3,13,13,0.0,M2019-02-07D,Race(5),,
11,8,2,10,20,2,4,4,10,3,3,6,12,13,9,20,42,7,7,3.0,M2019-02-07D,Race(5),,
12,0,0,0,0,0,0,8,8,0,0,0,0,0,0,8,8,16,16,0.0,M2019-02-07D,Race(5),,
1,7,13,7,27,6,5,6,17,3,6,3,12,16,24,16,56,4.2,4.2,0.0,M2019-02-07D,Race(6),,
2,20,3,2,25,11,7,4,22,15,3,6,24,46,13,12,71,5,5,0.0,M2019-02-07D,Race(6),,
3,0,7,6,13,3,4,3,10,5,6,3,14,8,17,12,37,5.5,5.5,1.0,M2019-02-07D,Race(6),,
4,0,0,3,3,0,0,0,0,1,2,5,8,1,2,8,11,8.5,8.5,2.0,M2019-02-07D,Race(6),,
5,0,0,2,2,8,1,3,12,0,3,1,4,8,4,6,18,14,14,0.0,M2019-02-07D,Race(6),,
6,0,0,0,0,0,0,0,0,0,0,0,0,0,0,0,0,81,81,0.0,M2019-02-07D,Race(6),,
7,3,0,5,8,1,4,4,9,0,4,2,6,4,8,11,23,6.5,6.5,0.0,M2019-02-07D,Race(6),,
8,0,2,0,2,1,1,8,10,1,2,2,5,2,5,10,17,10,10,3.0,M2019-02-07D,Race(6),,
9,0,0,0,0,0,0,0,0,0,0,0,0,0,0,0,0,31,31,0.0,M2019-02-07D,Race(6),,
10,0,0,0,0,0,0,0,0,0,0,0,0,0,0,0,0,101,101,0.0,M2019-02-07D,Race(6),,
11,0,0,0,0,0,0,0,0,0,0,0,0,0,0,0,0,31,31,0.0,M2019-02-07D,Race(6),,
12,0,0,0,0,0,0,0,0,0,0,0,0,0,0,0,0,31,31,0.0,M2019-02-07D,Race(6),,
13,0,0,0,0,0,0,0,0,0,0,0,0,0,0,0,0,81,81,0.0,M2019-02-07D,Race(6),,
14,0,5,5,10,0,8,3,11,1,0,4,5,1,13,12,26,9.5,9.5,0.0,M2019-02-07D,Race(6),,
1,2,3,2,7,11,7,5,23,3,6,7,16,16,16,14,46,6.5,6.5,0.0,M2019-02-07D,Race(7),,
2,0,0,0,0,0,0,0,0,0,0,0,0,0,0,0,0,126,126,0.0,M2019-02-07D,Race(7),,
3,0,0,0,0,0,0,0,0,0,0,0,0,0,0,0,0,41,41,0.0,M2019-02-07D,Race(7),,
4,0,0,0,0,0,0,0,0,0,0,0,0,0,0,0,0,81,81,0.0,M2019-02-07D,Race(7),,
5,2,12,3,17,0,7,5,12,0,4,6,10,2,23,14,39,8,8,3.0,M2019-02-07D,Race(7),,
6,0,2,0,2,0,0,0,0,1,0,0,1,1,2,0,3,71,67,0.0,M2019-02-07D,Race(7),,
7,20,5,5,30,19,2,2,23,21,2,1,24,60,9,8,77,1.9,1.9,1.0,M2019-02-07D,Race(7),,
8,3,3,7,13,0,5,4,9,0,6,5,11,3,14,16,33,7,7,0.0,M2019-02-07D,Race(7),,
9,0,0,0,0,0,0,0,0,0,0,0,0,0,0,0,0,51,51,0.0,M2019-02-07D,Race(7),,
10,0,3,5,8,0,1,10,11,1,1,3,5,1,5,18,24,7.5,7.5,2.0,M2019-02-07D,Race(7),,
11,0,0,0,0,0,0,0,0,0,0,0,0,0,0,0,0,101,101,0.0,M2019-02-07D,Race(7),,
12,3,2,8,13,0,8,4,12,0,5,4,9,3,15,16,34,7.5,7.5,0.0,M2019-02-07D,Race(7),,
1,0,0,10,10,0,4,12,16,0,4,10,14,0,8,32,40,8,8,0.0,M2019-02-07D,Race(8),,
2,0,2,3,5,0,0,10,10,2,0,2,4,2,2,15,19,12,12,0.0,M2019-02-07D,Race(8),,
3,7,21,0,28,16,11,2,29,6,15,3,24,29,47,5,81,2.9,2.9,1.0,M2019-02-07D,Race(8),,
4,21,4,5,30,14,7,1,22,17,5,1,23,52,16,7,75,2.7,2.7,0.0,M2019-02-07D,Race(8),,
5,0,0,10,10,0,8,1,9,0,0,3,3,0,8,14,22,13,13,0.0,M2019-02-07D,Race(8),,
6,2,3,2,7,0,0,4,4,1,2,7,10,3,5,13,21,4.2,4.2,2.0,M2019-02-07D,Race(8),,
1,0,0,8,8,0,1,0,1,0,0,0,0,0,1,8,9,18,18,0.0,M2019-02-07D,Race(9),,
2,16,7,4,27,0,8,6,14,0,4,4,8,16,19,14,49,4.8,4.8,3.0,M2019-02-07D,Race(9),,
3,5,0,0,5,0,0,0,0,0,0,0,0,5,0,0,5,6,6,0.0,M2019-02-07D,Race(9),,
4,4,6,2,12,0,9,4,13,0,7,4,11,4,22,10,36,4.8,4.8,0.0,M2019-02-07D,Race(9),,
5,0,6,7,13,0,6,6,12,0,3,6,9,0,15,19,34,7,7,1.0,M2019-02-07D,Race(9),,
6,0,0,0,0,0,0,0,0,0,1,0,1,0,1,0,1,34,34,0.0,M2019-02-07D,Race(9),,
7,5,6,9,20,0,4,5,9,1,6,8,15,6,16,22,44,3.7,3.7,2.0,M2019-02-07D,Race(9),,
8,0,0,0,0,0,0,0,0,0,2,0,2,0,2,0,2,16,16,0.0,M2019-02-07D,Race(9),,
9,0,5,0,5,0,2,9,11,1,2,2,5,1,9,11,21,11,11,0.0,M2019-02-07D,Race(9),,
10,0,0,0,0,0,0,0,0,0,0,2,2,0,0,2,2,51,51,0.0,M2019-02-07D,Race(9),,
11,0,0,0,0,0,0,0,0,0,0,0,0,0,0,0,0,51,51,0.0,M2019-02-07D,Race(9),,
12,0,0,0,0,0,0,0,0,0,0,0,0,0,0,0,0,71,67,0.0,M2019-02-07D,Race(9),,
1,0,0,0,0,0,0,0,0,0,0,0,0,0,0,0,0,51,41,0.0,M2019-02-10D,Race(1),,
2,5,3,5,13,4,6,2,12,2,7,2,11,11,16,9,36,8.5,8.5,0.0,M2019-02-10D,Race(1),,
3,0,3,2,5,0,3,3,6,1,2,3,6,1,8,8,17,10,10,0.0,M2019-02-10D,Race(1),,
4,0,0,3,3,0,1,8,9,0,1,2,3,0,2,13,15,9.5,9.5,0.0,M2019-02-10D,Race(1),,
5,19,6,2,27,15,4,2,21,18,2,0,20,52,12,4,68,2.45,2.5,0.0,M2019-02-10D,Race(1),,
6,0,0,0,0,0,0,0,0,0,1,0,1,0,1,0,1,41,41,0.0,M2019-02-10D,Race(1),,
7,0,4,0,4,0,8,2,10,1,4,2,7,1,16,4,21,12,11,0.0,M2019-02-10D,Race(1),,
8,0,6,5,11,0,2,0,2,0,4,3,7,0,12,8,20,7.5,7.5,2.0,M2019-02-10D,Race(1),,
9,0,0,0,0,0,0,0,0,0,0,0,0,0,0,0,0,31,31,0.0,M2019-02-10D,Race(1),,
10,0,5,10,15,9,3,3,15,2,2,2,6,11,10,15,36,11,11,1.0,M2019-02-10D,Race(1),,
11,4,3,3,10,2,3,6,11,2,0,5,7,8,6,14,28,15,14,3.0,M2019-02-10D,Race(1),,
12,2,0,0,2,0,0,0,0,0,0,0,0,2,0,0,2,19,19,0.0,M2019-02-10D,Race(1),,
13,0,0,0,0,0,0,4,4,0,3,7,10,0,3,11,14,18,19,0.0,M2019-02-10D,Race(1),,
1,5,2,2,9,3,5,3,11,1,2,2,5,9,9,7,25,7.5,7.5,0.0,M2019-02-10D,Race(10),,
2,0,0,0,0,0,0,1,1,0,1,0,1,0,1,1,2,41,41,0.0,M2019-02-10D,Race(10),,
3,0,0,3,3,0,8,3,11,1,3,2,6,1,11,8,20,19,19,0.0,M2019-02-10D,Race(10),,
4,0,3,0,3,0,0,8,8,0,1,3,4,0,4,11,15,21,21,0.0,M2019-02-10D,Race(10),,
5,0,0,0,0,0,0,0,0,1,1,0,2,1,1,0,2,51,51,0.0,M2019-02-10D,Race(10),,
6,0,0,0,0,0,0,0,0,0,0,0,0,0,0,0,0,31,31,0.0,M2019-02-10D,Race(10),,
7,0,0,2,2,0,1,2,3,0,0,1,1,0,1,5,6,5.5,5.5,0.0,M2019-02-10D,Race(10),,
8,20,5,5,30,18,2,3,23,22,3,1,26,60,10,9,79,2.7,2.7,1.0,M2019-02-10D,Race(10),,
9,2,2,0,4,0,2,0,2,0,2,0,2,2,6,0,8,8.5,8.5,0.0,M2019-02-10D,Race(10),,
10,0,0,3,3,0,0,0,0,0,0,0,0,0,0,3,3,21,21,0.0,M2019-02-10D,Race(10),,
11,0,0,0,0,0,0,0,0,0,0,0,0,0,0,0,0,71,67,0.0,M2019-02-10D,Race(10),,
12,0,0,5,5,8,2,1,11,0,3,2,5,8,5,8,21,12,12,0.0,M2019-02-10D,Race(10),,
13,0,6,7,13,1,6,5,12,1,5,8,14,2,17,20,39,11,11,2.0,M2019-02-10D,Race(10),,
14,3,12,3,18,0,4,4,8,0,5,7,12,3,21,14,38,12,12,3.0,M2019-02-10D,Race(10),,
1,0,0,2,2,0,0,0,0,0,1,0,1,0,1,2,3,41,41,0.0,M2019-02-10D,Race(2),,
2,2,2,0,4,0,0,0,0,0,0,0,0,2,2,0,4,31,31,0.0,M2019-02-10D,Race(2),,
3,2,11,2,15,1,10,4,15,1,6,6,13,4,27,12,43,7,7,0.0,M2019-02-10D,Race(2),,
4,17,6,5,28,21,1,1,23,23,2,1,26,61,9,7,77,3,3,0.0,M2019-02-10D,Race(2),,
5,0,0,0,0,0,0,0,0,0,0,0,0,0,0,0,0,26,26,0.0,M2019-02-10D,Race(2),,
6,0,3,2,5,0,1,0,1,0,2,1,3,0,6,3,9,17,17,3.0,M2019-02-10D,Race(2),,
7,0,0,0,0,8,1,5,14,0,4,4,8,8,5,9,22,23,21,0.0,M2019-02-10D,Race(2),,
8,0,0,0,0,0,0,0,0,0,0,0,0,0,0,0,0,71,51,0.0,M2019-02-10D,Race(2),,
9,9,3,5,17,0,5,4,9,0,5,5,10,9,13,14,36,4.2,4.2,2.0,M2019-02-10D,Race(2),,
10,0,5,11,16,0,4,8,12,2,6,8,16,2,15,27,44,6.5,7,1.0,M2019-02-10D,Race(2),,
11,0,0,0,0,0,8,0,8,0,0,0,0,0,8,0,8,51,41,0.0,M2019-02-10D,Race(2),,
12,0,0,3,3,0,0,0,0,0,0,0,0,0,0,3,3,34,34,0.0,M2019-02-10D,Race(2),,
13,0,0,0,0,0,0,8,8,0,0,1,1,0,0,9,9,7.5,7.5,0.0,M2019-02-10D,Race(2),,
14,0,0,0,0,0,0,0,0,0,0,0,0,0,0,0,0,34,31,0.0,M2019-02-10D,Race(2),,
1,0,2,0,2,0,0,5,5,0,1,4,5,0,3,9,12,10,10,0.0,M2019-02-10D,Race(3),,
2,0,5,7,12,8,3,1,12,3,5,0,8,11,13,8,32,10,10,3.0,M2019-02-10D,Race(3),,
3,0,0,0,0,0,0,0,0,1,0,0,1,1,0,0,1,23,21,0.0,M2019-02-10D,Race(3),,
4,3,0,0,3,0,8,0,8,0,1,2,3,3,9,2,14,8.5,8,0.0,M2019-02-10D,Race(3),,
5,3,4,3,10,3,3,2,8,0,5,4,9,6,12,9,27,8,7.5,2.0,M2019-02-10D,Race(3),,
6,15,3,10,28,17,3,3,23,17,4,3,24,49,10,16,75,3,3,1.0,M2019-02-10D,Race(3),,
7,0,8,5,13,0,4,5,9,1,0,1,2,1,12,11,24,12,12,0.0,M2019-02-10D,Race(3),,
8,9,8,3,20,2,8,6,16,4,9,6,19,15,25,15,55,3.2,3.4,0.0,M2019-02-10D,Race(3),,
9,0,0,2,2,0,1,8,9,0,1,6,7,0,2,16,18,12,12,0.0,M2019-02-10D,Race(3),,
1,0,2,0,2,0,0,0,0,0,0,0,0,0,2,0,2,34,35,0.0,M2019-02-10D,Race(4),,
2,0,3,12,15,4,3,4,11,3,3,5,11,7,9,21,37,9,9,0.0,M2019-02-10D,Race(4),,
3,8,5,4,17,2,6,1,9,4,2,1,7,14,13,6,33,5,5,0.0,M2019-02-10D,Race(4),,
4,0,0,3,3,0,1,2,3,0,1,3,4,0,2,8,10,13,13,0.0,M2019-02-10D,Race(4),,
5,0,0,0,0,0,0,0,0,0,0,0,0,0,0,0,0,51,51,0.0,M2019-02-10D,Race(4),,
6,11,6,0,17,6,3,5,14,7,5,7,19,24,14,12,50,4.4,4.4,1.0,M2019-02-10D,Race(4),,
7,6,4,9,19,4,2,4,10,7,3,4,14,17,9,17,43,4.4,4.4,2.0,M2019-02-10D,Race(4),,
8,0,0,0,0,0,0,8,8,0,0,0,0,0,0,8,8,21,21,0.0,M2019-02-10D,Race(4),,
9,5,8,0,13,3,2,1,6,2,4,2,8,10,14,3,27,8.5,8.5,0.0,M2019-02-10D,Race(4),,
10,0,2,2,4,0,8,1,9,0,3,1,4,0,13,4,17,9,9,3.0,M2019-02-10D,Race(4),,
11,0,0,0,0,8,0,2,10,0,0,1,1,8,0,3,11,17,17,0.0,M2019-02-10D,Race(4),,
12,0,0,0,0,0,0,0,0,0,1,0,1,0,1,0,1,21,21,0.0,M2019-02-10D,Race(4),,
1,13,5,7,25,3,13,4,20,7,13,3,23,23,31,14,68,6,6,0.0,M2019-02-10D,Race(5),,
2,8,17,0,25,19,3,1,23,18,6,2,26,45,26,3,74,2.8,2.8,3.0,M2019-02-10D,Race(5),,
3,2,0,7,9,0,2,1,3,0,0,2,2,2,2,10,14,12,12,2.0,M2019-02-10D,Race(5),,
4,0,3,0,3,0,9,1,10,0,0,0,0,0,12,1,13,15,15,0.0,M2019-02-10D,Race(5),,
5,0,0,0,0,0,0,0,0,0,0,0,0,0,0,0,0,51,51,0.0,M2019-02-10D,Race(5),,
6,3,2,0,5,0,0,0,0,0,0,2,2,3,2,2,7,10,10,0.0,M2019-02-10D,Race(5),,
7,0,0,0,0,0,0,0,0,0,2,0,2,0,2,0,2,71,71,0.0,M2019-02-10D,Race(5),,
8,2,3,10,15,8,3,12,23,1,3,11,15,11,9,33,53,4.6,4.6,0.0,M2019-02-10D,Race(5),,
9,2,0,6,8,0,0,3,3,0,1,5,6,2,1,14,17,6,6,0.0,M2019-02-10D,Race(5),,
10,0,0,0,0,0,0,0,0,0,0,0,0,0,0,0,0,0,0,0.0,M2019-02-10D,Race(5),,
11,0,0,0,0,0,0,8,8,0,1,1,2,0,1,9,10,15,15,1.0,M2019-02-10D,Race(5),,
12,0,0,0,0,0,0,0,0,0,0,0,0,0,0,0,0,41,41,0.0,M2019-02-10D,Race(5),,
13,0,0,0,0,0,0,0,0,0,0,0,0,0,0,0,0,71,67,0.0,M2019-02-10D,Race(5),,
1,2,0,3,5,8,1,2,11,1,2,3,6,11,3,8,22,8.5,8.5,3.0,M2019-02-10D,Race(6),,
2,11,3,5,19,2,1,3,6,3,3,5,11,16,7,13,36,8,8,0.0,M2019-02-10D,Race(6),,
3,0,0,0,0,0,0,0,0,1,0,0,1,1,0,0,1,101,101,0.0,M2019-02-10D,Race(6),,
4,8,13,2,23,11,6,2,19,14,8,1,23,33,27,5,65,4.2,4.2,1.0,M2019-02-10D,Race(6),,
5,2,0,8,10,3,6,3,12,2,2,3,7,7,8,14,29,13,13,0.0,M2019-02-10D,Race(6),,
6,0,0,0,0,0,0,1,1,0,0,1,1,0,0,2,2,21,21,0.0,M2019-02-10D,Race(6),,
7,7,0,5,12,4,4,5,13,4,8,2,14,15,12,12,39,5,5,0.0,M2019-02-10D,Race(6),,
8,0,0,2,2,1,8,0,9,1,1,1,3,2,9,3,14,16,16,0.0,M2019-02-10D,Race(6),,
9,0,6,0,6,1,4,3,8,0,2,6,8,1,12,9,22,6,6,0.0,M2019-02-10D,Race(6),,
10,0,0,0,0,0,0,0,0,0,0,0,0,0,0,0,0,81,81,0.0,M2019-02-10D,Race(6),,
11,0,0,0,0,0,0,0,0,0,0,0,0,0,0,0,0,51,51,0.0,M2019-02-10D,Race(6),,
12,0,5,5,10,0,0,3,3,0,0,2,2,0,5,10,15,10,10,0.0,M2019-02-10D,Race(6),,
13,0,0,0,0,0,0,0,0,0,0,0,0,0,0,0,0,81,81,0.0,M2019-02-10D,Race(6),,
14,0,3,0,3,0,0,8,8,0,0,2,2,0,3,10,13,9,9,2.0,M2019-02-10D,Race(6),,
1,0,4,0,4,0,8,1,9,1,0,2,3,1,12,3,16,21,21,0.0,M2019-02-10D,Race(7),,
2,15,6,3,24,20,2,1,23,15,7,2,24,50,15,6,71,2.5,2.5,0.0,M2019-02-10D,Race(7),,
3,0,2,0,2,0,0,8,8,0,0,1,1,0,2,9,11,11,11,0.0,M2019-02-10D,Race(7),,
4,9,6,11,26,2,9,8,19,6,9,7,22,17,24,26,67,4.4,4.4,0.0,M2019-02-10D,Race(7),,
5,0,0,2,2,0,0,0,0,0,1,2,3,0,1,4,5,21,21,0.0,M2019-02-10D,Race(7),,
6,0,3,0,3,0,0,0,0,0,0,0,0,0,3,0,3,21,21,0.0,M2019-02-10D,Race(7),,
7,4,7,8,19,8,8,10,26,3,5,8,16,15,20,26,61,4.6,4.6,3.0,M2019-02-10D,Race(7),,
8,2,2,6,10,0,3,2,5,1,4,3,8,3,9,11,23,6,6,1.0,M2019-02-10D,Race(7),,
9,0,0,0,0,0,0,0,0,0,0,0,0,0,0,0,0,31,31,2.0,M2019-02-10D,Race(7),,
10,0,0,0,0,0,0,0,0,0,0,1,1,0,0,1,1,51,51,0.0,M2019-02-10D,Race(7),,
1,0,5,10,15,4,0,4,8,3,0,5,8,7,5,19,31,10,10,1.0,M2019-02-10D,Race(8),,
2,5,5,0,10,9,2,1,12,1,2,1,4,15,9,2,26,8,8,2.0,M2019-02-10D,Race(8),,
3,5,10,8,23,3,9,8,20,5,11,6,22,13,30,22,65,4.6,4.6,0.0,M2019-02-10D,Race(8),,
4,0,0,0,0,0,0,0,0,0,0,0,0,0,0,0,0,41,41,0.0,M2019-02-10D,Race(8),,
5,0,0,0,0,0,0,0,0,0,0,0,0,0,0,0,0,101,101,0.0,M2019-02-10D,Race(8),,
6,0,0,0,0,0,0,0,0,0,0,0,0,0,0,0,0,126,126,0.0,M2019-02-10D,Race(8),,
7,0,0,2,2,0,8,0,8,0,1,1,2,0,9,3,12,12,12,3.0,M2019-02-10D,Race(8),,
8,0,2,0,2,0,0,8,8,1,2,1,4,1,4,9,14,19,19,0.0,M2019-02-10D,Race(8),,
9,18,3,5,26,14,7,2,23,15,6,4,25,47,16,11,74,2,2,0.0,M2019-02-10D,Race(8),,
10,0,0,0,0,0,0,0,0,0,0,0,0,0,0,0,0,51,51,0.0,M2019-02-10D,Race(8),,
11,2,5,5,12,0,4,6,10,1,4,7,12,3,13,18,34,10,10,0.0,M2019-02-10D,Race(8),,
12,0,0,0,0,0,0,0,0,0,0,0,0,0,0,0,0,101,101,0.0,M2019-02-10D,Race(8),,
13,0,0,0,0,0,0,0,0,0,0,0,0,0,0,0,0,61,61,0.0,M2019-02-10D,Race(8),,
14,0,0,0,0,0,0,1,1,0,0,1,1,0,0,2,2,31,31,0.0,M2019-02-10D,Race(8),,
1,0,0,0,0,0,8,0,8,0,1,1,2,0,9,1,10,31,31,0.0,M2019-02-10D,Race(9),,
2,0,3,0,3,8,3,1,12,1,1,2,4,9,7,3,19,14,14,0.0,M2019-02-10D,Race(9),,
3,2,0,0,2,0,0,8,8,1,0,0,1,3,0,8,11,10,10,0.0,M2019-02-10D,Race(9),,
4,0,0,0,0,0,0,0,0,0,0,0,0,0,0,0,0,51,51,0.0,M2019-02-10D,Race(9),,
5,0,0,0,0,0,0,0,0,0,0,0,0,0,0,0,0,26,26,0.0,M2019-02-10D,Race(9),,
6,0,0,3,3,0,0,0,0,1,1,0,2,1,1,3,5,41,41,0.0,M2019-02-10D,Race(9),,
7,0,0,0,0,0,0,0,0,0,0,0,0,0,0,0,0,31,31,0.0,M2019-02-10D,Race(9),,
8,20,8,2,30,10,6,4,20,17,6,0,23,47,20,6,73,2.8,2.8,1.0,M2019-02-10D,Race(9),,
9,4,14,8,26,6,7,6,19,5,10,6,21,15,31,20,66,3.3,3.3,0.0,M2019-02-10D,Race(9),,
10,2,5,14,21,3,5,7,15,1,6,13,20,6,16,34,56,7,7,2.0,M2019-02-10D,Race(9),,
11,2,0,3,5,3,1,3,7,0,1,4,5,5,2,10,17,6.5,6.5,0.0,M2019-02-10D,Race(9),,
12,0,0,0,0,0,0,1,1,0,0,0,0,0,0,1,1,41,41,3.0,M2019-02-10D,Race(9),,
1,18,6,6,30,20,6,5,31,15,4,4,23,53,16,15,84,2.5,2.5,1.0,M2019-02-13D,Race(1),,
2,2,16,7,25,3,10,7,20,0,7,3,10,5,33,17,55,4.4,4.4,2.0,M2019-02-13D,Race(1),,
3,0,0,0,0,0,0,0,0,0,0,0,0,0,0,0,0,101,101,0.0,M2019-02-13D,Race(1),,
4,0,2,5,7,0,2,3,5,1,2,4,7,1,6,12,19,11,11,0.0,M2019-02-13D,Race(1),,
5,0,0,0,0,0,0,0,0,0,0,0,0,0,0,0,0,51,51,0.0,M2019-02-13D,Race(1),,
6,0,0,5,5,0,3,5,8,2,3,6,11,2,6,16,24,13,13,0.0,M2019-02-13D,Race(1),,
7,2,6,7,15,7,9,6,22,8,8,4,20,17,23,17,57,3.4,3.4,0.0,M2019-02-13D,Race(1),,
8,0,0,0,0,0,0,1,1,0,0,1,1,0,0,2,2,21,21,0.0,M2019-02-13D,Race(1),,
9,8,0,0,8,0,0,3,3,0,2,3,5,8,2,6,16,8,8,0.0,M2019-02-13D,Race(1),,
10,0,0,0,0,0,0,0,0,0,0,0,0,0,0,0,0,61,61,3.0,M2019-02-13D,Race(1),,
11,0,0,0,0,0,0,0,0,0,0,1,1,0,0,1,1,61,61,0.0,M2019-02-13D,Race(1),,
12,0,0,0,0,0,0,0,0,0,0,0,0,0,0,0,0,41,41,0.0,M2019-02-13D,Race(1),,
1,0,0,0,0,0,0,0,0,0,0,1,1,0,0,1,1,51,51,0.0,M2019-02-13D,Race(2),,
2,0,3,9,12,3,3,6,12,5,6,7,18,8,12,22,42,7,7,0.0,M2019-02-13D,Race(2),,
3,0,3,0,3,0,0,0,0,0,0,0,0,0,3,0,3,26,26,0.0,M2019-02-13D,Race(2),,
4,7,5,12,24,13,9,6,28,13,6,1,20,33,20,19,72,4.6,4.6,2.0,M2019-02-13D,Race(2),,
5,2,5,0,7,8,4,7,19,5,5,5,15,15,14,12,41,5,5,0.0,M2019-02-13D,Race(2),,
6,11,7,4,22,5,10,6,21,1,4,6,11,17,21,16,54,4.4,4.4,0.0,M2019-02-13D,Race(2),,
7,6,3,0,9,1,3,2,6,2,4,3,9,9,10,5,24,4.8,4.8,1.0,M2019-02-13D,Race(2),,
8,0,0,0,0,0,0,0,0,0,0,0,0,0,0,0,0,61,61,0.0,M2019-02-13D,Race(2),,
9,0,0,5,5,0,1,1,2,0,0,2,2,0,1,8,9,8,8,0.0,M2019-02-13D,Race(2),,
10,2,0,0,2,0,0,1,1,0,0,1,1,2,0,2,4,17,17,0.0,M2019-02-13D,Race(2),,
11,2,4,0,6,0,0,1,1,0,1,0,1,2,5,1,8,13,13,0.0,M2019-02-13D,Race(2),,
12,0,0,0,0,0,0,0,0,0,0,0,0,0,0,0,0,71,67,3.0,M2019-02-13D,Race(2),,
1,5,2,0,7,5,6,8,19,4,5,5,14,14,13,13,40,7,7,0.0,M2019-02-13D,Race(3),,
2,0,0,0,0,0,0,0,0,0,0,0,0,0,0,0,0,51,51,0.0,M2019-02-13D,Race(3),,
3,2,2,9,13,0,2,1,3,2,2,2,6,4,6,12,22,8,8,0.0,M2019-02-13D,Race(3),,
4,0,2,0,2,0,1,1,2,0,1,2,3,0,4,3,7,31,31,0.0,M2019-02-13D,Race(3),,
5,7,0,7,14,2,2,3,7,4,3,3,10,13,5,13,31,7,7,0.0,M2019-02-13D,Race(3),,
6,0,0,0,0,0,0,0,0,0,0,0,0,0,0,0,0,31,31,0.0,M2019-02-13D,Race(3),,
7,3,18,0,21,4,7,7,18,3,7,3,13,10,32,10,52,4.2,4.2,3.0,M2019-02-13D,Race(3),,
8,0,0,3,3,1,1,0,2,1,0,2,3,2,1,5,8,17,17,0.0,M2019-02-13D,Race(3),,
9,0,0,0,0,0,1,0,1,1,0,0,1,1,1,0,2,15,15,0.0,M2019-02-13D,Race(3),,
10,10,6,11,27,14,9,9,32,11,7,5,23,35,22,25,82,3,3,2.0,M2019-02-13D,Race(3),,
11,3,0,0,3,0,1,1,2,0,1,4,5,3,2,5,10,7,7,1.0,M2019-02-13D,Race(3),,
12,0,0,0,0,0,0,0,0,0,0,0,0,0,0,0,0,101,101,0.0,M2019-02-13D,Race(3),,
1,3,4,2,9,0,4,1,5,1,1,1,3,4,9,4,17,10,10,0.0,M2019-02-13D,Race(4),,
2,0,0,0,0,0,0,0,0,0,0,0,0,0,0,0,0,51,51,0.0,M2019-02-13D,Race(4),,
3,0,2,0,2,1,2,0,3,0,1,1,2,1,5,1,7,14,14,0.0,M2019-02-13D,Race(4),,
4,7,3,8,18,11,6,7,24,7,3,3,13,25,12,18,55,5.5,5.5,3.0,M2019-02-13D,Race(4),,
5,4,3,8,15,3,1,4,8,4,4,3,11,11,8,15,34,8.5,8.5,2.0,M2019-02-13D,Race(4),,
6,5,15,5,25,8,10,8,26,7,11,5,23,20,36,18,74,3.7,3.7,0.0,M2019-02-13D,Race(4),,
7,11,3,7,21,7,6,9,22,7,4,11,22,25,13,27,65,2.9,2.9,1.0,M2019-02-13D,Race(4),,
8,0,0,0,0,0,0,0,0,0,0,1,1,0,0,1,1,34,34,0.0,M2019-02-13D,Race(4),,
9,0,0,0,0,0,1,0,1,0,2,0,2,0,3,0,3,14,14,0.0,M2019-02-13D,Race(4),,
10,0,0,0,0,0,0,0,0,0,0,0,0,0,0,0,0,15,15,0.0,M2019-02-13D,Race(4),,
11,0,0,0,0,0,0,1,1,0,0,1,1,0,0,2,2,23,23,0.0,M2019-02-13D,Race(4),,
12,0,0,0,0,0,0,0,0,0,0,0,0,0,0,0,0,31,31,0.0,M2019-02-13D,Race(4),,
1,3,0,2,5,0,2,0,2,0,1,0,1,3,3,2,8,34,34,0.0,M2019-02-13D,Race(5),,
2,2,6,5,13,6,3,5,14,3,1,5,9,11,10,15,36,7.5,7.5,3.0,M2019-02-13D,Race(5),,
3,15,6,2,23,16,7,7,30,13,6,4,23,44,19,13,76,2.35,2.35,1.0,M2019-02-13D,Race(5),,
4,6,5,5,16,1,6,6,13,6,7,5,18,13,18,16,47,6.5,6.5,0.0,M2019-02-13D,Race(5),,
5,0,0,0,0,0,0,1,1,0,2,1,3,0,2,2,4,14,14,2.0,M2019-02-13D,Race(5),,
6,0,3,0,3,2,0,3,5,2,1,2,5,4,4,5,13,15,15,0.0,M2019-02-13D,Race(5),,
7,0,0,3,3,0,0,1,1,0,0,1,1,0,0,5,5,15,15,0.0,M2019-02-13D,Race(5),,
8,2,0,3,5,0,0,0,0,0,0,1,1,2,0,4,6,21,21,0.0,M2019-02-13D,Race(5),,
9,0,0,0,0,0,0,0,0,0,0,0,0,0,0,0,0,34,34,0.0,M2019-02-13D,Race(5),,
10,0,5,10,15,5,10,5,20,2,7,5,14,7,22,20,49,6,6,0.0,M2019-02-13D,Race(5),,
11,0,0,0,0,0,0,0,0,0,1,0,1,0,1,0,1,15,15,0.0,M2019-02-13D,Race(5),,
12,2,5,0,7,0,1,1,2,0,0,2,2,2,6,3,11,11,11,0.0,M2019-02-13D,Race(5),,
1,3,2,4,9,2,2,3,7,3,1,2,6,8,5,9,22,8,8,0.0,M2019-02-13D,Race(6),,
2,10,9,8,27,15,11,4,30,11,9,4,24,36,29,16,81,3.8,3.8,1.0,M2019-02-13D,Race(6),,
3,7,10,5,22,7,7,8,22,5,6,3,14,19,23,16,58,2.9,2.9,3.0,M2019-02-13D,Race(6),,
4,0,3,2,5,0,3,3,6,0,0,1,1,0,6,6,12,7,7,2.0,M2019-02-13D,Race(6),,
5,0,0,8,8,0,1,2,3,0,2,2,4,0,3,12,15,12,12,0.0,M2019-02-13D,Race(6),,
6,8,6,3,17,5,6,7,18,4,6,9,19,17,18,19,54,5,5,0.0,M2019-02-13D,Race(6),,
7,0,0,0,0,0,0,0,0,0,0,0,0,0,0,0,0,34,34,0.0,M2019-02-13D,Race(6),,
8,0,0,0,0,1,0,3,4,3,2,5,10,4,2,8,14,13,13,0.0,M2019-02-13D,Race(6),,
9,2,0,0,2,0,0,0,0,0,0,0,0,2,0,0,2,61,61,0.0,M2019-02-13D,Race(6),,
10,0,0,0,0,0,0,0,0,0,0,0,0,0,0,0,0,15,15,0.0,M2019-02-13D,Race(6),,
1,3,2,10,15,4,2,6,12,5,2,6,13,12,6,22,40,5,5,3.0,M2019-02-13D,Race(7),,
2,0,5,2,7,6,11,6,23,4,7,6,17,10,23,14,47,8,8,0.0,M2019-02-13D,Race(7),,
3,13,6,3,22,12,9,10,31,12,9,2,23,37,24,15,76,2.45,2.45,0.0,M2019-02-13D,Race(7),,
4,3,0,0,3,0,0,0,0,0,0,0,0,3,0,0,3,31,31,0.0,M2019-02-13D,Race(7),,
5,0,0,0,0,0,1,0,1,0,1,0,1,0,2,0,2,18,18,0.0,M2019-02-13D,Race(7),,
6,0,0,0,0,0,0,0,0,0,0,0,0,0,0,0,0,18,18,0.0,M2019-02-13D,Race(7),,
7,3,5,7,15,0,2,0,2,0,4,1,5,3,11,8,22,7,7,2.0,M2019-02-13D,Race(7),,
8,0,5,3,8,1,1,1,3,1,2,2,5,2,8,6,16,11,11,0.0,M2019-02-13D,Race(7),,
9,8,5,5,18,7,4,6,17,4,1,9,14,19,10,20,49,5.5,5.5,1.0,M2019-02-13D,Race(7),,
10,0,2,0,2,0,0,1,1,0,0,0,0,0,2,1,3,17,17,0.0,M2019-02-13D,Race(7),,
1,9,4,8,21,11,7,7,25,8,6,3,17,28,17,18,63,5.5,5.5,1.0,M2019-02-13D,Race(8),,
2,0,3,3,6,2,1,3,6,3,0,2,5,5,4,8,17,10,10,0.0,M2019-02-13D,Race(8),,
3,7,5,7,19,9,8,4,21,4,10,4,18,20,23,15,58,4.2,4.2,0.0,M2019-02-13D,Race(8),,
4,12,11,5,28,8,11,9,28,9,6,8,23,29,28,22,79,2.5,2.5,0.0,M2019-02-13D,Race(8),,
5,0,0,0,0,0,0,1,1,1,1,2,4,1,1,3,5,14,14,0.0,M2019-02-13D,Race(8),,
6,2,5,2,9,0,2,3,5,1,2,4,7,3,9,9,21,10,10,0.0,M2019-02-13D,Race(8),,
7,0,0,0,0,0,0,0,0,0,0,0,0,0,0,0,0,16,16,0.0,M2019-02-13D,Race(8),,
8,0,0,3,3,0,0,0,0,0,0,1,1,0,0,4,4,15,15,0.0,M2019-02-13D,Race(8),,
9,0,0,0,0,0,0,0,0,0,0,0,0,0,0,0,0,71,71,2.0,M2019-02-13D,Race(8),,
10,0,0,0,0,0,0,0,0,0,0,0,0,0,0,0,0,34,34,0.0,M2019-02-13D,Race(8),,
11,0,0,0,0,0,0,1,1,0,0,0,0,0,0,1,1,41,41,0.0,M2019-02-13D,Race(8),,
12,0,2,2,4,0,1,2,3,0,1,2,3,0,4,6,10,16,16,3.0,M2019-02-13D,Race(8),,
1,0,5,8,13,2,6,12,20,0,4,11,15,2,15,31,48,10,10,0.0,M2019-02-13D,Race(9),,
2,0,3,8,11,0,1,3,4,0,1,3,4,0,5,14,19,7.5,7.5,0.0,M2019-02-13D,Race(9),,
3,12,13,3,28,10,10,6,26,5,15,5,25,27,38,14,79,2.6,2.6,1.0,M2019-02-13D,Race(9),,
4,2,0,2,4,1,0,1,2,0,0,3,3,3,0,6,9,12,12,0.0,M2019-02-13D,Race(9),,
5,14,7,4,25,17,10,4,31,21,4,1,26,52,21,9,82,2.45,2.45,0.0,M2019-02-13D,Race(9),,
6,0,0,0,0,0,2,2,4,0,1,1,2,0,3,3,6,26,26,0.0,M2019-02-13D,Race(9),,
7,0,0,0,0,0,0,0,0,0,0,1,1,0,0,1,1,51,51,2.0,M2019-02-13D,Race(9),,
8,0,2,3,5,0,0,1,1,0,0,1,1,0,2,5,7,17,17,0.0,M2019-02-13D,Race(9),,
9,0,0,0,0,0,0,0,0,0,0,0,0,0,0,0,0,41,41,0.0,M2019-02-13D,Race(9),,
10,0,0,0,0,0,1,0,1,0,1,0,1,0,2,0,2,41,41,3.0,M2019-02-13D,Race(9),,
11,0,0,0,0,0,0,1,1,0,0,0,0,0,0,1,1,26,26,0.0,M2019-02-13D,Race(9),,
12,2,0,2,4,0,0,0,0,0,0,0,0,2,0,2,4,26,26,0.0,M2019-02-13D,Race(9),,
1,8,10,7,25,8,8,9,25,5,7,6,18,21,25,22,68,4,4,2.0,M2019-02-20D,Race(1),,
2,5,6,0,11,1,0,0,1,0,4,2,6,6,10,2,18,15,15,3.0,M2019-02-20D,Race(1),,
3,0,0,3,3,0,0,0,0,0,0,0,0,0,0,3,3,19,19,0.0,M2019-02-20D,Race(1),,
4,10,12,6,28,12,7,10,29,9,4,8,21,31,23,24,78,3.2,3.2,0.0,M2019-02-20D,Race(1),,
5,3,0,3,6,3,4,3,10,2,2,3,7,8,6,9,23,16,16,0.0,M2019-02-20D,Race(1),,
6,2,2,2,6,4,5,3,12,6,4,0,10,12,11,5,28,11,11,0.0,M2019-02-20D,Race(1),,
7,0,0,0,0,0,0,0,0,0,0,0,0,0,0,0,0,41,41,0.0,M2019-02-20D,Race(1),,
8,0,0,6,6,0,3,5,8,3,4,3,10,3,7,14,24,5.5,5.5,1.0,M2019-02-20D,Race(1),,
9,0,0,0,0,0,0,0,0,0,0,1,1,0,0,1,1,26,26,0.0,M2019-02-20D,Race(1),,
10,0,0,0,0,0,0,0,0,0,0,1,1,0,0,1,1,17,17,0.0,M2019-02-20D,Race(1),,
11,0,0,0,0,1,0,0,1,1,0,1,2,2,0,1,3,19,19,0.0,M2019-02-20D,Race(1),,
12,2,0,3,5,1,1,0,2,0,0,0,0,3,1,3,7,10,10,0.0,M2019-02-20D,Race(1),,
1,16,5,2,23,7,7,6,20,7,8,2,17,30,20,10,60,4.4,4.4,2.0,M2019-02-20D,Race(2),,
2,5,10,8,23,12,6,6,24,6,1,5,12,23,17,19,59,5.5,5.5,0.0,M2019-02-20D,Race(2),,
3,0,3,2,5,2,1,0,3,2,1,0,3,4,5,2,11,16,16,0.0,M2019-02-20D,Race(2),,
4,2,0,3,5,1,1,3,5,2,2,3,7,5,3,9,17,17,17,0.0,M2019-02-20D,Race(2),,
5,0,0,2,2,0,2,2,4,0,4,3,7,0,6,7,13,14,14,0.0,M2019-02-20D,Race(2),,
6,0,2,6,8,1,1,1,3,0,2,3,5,1,5,10,16,15,15,0.0,M2019-02-20D,Race(2),,
7,5,8,0,13,5,9,10,24,3,4,9,16,13,21,19,53,4.4,4.4,1.0,M2019-02-20D,Race(2),,
8,0,2,2,4,0,0,0,0,1,0,0,1,1,2,2,5,17,17,0.0,M2019-02-20D,Race(2),,
9,0,0,3,3,0,0,1,1,0,0,0,0,0,0,4,4,18,18,0.0,M2019-02-20D,Race(2),,
10,2,0,2,4,2,2,0,4,4,3,0,7,8,5,2,15,9,9,0.0,M2019-02-20D,Race(2),,
11,0,0,0,0,0,1,1,2,1,1,0,2,1,2,1,4,12,12,0.0,M2019-02-20D,Race(2),,
12,0,0,0,0,0,0,0,0,0,0,1,1,0,0,1,1,14,14,3.0,M2019-02-20D,Race(2),,
1,0,0,0,0,0,0,0,0,0,1,0,1,0,1,0,1,51,51,0.0,M2019-02-20D,Race(3),,
2,3,5,2,10,3,4,3,10,2,3,3,8,8,12,8,28,7,7,3.0,M2019-02-20D,Race(3),,
3,3,2,0,5,1,1,3,5,1,2,3,6,5,5,6,16,7.5,7.5,0.0,M2019-02-20D,Race(3),,
4,0,2,2,4,1,0,1,2,1,0,4,5,2,2,7,11,21,21,0.0,M2019-02-20D,Race(3),,
5,0,0,0,0,0,0,0,0,0,0,0,0,0,0,0,0,61,61,0.0,M2019-02-20D,Race(3),,
6,3,3,6,12,2,1,1,4,1,4,1,6,6,8,8,22,8,8,1.0,M2019-02-20D,Race(3),,
7,8,4,5,17,4,7,4,15,3,4,6,13,15,15,15,45,7,7,0.0,M2019-02-20D,Race(3),,
8,11,3,8,22,4,5,4,13,5,1,4,10,20,9,16,45,3.6,3.6,0.0,M2019-02-20D,Race(3),,
9,2,0,4,6,0,2,2,4,1,3,0,4,3,5,6,14,12,12,0.0,M2019-02-20D,Race(3),,
10,0,11,3,14,11,8,9,28,9,5,3,17,20,24,15,59,7,7,0.0,M2019-02-20D,Race(3),,
11,0,0,0,0,0,1,2,3,0,2,1,3,0,3,3,6,10,10,0.0,M2019-02-20D,Race(3),,
12,0,0,0,0,4,1,1,6,3,1,1,5,7,2,2,11,21,21,2.0,M2019-02-20D,Race(3),,
1,20,7,3,30,20,10,5,35,20,1,3,24,60,18,11,89,1.7,1.7,1.0,M2019-02-20D,Race(4),,
2,7,15,8,30,7,13,7,27,3,14,5,22,17,42,20,79,4,4,3.0,M2019-02-20D,Race(4),,
3,0,0,5,5,0,0,1,1,0,1,1,2,0,1,7,8,17,17,0.0,M2019-02-20D,Race(4),,
4,0,0,0,0,0,1,1,2,0,0,2,2,0,1,3,4,31,31,0.0,M2019-02-20D,Race(4),,
5,3,0,2,5,0,0,2,2,0,2,1,3,3,2,5,10,26,26,0.0,M2019-02-20D,Race(4),,
6,0,2,5,7,3,3,4,10,2,3,5,10,5,8,14,27,31,31,0.0,M2019-02-20D,Race(4),,
7,0,3,2,5,0,2,8,10,0,2,4,6,0,7,14,21,17,17,0.0,M2019-02-20D,Race(4),,
8,0,0,0,0,0,0,0,0,1,0,1,2,1,0,1,2,23,23,2.0,M2019-02-20D,Race(4),,
9,0,3,2,5,0,1,1,2,0,2,2,4,0,6,5,11,12,12,0.0,M2019-02-20D,Race(4),,
10,0,0,3,3,0,0,0,0,0,1,0,1,0,1,3,4,21,21,0.0,M2019-02-20D,Race(4),,
11,0,0,0,0,0,0,0,0,0,0,0,0,0,0,0,0,31,31,0.0,M2019-02-20D,Race(4),,
12,0,0,0,0,0,0,1,1,0,0,2,2,0,0,3,3,71,67,0.0,M2019-02-20D,Race(4),,
1,2,0,0,2,0,0,2,2,1,0,2,3,3,0,4,7,16,16,0.0,M2019-02-20D,Race(5),,
2,0,0,0,0,0,0,0,0,0,0,0,0,0,0,0,0,41,41,0.0,M2019-02-20D,Race(5),,
3,3,0,2,5,8,7,7,22,5,5,5,15,16,12,14,42,7,7,0.0,M2019-02-20D,Race(5),,
4,2,6,4,12,2,0,0,2,3,2,1,6,7,8,5,20,5,5,0.0,M2019-02-20D,Race(5),,
5,2,4,6,12,7,6,6,19,1,6,7,14,10,16,19,45,6.5,6.5,2.0,M2019-02-20D,Race(5),,
6,3,0,3,6,4,5,2,11,5,2,0,7,12,7,5,24,7,7,1.0,M2019-02-20D,Race(5),,
7,9,7,6,22,5,8,5,18,5,7,2,14,19,22,13,54,6.5,6.5,0.0,M2019-02-20D,Race(5),,
8,3,8,0,11,2,2,3,7,2,2,4,8,7,12,7,26,10,10,0.0,M2019-02-20D,Race(5),,
9,0,5,3,8,0,1,0,1,0,0,0,0,0,6,3,9,9,9,0.0,M2019-02-20D,Race(5),,
10,0,0,0,0,0,0,0,0,0,0,0,0,0,0,0,0,51,51,0.0,M2019-02-20D,Race(5),,
11,6,0,6,12,2,1,5,8,4,2,5,11,12,3,16,31,7,7,3.0,M2019-02-20D,Race(5),,
12,0,0,0,0,0,0,0,0,0,0,0,0,0,0,0,0,41,41,0.0,M2019-02-20D,Race(5),,
1,11,10,4,25,3,4,2,9,1,6,3,10,15,20,9,44,9,9,0.0,M2019-02-20D,Race(6),,
2,0,0,0,0,0,0,0,0,0,0,0,0,0,0,0,0,21,21,0.0,M2019-02-20D,Race(6),,
3,2,5,4,11,2,1,3,6,2,3,4,9,6,9,11,26,7,7,1.0,M2019-02-20D,Race(6),,
4,0,3,5,8,9,6,8,23,6,4,7,17,15,13,20,48,10,10,3.0,M2019-02-20D,Race(6),,
5,0,0,0,0,0,0,0,0,0,0,0,0,0,0,0,0,31,31,0.0,M2019-02-20D,Race(6),,
6,0,0,0,0,1,2,1,4,2,3,2,7,3,5,3,11,19,19,0.0,M2019-02-20D,Race(6),,
7,0,0,0,0,0,0,0,0,0,0,0,0,0,0,0,0,21,21,0.0,M2019-02-20D,Race(6),,
8,5,0,8,13,8,4,3,15,7,3,1,11,20,7,12,39,4.6,4.6,0.0,M2019-02-20D,Race(6),,
9,0,2,0,2,0,0,1,1,0,1,1,2,0,3,2,5,14,14,0.0,M2019-02-20D,Race(6),,
10,7,7,6,20,5,11,3,19,7,5,1,13,19,23,10,52,3.3,3.3,2.0,M2019-02-20D,Race(6),,
11,5,3,0,8,1,2,7,10,1,1,4,6,7,6,11,24,8,8,0.0,M2019-02-20D,Race(6),,
12,0,0,3,3,0,0,0,0,0,0,1,1,0,0,4,4,34,34,0.0,M2019-02-20D,Race(6),,
1,5,3,0,8,0,0,2,2,1,0,3,4,6,3,5,14,11,11,2.0,M2019-02-20D,Race(7),,
2,10,4,0,14,7,10,5,22,5,6,5,16,22,20,10,52,4.6,4.6,1.0,M2019-02-20D,Race(7),,
3,0,0,0,0,0,0,0,0,0,0,0,0,0,0,0,0,31,31,0.0,M2019-02-20D,Race(7),,
4,4,3,8,15,5,6,7,18,2,8,4,14,11,17,19,47,6,6,0.0,M2019-02-20D,Race(7),,
5,0,0,0,0,0,0,0,0,0,0,0,0,0,0,0,0,41,41,0.0,M2019-02-20D,Race(7),,
6,3,0,0,3,0,2,2,4,1,1,5,7,4,3,7,14,9,9,0.0,M2019-02-20D,Race(7),,
7,5,7,12,24,3,3,3,9,4,1,5,10,12,11,20,43,5.5,5.5,0.0,M2019-02-20D,Race(7),,
8,0,0,2,2,1,1,1,3,1,3,0,4,2,4,3,9,9,9,0.0,M2019-02-20D,Race(7),,
9,0,0,0,0,0,0,0,0,0,0,0,0,0,0,0,0,61,61,0.0,M2019-02-20D,Race(7),,
10,0,10,3,13,13,8,6,27,12,6,3,21,25,24,12,61,4.6,4.6,0.0,M2019-02-20D,Race(7),,
11,3,3,5,11,1,0,1,2,0,1,1,2,4,4,7,15,12,12,0.0,M2019-02-20D,Race(7),,
12,0,0,0,0,0,0,0,0,0,0,0,0,0,0,0,0,41,41,3.0,M2019-02-20D,Race(7),,
1,5,2,5,12,4,7,3,14,1,6,1,8,10,15,9,34,8,8,0.0,M2019-02-20D,Race(8),,
2,0,0,0,0,0,0,0,0,1,0,0,1,1,0,0,1,26,26,0.0,M2019-02-20D,Race(8),,
3,0,11,2,13,7,8,10,25,8,5,6,19,15,24,18,57,6,6,2.0,M2019-02-20D,Race(8),,
4,0,3,5,8,0,0,3,3,2,0,5,7,2,3,13,18,9,9,0.0,M2019-02-20D,Race(8),,
5,0,2,0,2,0,0,2,2,0,1,4,5,0,3,6,9,18,18,0.0,M2019-02-20D,Race(8),,
6,2,0,0,2,0,0,0,0,0,0,0,0,2,0,0,2,26,26,0.0,M2019-02-20D,Race(8),,
7,2,2,0,4,0,0,0,0,0,0,0,0,2,2,0,4,13,13,0.0,M2019-02-20D,Race(8),,
8,3,0,3,6,0,1,0,1,1,2,1,4,4,3,4,11,9.5,9.5,0.0,M2019-02-20D,Race(8),,
9,18,7,2,27,17,7,4,28,11,8,3,22,46,22,9,77,3,3,1.0,M2019-02-20D,Race(8),,
10,0,0,2,2,0,2,1,3,0,0,1,1,0,2,4,6,21,21,0.0,M2019-02-20D,Race(8),,
11,0,3,11,14,2,5,7,14,2,4,5,11,4,12,23,39,6.5,6.5,3.0,M2019-02-20D,Race(8),,
12,0,0,0,0,0,0,0,0,0,0,0,0,0,0,0,0,41,41,0.0,M2019-02-20D,Race(8),,
1,10,12,4,26,11,4,5,20,13,7,5,25,34,23,14,71,3.5,3.5,0.0,M2019-02-24D,Race(1),,
2,0,3,2,5,3,7,6,16,3,3,6,12,6,13,14,33,8.5,8.5,0.0,M2019-02-24D,Race(1),,
3,0,0,3,3,0,0,0,0,0,1,0,1,0,1,3,4,16,16,0.0,M2019-02-24D,Race(1),,
4,11,6,3,20,6,6,2,14,7,6,1,14,24,18,6,48,5,5,1.0,M2019-02-24D,Race(1),,
5,0,0,0,0,0,0,2,2,0,1,3,4,0,1,5,6,19,19,0.0,M2019-02-24D,Race(1),,
6,5,3,0,8,8,1,3,12,2,3,3,8,15,7,6,28,8.5,8.5,2.0,M2019-02-24D,Race(1),,
7,0,0,3,3,0,0,1,1,0,0,1,1,0,0,5,5,23,23,3.0,M2019-02-24D,Race(1),,
8,0,2,0,2,0,0,0,0,0,0,0,0,0,2,0,2,51,51,0.0,M2019-02-24D,Race(1),,
9,2,0,2,4,0,3,1,4,0,4,2,6,2,7,5,14,7.5,7.5,0.0,M2019-02-24D,Race(1),,
10,0,0,0,0,0,0,0,0,0,0,0,0,0,0,0,0,26,26,0.0,M2019-02-24D,Race(1),,
11,2,2,8,12,2,1,8,11,1,1,3,5,5,4,19,28,8.5,8.5,0.0,M2019-02-24D,Race(1),,
12,0,2,5,7,0,8,2,10,0,0,2,2,0,10,9,19,21,21,0.0,M2019-02-24D,Race(1),,
13,0,0,0,0,0,0,0,0,0,0,0,0,0,0,0,0,41,41,0.0,M2019-02-24D,Race(1),,
14,0,0,0,0,0,0,0,0,0,0,0,0,0,0,0,0,51,51,0.0,M2019-02-24D,Race(1),,
1,9,7,6,22,3,3,4,10,1,4,4,9,13,14,14,41,8,8,1.0,M2019-02-24D,Race(10),,
2,14,12,2,28,11,7,2,20,15,5,0,20,40,24,4,68,2.7,2.9,2.0,M2019-02-24D,Race(10),,
3,0,3,2,5,0,0,0,0,1,1,0,2,1,4,2,7,26,26,0.0,M2019-02-24D,Race(10),,
4,2,0,0,2,0,0,1,1,0,1,1,2,2,1,2,5,34,34,0.0,M2019-02-24D,Race(10),,
5,0,0,2,2,8,1,1,10,0,1,0,1,8,2,3,13,21,21,0.0,M2019-02-24D,Race(10),,
6,0,0,2,2,0,1,0,1,0,2,2,4,0,3,4,7,12,12,0.0,M2019-02-24D,Race(10),,
7,3,5,5,13,2,5,7,14,3,6,12,21,8,16,24,48,7.5,7,0.0,M2019-02-24D,Race(10),,
8,0,0,0,0,0,0,0,0,0,0,0,0,0,0,0,0,51,51,0.0,M2019-02-24D,Race(10),,
9,0,0,3,3,0,0,0,0,0,0,0,0,0,0,3,3,20,21,3.0,M2019-02-24D,Race(10),,
10,0,3,0,3,0,0,2,2,1,1,2,4,1,4,4,9,13,13,0.0,M2019-02-24D,Race(10),,
11,0,0,0,0,0,1,4,5,0,1,3,4,0,2,7,9,13,13,0.0,M2019-02-24D,Race(10),,
12,2,0,3,5,6,3,1,10,5,3,1,9,13,6,5,24,9,9,0.0,M2019-02-24D,Race(10),,
13,0,0,3,3,0,1,8,9,0,0,0,0,0,1,11,12,16,17,0.0,M2019-02-24D,Race(10),,
14,0,0,2,2,0,8,0,8,0,1,1,2,0,9,3,12,13,13,0.0,M2019-02-24D,Race(10),,
1,0,0,8,8,0,3,4,7,1,4,4,9,1,7,16,24,13,13,0.0,M2019-02-24D,Race(2),,
2,3,0,5,8,8,2,6,16,1,2,7,10,12,4,18,34,8,8,0.0,M2019-02-24D,Race(2),,
3,12,10,3,25,10,9,3,22,11,10,1,22,33,29,7,69,3.2,3.2,0.0,M2019-02-24D,Race(2),,
4,13,10,7,30,12,6,4,22,13,8,2,23,38,24,13,75,2,2,1.0,M2019-02-24D,Race(2),,
5,2,8,3,13,0,2,10,12,0,2,6,8,2,12,19,33,7.5,7.5,2.0,M2019-02-24D,Race(2),,
6,0,2,4,6,0,8,3,11,0,0,6,6,0,10,13,23,12,12,0.0,M2019-02-24D,Race(2),,
1,3,0,0,3,0,1,8,9,1,0,3,4,4,1,11,16,16,16,0.0,M2019-02-24D,Race(3),,
2,7,7,5,19,8,3,6,17,2,6,3,11,17,16,14,47,6,6,0.0,M2019-02-24D,Race(3),,
3,2,2,8,12,6,3,4,13,7,3,1,11,15,8,13,36,7.5,7.5,0.0,M2019-02-24D,Race(3),,
4,0,0,0,0,0,0,0,0,0,0,0,0,0,0,0,0,51,51,0.0,M2019-02-24D,Race(3),,
5,0,0,0,0,0,0,0,0,0,0,0,0,0,0,0,0,31,31,0.0,M2019-02-24D,Race(3),,
6,0,0,0,0,0,0,0,0,0,1,0,1,0,1,0,1,81,81,0.0,M2019-02-24D,Race(3),,
7,0,0,0,0,0,0,0,0,0,1,1,2,0,1,1,2,101,101,0.0,M2019-02-24D,Race(3),,
8,0,0,0,0,0,0,0,0,0,0,0,0,0,0,0,0,81,81,0.0,M2019-02-24D,Race(3),,
9,0,0,0,0,0,0,0,0,0,0,0,0,0,0,0,0,41,41,0.0,M2019-02-24D,Race(3),,
10,3,0,2,5,2,5,2,9,2,2,4,8,7,7,8,22,12,12,2.0,M2019-02-24D,Race(3),,
11,5,10,6,21,10,5,4,19,6,4,8,18,21,19,18,58,6,6,0.0,M2019-02-24D,Race(3),,
12,7,3,5,15,4,4,2,10,7,4,1,12,18,11,8,37,2.9,2.9,1.0,M2019-02-24D,Race(3),,
13,3,8,4,15,0,9,4,13,1,5,5,11,4,22,13,39,5.5,5.5,3.0,M2019-02-24D,Race(3),,
14,0,0,0,0,0,0,0,0,0,0,0,0,0,0,0,0,34,41,0.0,M2019-02-24D,Race(3),,
1,5,0,2,7,0,0,3,3,2,1,4,7,7,1,9,17,8.5,8.5,1.0,M2019-02-24D,Race(4),,
2,0,0,0,0,0,0,0,0,0,0,0,0,0,0,0,0,51,51,0.0,M2019-02-24D,Race(4),,
3,15,9,4,28,9,7,4,20,10,7,5,22,34,23,13,70,2.6,2.6,3.0,M2019-02-24D,Race(4),,
4,0,4,3,7,3,7,6,16,5,8,2,15,8,19,11,38,7.5,7.5,0.0,M2019-02-24D,Race(4),,
5,0,3,2,5,8,2,2,12,1,2,3,6,9,7,7,23,16,16,0.0,M2019-02-24D,Race(4),,
6,0,2,16,18,3,9,1,13,5,2,3,10,8,13,20,41,7.5,7,2.0,M2019-02-24D,Race(4),,
7,10,8,0,18,7,5,4,16,3,6,5,14,20,19,9,48,4.2,4.2,0.0,M2019-02-24D,Race(4),,
8,0,0,0,0,0,0,0,0,0,0,0,0,0,0,0,0,101,101,0.0,M2019-02-24D,Race(4),,
9,0,4,3,7,0,0,0,0,0,0,0,0,0,4,3,7,16,17,0.0,M2019-02-24D,Race(4),,
10,0,0,0,0,0,0,8,8,0,0,1,1,0,0,9,9,41,51,0.0,M2019-02-24D,Race(4),,
11,0,0,0,0,0,0,0,0,0,0,1,1,0,0,1,1,51,51,0.0,M2019-02-24D,Race(4),,
12,0,0,0,0,0,0,2,2,0,0,2,2,0,0,4,4,31,31,0.0,M2019-02-24D,Race(4),,
13,0,0,0,0,0,0,0,0,0,0,0,0,0,0,0,0,41,41,0.0,M2019-02-24D,Race(4),,
14,0,0,0,0,0,0,0,0,0,0,0,0,0,0,0,0,71,67,0.0,M2019-02-24D,Race(4),,
1,15,5,4,24,6,7,4,17,5,6,6,17,26,18,14,58,3.7,3.7,1.0,M2019-02-24D,Race(5),,
2,5,3,0,8,0,3,2,5,2,4,1,7,7,10,3,20,17,17,0.0,M2019-02-24D,Race(5),,
3,3,4,0,7,0,0,2,2,2,1,3,6,5,5,5,15,17,17,0.0,M2019-02-24D,Race(5),,
4,0,11,5,16,9,8,5,22,6,8,4,18,15,27,14,56,4.4,4.4,2.0,M2019-02-24D,Race(5),,
5,0,0,0,0,0,0,0,0,0,0,0,0,0,0,0,0,51,51,0.0,M2019-02-24D,Race(5),,
6,0,0,0,0,0,0,0,0,0,1,1,2,0,1,1,2,81,81,0.0,M2019-02-24D,Race(5),,
7,0,0,0,0,0,0,0,0,1,0,0,1,1,0,0,1,21,21,0.0,M2019-02-24D,Race(5),,
8,0,2,2,4,8,0,0,8,1,0,0,1,9,2,2,13,17,17,0.0,M2019-02-24D,Race(5),,
9,0,0,0,0,0,0,0,0,0,0,0,0,0,0,0,0,18,18,0.0,M2019-02-24D,Race(5),,
10,0,2,5,7,0,1,8,9,0,1,3,4,0,4,16,20,15,15,0.0,M2019-02-24D,Race(5),,
11,2,3,5,10,5,3,7,15,6,3,6,15,13,9,18,40,4.4,4.4,3.0,M2019-02-24D,Race(5),,
12,0,0,3,3,0,0,0,0,0,0,0,0,0,0,3,3,51,51,0.0,M2019-02-24D,Race(5),,
13,0,0,0,0,0,0,0,0,0,0,0,0,0,0,0,0,41,41,0.0,M2019-02-24D,Race(5),,
14,5,0,6,11,2,8,2,12,3,2,2,7,10,10,10,30,7.5,7.5,0.0,M2019-02-24D,Race(5),,
1,3,8,7,18,3,4,4,11,6,6,4,16,12,18,15,45,4.8,4.8,0.0,M2019-02-24D,Race(6),,
2,0,0,0,0,0,0,0,0,0,0,0,0,0,0,0,0,71,67,0.0,M2019-02-24D,Race(6),,
3,19,7,4,30,17,3,2,22,16,5,3,24,52,15,9,76,1.95,2,1.0,M2019-02-24D,Race(6),,
4,2,0,0,2,0,0,0,0,0,0,0,0,2,0,0,2,41,41,0.0,M2019-02-24D,Race(6),,
5,2,0,5,7,0,10,3,13,0,3,4,7,2,13,12,27,13,13,0.0,M2019-02-24D,Race(6),,
6,0,8,3,11,0,6,5,11,1,6,5,12,1,20,13,34,10,10,0.0,M2019-02-24D,Race(6),,
7,4,5,6,15,2,7,6,15,2,5,5,12,8,17,17,42,7.5,7.5,3.0,M2019-02-24D,Race(6),,
8,0,2,3,5,0,0,0,0,0,0,0,0,0,2,3,5,26,26,0.0,M2019-02-24D,Race(6),,
9,0,0,2,2,8,0,0,8,1,0,0,1,9,0,2,11,26,26,0.0,M2019-02-24D,Race(6),,
10,0,0,0,0,0,0,0,0,0,0,0,0,0,0,0,0,61,61,0.0,M2019-02-24D,Race(6),,
11,0,0,0,0,0,0,0,0,0,0,0,0,0,0,0,0,51,51,0.0,M2019-02-24D,Race(6),,
12,0,0,0,0,0,0,10,10,0,1,5,6,0,1,15,16,11,11,2.0,M2019-02-24D,Race(6),,
13,0,0,0,0,0,0,0,0,0,0,0,0,0,0,0,0,151,151,0.0,M2019-02-24D,Race(6),,
14,0,0,0,0,0,0,0,0,0,0,0,0,0,0,0,0,101,101,0.0,M2019-02-24D,Race(6),,
1,0,0,0,0,0,0,0,0,0,0,0,0,0,0,0,0,41,41,0.0,M2019-02-24D,Race(7),,
2,0,6,0,6,3,4,1,8,5,3,1,9,8,13,2,23,12,12,2.0,M2019-02-24D,Race(7),,
3,2,3,5,10,4,4,4,12,3,5,6,14,9,12,15,36,9,9,0.0,M2019-02-24D,Race(7),,
4,0,0,2,2,0,0,2,2,1,2,2,5,1,2,6,9,15,15,0.0,M2019-02-24D,Race(7),,
5,11,5,10,26,11,10,6,27,10,4,7,21,32,19,23,74,4.8,4.8,3.0,M2019-02-24D,Race(7),,
6,0,0,0,0,0,0,0,0,0,0,0,0,0,0,0,0,26,26,0.0,M2019-02-24D,Race(7),,
7,6,5,10,21,9,6,4,19,1,5,5,11,16,16,19,51,5,5,0.0,M2019-02-24D,Race(7),,
8,0,0,0,0,0,0,0,0,0,0,0,0,0,0,0,0,21,21,0.0,M2019-02-24D,Race(7),,
9,0,0,0,0,0,0,0,0,0,0,1,1,0,0,1,1,31,31,0.0,M2019-02-24D,Race(7),,
10,2,0,0,2,0,0,8,8,0,0,2,2,2,0,10,12,11,11,0.0,M2019-02-24D,Race(7),,
11,0,0,0,0,0,0,0,0,0,0,1,1,0,0,1,1,51,51,0.0,M2019-02-24D,Race(7),,
12,9,11,3,23,3,6,5,14,6,7,1,14,18,24,9,51,2.8,2.8,1.0,M2019-02-24D,Race(7),,
1,10,3,10,23,7,6,3,16,6,6,8,20,23,15,21,59,4.2,4.2,0.0,M2019-02-24D,Race(8),,
2,15,10,5,30,14,4,4,22,19,4,3,26,48,18,12,78,2.6,26,1.0,M2019-02-24D,Race(8),,
3,3,8,5,16,0,6,6,12,0,10,3,13,3,24,14,41,7,7,2.0,M2019-02-24D,Race(8),,
4,0,2,0,2,0,2,8,10,0,1,4,5,0,5,12,17,13,13,3.0,M2019-02-24D,Race(8),,
5,0,0,0,0,0,0,0,0,0,0,0,0,0,0,0,0,21,21,0.0,M2019-02-24D,Race(8),,
6,0,4,0,4,0,2,3,5,0,1,3,4,0,7,6,13,26,26,0.0,M2019-02-24D,Race(8),,
7,0,0,0,0,0,0,0,0,0,0,0,0,0,0,0,0,26,26,0.0,M2019-02-24D,Race(8),,
8,0,0,0,0,0,0,0,0,0,0,0,0,0,0,0,0,61,61,0.0,M2019-02-24D,Race(8),,
9,0,0,0,0,0,0,0,0,0,0,0,0,0,0,0,0,26,26,0.0,M2019-02-24D,Race(8),,
10,0,0,0,0,0,0,0,0,0,0,1,1,0,0,1,1,26,26,0.0,M2019-02-24D,Race(8),,
11,2,0,5,7,9,2,2,13,1,3,0,4,12,5,7,24,11,11,0.0,M2019-02-24D,Race(8),,
12,0,3,5,8,0,8,4,12,0,1,4,5,0,12,13,25,12,12,0.0,M2019-02-24D,Race(8),,
13,0,0,0,0,0,0,0,0,0,0,0,0,0,0,0,0,34,35,0.0,M2019-02-24D,Race(8),,
14,0,0,0,0,0,0,0,0,0,0,0,0,0,0,0,0,61,61,0.0,M2019-02-24D,Race(8),,
1,0,0,0,0,0,0,0,0,0,0,0,0,0,0,0,0,51,51,0.0,M2019-02-24D,Race(9),,
2,0,0,0,0,8,0,0,8,1,0,0,1,9,0,0,9,71,67,0.0,M2019-02-24D,Race(9),,
3,30,0,0,30,21,2,0,23,24,2,0,26,75,4,0,79,1.45,1.45,1.0,M2019-02-24D,Race(9),,
4,0,0,4,4,0,1,3,4,0,1,4,5,0,2,11,13,26,26,3.0,M2019-02-24D,Race(9),,
5,0,3,10,13,1,1,1,3,1,0,3,4,2,4,14,20,8,8,0.0,M2019-02-24D,Race(9),,
6,0,0,0,0,0,0,0,0,0,1,0,1,0,1,0,1,101,101,0.0,M2019-02-24D,Race(9),,
7,0,0,0,0,0,0,0,0,0,0,1,1,0,0,1,1,31,31,0.0,M2019-02-24D,Race(9),,
8,0,7,9,16,0,3,12,15,0,5,8,13,0,15,29,44,12,12,0.0,M2019-02-24D,Race(9),,
9,0,18,5,23,1,15,6,22,0,17,7,24,1,50,18,69,6.5,6.5,2.0,M2019-02-24D,Race(9),,
10,0,2,0,2,0,8,0,8,0,0,0,0,0,10,0,10,71,67,0.0,M2019-02-24D,Race(9),,
11,0,0,0,0,0,0,0,0,0,0,0,0,0,0,0,0,101,101,0.0,M2019-02-24D,Race(9),,
12,0,0,0,0,0,0,0,0,0,0,0,0,0,0,0,0,41,41,0.0,M2019-02-24D,Race(9),,
13,0,0,2,2,0,0,0,0,0,0,0,0,0,0,2,2,41,41,0.0,M2019-02-24D,Race(9),,
14,0,0,0,0,0,0,8,8,0,0,3,3,0,0,11,11,26,26,0.0,M2019-02-24D,Race(9),,
1,14,5,6,25,14,8,4,26,16,3,2,21,44,16,12,72,3.6,3.6,1.0,M2019-02-27D,Race(1),,
2,2,10,10,22,8,11,8,27,5,11,5,21,15,32,23,70,7,7,0.0,M2019-02-27D,Race(1),,
3,9,7,9,25,2,6,8,16,4,6,7,17,15,19,24,58,3.2,3.2,2.0,M2019-02-27D,Race(1),,
4,3,3,0,6,1,0,3,4,0,0,4,4,4,3,7,14,13,13,3.0,M2019-02-27D,Race(1),,
5,0,0,2,2,0,2,1,3,0,3,1,4,0,5,4,9,21,21,0.0,M2019-02-27D,Race(1),,
6,0,0,0,0,0,0,0,0,0,2,0,2,0,2,0,2,71,67,0.0,M2019-02-27D,Race(1),,
7,0,0,0,0,0,0,0,0,0,0,0,0,0,0,0,0,17,17,0.0,M2019-02-27D,Race(1),,
8,0,2,3,5,5,3,5,13,0,1,6,7,5,6,14,25,7.5,7.5,0.0,M2019-02-27D,Race(1),,
9,2,0,0,2,0,1,1,2,0,0,0,0,2,1,1,4,17,17,0.0,M2019-02-27D,Race(1),,
10,0,3,0,3,0,0,0,0,0,0,0,0,0,3,0,3,14,14,0.0,M2019-02-27D,Race(1),,
11,0,0,0,0,0,0,0,0,1,0,0,1,1,0,0,1,126,126,0.0,M2019-02-27D,Race(1),,
12,0,0,0,0,0,0,0,0,0,0,1,1,0,0,1,1,13,13,0.0,M2019-02-27D,Race(1),,
1,2,0,2,4,11,6,7,24,12,4,4,20,25,10,13,48,5.5,5.5,0.0,M2019-02-27D,Race(2),,
2,3,0,4,7,0,7,2,9,1,8,2,11,4,15,8,27,5.5,5.5,2.0,M2019-02-27D,Race(2),,
3,2,4,8,14,2,0,2,4,1,0,3,4,5,4,13,22,9,9,0.0,M2019-02-27D,Race(2),,
4,3,3,0,6,0,0,3,3,0,3,3,6,3,6,6,15,12,12,0.0,M2019-02-27D,Race(2),,
5,7,12,4,23,11,9,6,26,9,7,3,19,27,28,13,68,4.4,4.5,3.0,M2019-02-27D,Race(2),,
6,0,0,0,0,0,0,0,0,0,0,0,0,0,0,0,0,81,81,0.0,M2019-02-27D,Race(2),,
7,0,0,0,0,0,0,0,0,0,0,0,0,0,0,0,0,26,26,0.0,M2019-02-27D,Race(2),,
8,0,0,0,0,0,0,0,0,0,0,0,0,0,0,0,0,14,14,0.0,M2019-02-27D,Race(2),,
9,3,4,6,13,0,7,3,10,0,0,5,5,3,11,14,28,9.5,9.5,1.0,M2019-02-27D,Race(2),,
10,10,7,6,23,7,7,8,22,3,4,6,13,20,18,20,58,3.7,3.7,0.0,M2019-02-27D,Race(2),,
1,0,5,9,14,6,9,6,21,3,9,3,15,9,23,18,50,16,16,0.0,M2019-02-27D,Race(3),,
2,0,0,0,0,0,0,0,0,0,0,0,0,0,0,0,0,34,34,0.0,M2019-02-27D,Race(3),,
3,5,3,4,12,13,4,5,22,13,4,4,21,31,11,13,55,6.5,6.5,0.0,M2019-02-27D,Race(3),,
4,0,0,0,0,0,0,1,1,0,0,0,0,0,0,1,1,31,31,0.0,M2019-02-27D,Race(3),,
5,3,2,3,8,0,1,1,2,1,0,2,3,4,3,6,13,6.5,6.5,1.0,M2019-02-27D,Race(3),,
6,5,8,3,16,2,2,2,6,2,0,4,6,9,10,9,28,5,5.5,0.0,M2019-02-27D,Race(3),,
7,0,2,0,2,0,0,0,0,0,0,0,0,0,2,0,2,41,41,0.0,M2019-02-27D,Race(3),,
8,3,3,2,8,0,0,0,0,0,1,0,1,3,4,2,9,21,21,3.0,M2019-02-27D,Race(3),,
9,0,0,0,0,2,1,1,4,1,0,0,1,3,1,1,5,31,31,0.0,M2019-02-27D,Race(3),,
10,2,0,0,2,0,2,2,4,1,1,3,5,3,3,5,11,12,12,0.0,M2019-02-27D,Race(3),,
11,8,3,3,14,8,10,7,25,4,8,3,15,20,21,13,54,3.6,3.6,2.0,M2019-02-27D,Race(3),,
12,4,4,6,14,0,2,6,8,1,3,7,11,5,9,19,33,5,5,0.0,M2019-02-27D,Race(3),,
1,11,5,3,19,8,9,7,24,6,7,5,18,25,21,15,61,4,4,0.0,M2019-02-27D,Race(4),,
2,0,3,10,13,0,2,0,2,4,1,2,7,4,6,12,22,6,6,3.0,M2019-02-27D,Race(4),,
3,0,0,5,5,1,3,7,11,1,4,6,11,2,7,18,27,34,35,0.0,M2019-02-27D,Race(4),,
4,6,5,5,16,3,9,9,21,2,6,5,13,11,20,19,50,5.5,5.5,0.0,M2019-02-27D,Race(4),,
5,0,0,0,0,0,0,0,0,0,1,0,1,0,1,0,1,71,67,0.0,M2019-02-27D,Race(4),,
6,11,7,5,23,18,6,4,28,13,7,4,24,42,20,13,75,3,3,1.0,M2019-02-27D,Race(4),,
7,0,0,2,2,0,0,0,0,0,0,2,2,0,0,4,4,51,51,0.0,M2019-02-27D,Race(4),,
8,0,0,0,0,0,0,1,1,0,0,2,2,0,0,3,3,12,12,0.0,M2019-02-27D,Race(4),,
9,0,5,0,5,0,1,1,2,0,0,0,0,0,6,1,7,14,14,0.0,M2019-02-27D,Race(4),,
10,0,5,0,5,0,0,0,0,0,0,0,0,0,5,0,5,13,13,2.0,M2019-02-27D,Race(4),,
11,2,0,0,2,0,0,0,0,0,0,0,0,2,0,0,2,31,31,0.0,M2019-02-27D,Race(4),,
12,0,0,0,0,0,0,0,0,0,0,0,0,0,0,0,0,51,51,0.0,M2019-02-27D,Race(4),,
1,0,0,0,0,0,0,0,0,0,0,0,0,0,0,0,0,41,41,0.0,M2019-02-27D,Race(5),,
2,10,10,7,27,15,6,6,27,12,4,4,20,37,20,17,74,3.5,3.5,3.0,M2019-02-27D,Race(5),,
3,0,0,0,0,0,1,3,4,0,4,2,6,0,5,5,10,21,21,0.0,M2019-02-27D,Race(5),,
4,3,0,0,3,0,0,0,0,1,0,1,2,4,0,1,5,13,13,2.0,M2019-02-27D,Race(5),,
5,5,7,8,20,9,8,13,30,8,9,6,23,22,24,27,73,4.2,4.2,1.0,M2019-02-27D,Race(5),,
6,2,7,0,9,1,4,3,8,1,5,8,14,4,16,11,31,6.5,6.5,0.0,M2019-02-27D,Race(5),,
7,0,3,4,7,0,3,0,3,1,0,1,2,1,6,5,12,13,13,0.0,M2019-02-27D,Race(5),,
8,0,0,0,0,0,0,0,0,0,0,0,0,0,0,0,0,51,51,0.0,M2019-02-27D,Race(5),,
9,10,0,3,13,5,6,5,16,3,0,4,7,18,6,12,36,5,5,0.0,M2019-02-27D,Race(5),,
10,0,0,3,3,0,0,0,0,0,0,0,0,0,0,3,3,31,31,0.0,M2019-02-27D,Race(5),,
11,0,3,2,5,1,1,1,3,0,2,0,2,1,6,3,10,17,17,0.0,M2019-02-27D,Race(5),,
12,0,0,3,3,0,2,0,2,0,2,0,2,0,4,3,7,16,16,0.0,M2019-02-27D,Race(5),,
1,0,3,0,3,2,0,1,3,2,1,1,4,4,4,2,10,13,13,0.0,M2019-02-27D,Race(6),,
2,3,0,2,5,1,6,2,9,1,6,2,9,5,12,6,23,15,15,3.0,M2019-02-27D,Race(6),,
3,0,5,0,5,1,0,0,1,2,0,1,3,3,5,1,9,14,14,1.0,M2019-02-27D,Race(6),,
4,5,5,2,12,6,5,9,20,3,1,8,12,14,11,19,44,7,7,0.0,M2019-02-27D,Race(6),,
5,0,2,5,7,1,1,5,7,0,4,3,7,1,7,13,21,8,8,0.0,M2019-02-27D,Race(6),,
6,5,0,8,13,1,1,2,4,1,3,3,7,7,4,13,24,18,18,0.0,M2019-02-27D,Race(6),,
7,7,13,7,27,13,11,5,29,14,7,3,24,34,31,15,80,2.4,2.4,2.0,M2019-02-27D,Race(6),,
8,0,0,0,0,0,0,0,0,0,0,0,0,0,0,0,0,31,31,0.0,M2019-02-27D,Race(6),,
9,10,2,6,18,5,5,5,15,3,4,4,11,18,11,15,44,4.4,4.5,0.0,M2019-02-27D,Race(6),,
10,0,0,0,0,0,0,0,0,0,0,0,0,0,0,0,0,34,35,0.0,M2019-02-27D,Race(6),,
11,0,0,0,0,0,0,0,0,0,0,1,1,0,0,1,1,61,61,0.0,M2019-02-27D,Race(6),,
12,0,0,0,0,0,0,0,0,0,0,0,0,0,0,0,0,41,41,0.0,M2019-02-27D,Race(6),,
1,13,4,10,27,18,6,4,28,17,6,2,25,48,16,16,80,2.5,2.5,2.0,M2019-02-27D,Race(7),,
2,0,2,0,2,0,0,1,1,0,1,2,3,0,3,3,6,26,26,0.0,M2019-02-27D,Race(7),,
3,4,8,5,17,1,3,3,7,2,3,3,8,7,14,11,32,7.5,7.5,0.0,M2019-02-27D,Race(7),,
4,7,9,5,21,8,11,10,29,5,7,8,20,20,27,23,70,5,5,1.0,M2019-02-27D,Race(7),,
5,0,0,0,0,0,0,0,0,0,1,0,1,0,1,0,1,31,31,0.0,M2019-02-27D,Race(7),,
6,0,0,5,5,4,7,7,18,2,3,6,11,6,10,18,34,7.5,7.5,0.0,M2019-02-27D,Race(7),,
7,0,4,3,7,0,0,3,3,0,0,2,2,0,4,8,12,17,17,0.0,M2019-02-27D,Race(7),,
8,0,0,0,0,0,0,0,0,0,0,1,1,0,0,1,1,71,67,0.0,M2019-02-27D,Race(7),,
9,6,0,2,8,0,1,2,3,0,1,0,1,6,2,4,12,10,10,0.0,M2019-02-27D,Race(7),,
10,0,0,0,0,0,0,0,0,0,0,1,1,0,0,1,1,21,21,0.0,M2019-02-27D,Race(7),,
11,0,3,0,3,0,3,1,4,0,4,1,5,0,10,2,12,10,10,0.0,M2019-02-27D,Race(7),,
12,0,0,0,0,0,0,0,0,0,0,0,0,0,0,0,0,81,81,3.0,M2019-02-27D,Race(7),,
1,0,0,3,3,0,1,2,3,0,0,1,1,0,1,6,7,19,19,1.0,M2019-02-27D,Race(8),,
2,19,3,6,28,16,7,4,27,17,2,4,23,52,12,14,78,2.8,2.8,2.0,M2019-02-27D,Race(8),,
3,0,0,0,0,0,0,0,0,0,0,0,0,0,0,0,0,21,21,0.0,M2019-02-27D,Race(8),,
4,0,4,3,7,0,2,1,3,0,5,0,5,0,11,4,15,12,12,0.0,M2019-02-27D,Race(8),,
5,0,3,0,3,0,0,0,0,0,0,0,0,0,3,0,3,41,41,0.0,M2019-02-27D,Race(8),,
6,2,3,2,7,1,1,3,5,0,2,4,6,3,6,9,18,7,7,0.0,M2019-02-27D,Race(8),,
7,0,0,0,0,0,1,0,1,1,0,1,2,1,1,1,3,17,17,0.0,M2019-02-27D,Race(8),,
8,0,3,0,3,0,1,0,1,0,2,0,2,0,6,0,6,19,19,0.0,M2019-02-27D,Race(8),,
9,0,3,6,9,1,4,3,8,3,5,6,14,4,12,15,31,8,8,0.0,M2019-02-27D,Race(8),,
10,0,2,5,7,1,1,0,2,1,2,0,3,2,5,5,12,16,16,0.0,M2019-02-27D,Race(8),,
11,6,0,2,8,6,6,11,23,2,4,5,11,14,10,18,42,11,11,0.0,M2019-02-27D,Race(8),,
12,3,9,3,15,6,7,7,20,2,4,5,11,11,20,15,46,5.5,5.5,3.0,M2019-02-27D,Race(8),,
1,0,0,0,0,0,0,0,0,0,0,0,0,0,0,0,0,71,67,0.0,M2019-03-02D,Race(1),,
2,10,0,2,12,3,4,5,12,1,3,2,6,14,7,9,30,7.5,7.5,0.0,M2019-03-02D,Race(1),,
3,12,9,9,30,15,3,2,20,16,3,3,22,43,15,14,72,2.4,2.4,0.0,M2019-03-02D,Race(1),,
4,3,10,0,13,1,6,3,10,4,5,1,10,8,21,4,33,7.5,7.5,0.0,M2019-03-02D,Race(1),,
5,0,0,7,7,0,8,4,12,0,0,3,3,0,8,14,22,13,13,1.0,M2019-03-02D,Race(1),,
6,0,0,2,2,1,1,0,2,0,0,0,0,1,1,2,4,41,34,0.0,M2019-03-02D,Race(1),,
7,2,0,0,2,0,0,0,0,0,0,0,0,2,0,0,2,51,51,0.0,M2019-03-02D,Race(1),,
8,0,8,2,10,2,4,3,9,4,5,6,15,6,17,11,34,7,7,0.0,M2019-03-02D,Race(1),,
9,0,0,0,0,8,0,1,9,0,0,1,1,8,0,2,10,15,15,2.0,M2019-03-02D,Race(1),,
10,0,0,0,0,0,0,0,0,0,0,0,0,0,0,0,0,41,41,0.0,M2019-03-02D,Race(1),,
11,0,0,0,0,0,0,0,0,0,0,0,0,0,0,0,0,151,201,0.0,M2019-03-02D,Race(1),,
12,0,0,0,0,0,0,0,0,0,0,0,0,0,0,0,0,151,151,0.0,M2019-03-02D,Race(1),,
13,3,3,8,14,0,4,4,8,1,5,5,11,4,12,17,33,7,7,3.0,M2019-03-02D,Race(1),,
14,0,0,0,0,0,0,8,8,0,0,2,2,0,0,10,10,15,15,0.0,M2019-03-02D,Race(1),,
1,4,7,5,16,0,4,9,13,0,3,5,8,4,14,19,37,11,11,0.0,M2019-03-02D,Race(10),,
2,19,5,0,24,13,1,6,20,19,3,1,23,51,9,7,67,2.6,2.6,1.0,M2019-03-02D,Race(10),,
3,0,0,0,0,8,0,0,8,0,0,0,0,8,0,0,8,81,81,0.0,M2019-03-02D,Race(10),,
4,0,0,0,0,1,0,0,1,3,0,0,3,4,0,0,4,17,17,0.0,M2019-03-02D,Race(10),,
5,3,11,5,19,7,9,4,20,1,14,5,20,11,34,14,59,3.8,3.8,0.0,M2019-03-02D,Race(10),,
6,4,0,9,13,0,9,4,13,0,3,6,9,4,12,19,35,12,12,0.0,M2019-03-02D,Race(10),,
7,0,0,2,2,0,0,0,0,0,0,0,0,0,0,2,2,41,41,0.0,M2019-03-02D,Race(10),,
8,0,7,7,14,1,3,7,11,3,1,8,12,4,11,22,37,5,5,3.0,M2019-03-02D,Race(10),,
9,0,0,2,2,0,4,0,4,0,2,0,2,0,6,2,8,41,41,0.0,M2019-03-02D,Race(10),,
10,0,0,0,0,0,0,0,0,0,0,1,1,0,0,1,1,61,61,0.0,M2019-03-02D,Race(10),,
11,0,0,0,0,0,0,0,0,0,0,0,0,0,0,0,0,31,31,2.0,M2019-03-02D,Race(10),,
12,0,0,0,0,0,0,0,0,0,0,0,0,0,0,0,0,41,41,0.0,M2019-03-02D,Race(10),,
13,0,0,0,0,0,0,0,0,0,0,0,0,0,0,0,0,21,21,0.0,M2019-03-02D,Race(10),,
14,0,0,0,0,0,0,0,0,0,0,0,0,0,0,0,0,61,61,0.0,M2019-03-02D,Race(10),,
1,14,11,2,27,14,2,10,26,10,6,2,18,38,19,14,71,3.1,3.1,0.0,M2019-03-02D,Race(2),,
2,3,8,5,16,2,3,4,9,2,6,3,11,7,17,12,36,5,5,0.0,M2019-03-02D,Race(2),,
3,2,0,5,7,0,4,4,8,0,0,5,5,2,4,14,20,12,12,3.0,M2019-03-02D,Race(2),,
4,0,0,0,0,0,0,0,0,0,0,0,0,0,0,0,0,81,81,0.0,M2019-03-02D,Race(2),,
5,2,0,5,7,2,8,2,12,4,1,2,7,8,9,9,26,8.5,8.5,0.0,M2019-03-02D,Race(2),,
6,0,0,0,0,0,0,0,0,0,0,0,0,0,0,0,0,34,35,0.0,M2019-03-02D,Race(2),,
7,9,6,8,23,4,7,6,17,8,8,3,19,21,21,17,59,3.6,3.6,0.0,M2019-03-02D,Race(2),,
8,0,0,0,0,0,0,0,0,0,0,0,0,0,0,0,0,71,67,0.0,M2019-03-02D,Race(2),,
9,0,5,0,5,0,4,4,8,1,2,10,13,1,11,14,26,10,10,1.0,M2019-03-02D,Race(2),,
10,0,0,3,3,8,2,0,10,1,3,0,4,9,5,3,17,17,17,0.0,M2019-03-02D,Race(2),,
11,0,0,0,0,0,0,0,0,0,0,0,0,0,0,0,0,23,23,2.0,M2019-03-02D,Race(2),,
12,0,0,2,2,0,0,0,0,0,0,1,1,0,0,3,3,51,51,0.0,M2019-03-02D,Race(2),,
1,0,0,0,0,1,0,0,1,0,0,0,0,1,0,0,1,18,17,0.0,M2019-03-02D,Race(3),,
2,9,11,2,22,12,7,1,20,16,6,1,23,37,24,4,65,2.8,2.8,0.0,M2019-03-02D,Race(3),,
3,0,2,0,2,1,1,2,4,0,0,1,1,1,3,3,7,23,21,0.0,M2019-03-02D,Race(3),,
4,0,0,0,0,0,0,0,0,0,0,0,0,0,0,0,0,101,101,0.0,M2019-03-02D,Race(3),,
5,0,3,0,3,1,2,5,8,2,1,3,6,3,6,8,17,11,13,0.0,M2019-03-02D,Race(3),,
6,7,0,0,7,8,2,0,10,1,1,2,4,16,3,2,21,7.5,7,2.0,M2019-03-02D,Race(3),,
7,0,0,2,2,2,1,8,11,0,1,1,2,2,2,11,15,18,17,3.0,M2019-03-02D,Race(3),,
8,5,0,0,5,0,1,2,3,0,2,1,3,5,3,3,11,19,18,0.0,M2019-03-02D,Race(3),,
9,2,8,8,18,0,0,6,6,0,4,10,14,2,12,24,38,5.5,5,0.0,M2019-03-02D,Race(3),,
10,0,0,0,0,0,0,0,0,0,0,0,0,0,0,0,0,151,201,0.0,M2019-03-02D,Race(3),,
11,0,0,3,3,0,8,0,8,0,0,1,1,0,8,4,12,19,19,0.0,M2019-03-02D,Race(3),,
12,7,6,15,28,5,8,6,19,7,11,6,24,19,25,27,71,5,6,0.0,M2019-03-02D,Race(3),,
13,0,0,0,0,0,0,0,0,0,0,0,0,0,0,0,0,81,67,1.0,M2019-03-02D,Race(3),,
14,0,0,0,0,0,0,0,0,0,0,0,0,0,0,0,0,41,34,0.0,M2019-03-02D,Race(3),,
1,5,5,2,12,1,8,8,17,4,8,7,19,10,21,17,48,5.5,5.5,0.0,M2019-03-02D,Race(4),,
2,0,0,0,0,0,0,0,0,0,0,0,0,0,0,0,0,81,81,0.0,M2019-03-02D,Race(4),,
3,0,0,0,0,2,3,1,6,0,1,2,3,2,4,3,9,14,14,0.0,M2019-03-02D,Race(4),,
4,0,0,0,0,0,0,0,0,1,0,1,2,1,0,1,2,81,81,0.0,M2019-03-02D,Race(4),,
5,15,9,6,30,15,6,0,21,15,9,1,25,45,24,7,76,2.7,2.7,1.0,M2019-03-02D,Race(4),,
6,0,0,0,0,0,0,0,0,0,0,0,0,0,0,0,0,71,67,0.0,M2019-03-02D,Race(4),,
7,5,8,6,19,3,3,7,13,4,4,6,14,12,15,19,46,4,4,3.0,M2019-03-02D,Race(4),,
8,0,2,2,4,0,0,8,8,0,0,2,2,0,2,12,14,34,35,0.0,M2019-03-02D,Race(4),,
9,0,0,3,3,0,8,0,8,0,1,0,1,0,9,3,12,17,17,0.0,M2019-03-02D,Race(4),,
10,0,0,0,0,0,0,0,0,0,0,0,0,0,0,0,0,101,101,0.0,M2019-03-02D,Race(4),,
11,0,2,8,10,8,0,2,10,1,0,2,3,9,2,12,23,11,11,0.0,M2019-03-02D,Race(4),,
12,0,0,0,0,0,0,0,0,0,0,0,0,0,0,0,0,91,81,0.0,M2019-03-02D,Race(4),,
13,0,0,0,0,0,0,0,0,0,0,0,0,0,0,0,0,91,91,2.0,M2019-03-02D,Race(4),,
14,5,4,3,12,1,2,4,7,1,3,5,9,7,9,12,28,6.5,6.5,0.0,M2019-03-02D,Race(4),,
1,15,10,2,27,13,4,2,19,16,5,3,24,44,19,7,70,2.2,2.2,0.0,M2019-03-02D,Race(5),,
2,0,0,0,0,0,0,0,0,0,0,0,0,0,0,0,0,51,51,0.0,M2019-03-02D,Race(5),,
3,6,10,10,26,7,8,5,20,8,8,6,22,21,26,21,68,5,5,2.0,M2019-03-02D,Race(5),,
4,0,3,10,13,8,2,6,16,0,3,7,10,8,8,23,39,7,7,0.0,M2019-03-02D,Race(5),,
5,7,3,5,15,2,8,6,16,2,9,3,14,11,20,14,45,4.6,4.6,0.0,M2019-03-02D,Race(5),,
6,0,0,0,0,0,0,0,0,0,0,0,0,0,0,0,0,71,67,1.0,M2019-03-02D,Race(5),,
7,0,0,0,0,0,0,8,8,0,0,1,1,0,0,9,9,61,61,0.0,M2019-03-02D,Race(5),,
8,0,2,0,2,0,0,0,0,0,0,2,2,0,2,2,4,15,15,0.0,M2019-03-02D,Race(5),,
9,0,0,0,0,0,0,0,0,0,0,0,0,0,0,0,0,81,81,0.0,M2019-03-02D,Race(5),,
10,2,2,3,7,0,8,3,11,0,1,4,5,2,11,10,23,13,13,3.0,M2019-03-02D,Race(5),,
11,0,0,0,0,0,0,0,0,0,0,0,0,0,0,0,0,41,41,0.0,M2019-03-02D,Race(5),,
12,0,0,0,0,0,0,0,0,0,0,0,0,0,0,0,0,31,31,0.0,M2019-03-02D,Race(5),,
1,3,0,8,11,1,11,5,17,2,6,4,12,6,17,17,40,7.5,7.5,3.0,M2019-03-02D,Race(6),,
2,0,0,0,0,0,0,0,0,0,0,0,0,0,0,0,0,51,51,0.0,M2019-03-02D,Race(6),,
3,3,15,9,27,0,0,3,3,1,5,7,13,4,20,19,43,6.5,6.5,0.0,M2019-03-02D,Race(6),,
4,12,9,0,21,21,2,0,23,21,2,1,24,54,13,1,68,3,3,0.0,M2019-03-02D,Race(6),,
5,2,0,0,2,0,0,3,3,1,0,1,2,3,0,4,7,11,11,2.0,M2019-03-02D,Race(6),,
6,0,0,0,0,0,0,0,0,0,0,0,0,0,0,0,0,101,101,0.0,M2019-03-02D,Race(6),,
7,0,0,0,0,0,0,0,0,0,1,0,1,0,1,0,1,41,41,0.0,M2019-03-02D,Race(6),,
8,0,3,3,6,0,4,5,9,0,6,3,9,0,13,11,24,9,9,0.0,M2019-03-02D,Race(6),,
9,0,0,0,0,0,0,0,0,0,2,1,3,0,2,1,3,34,34,0.0,M2019-03-02D,Race(6),,
10,0,0,10,10,8,1,5,14,1,0,7,8,9,1,22,32,6,6,0.0,M2019-03-02D,Race(6),,
11,5,3,0,8,0,4,8,12,0,3,0,3,5,10,8,23,6.5,6.5,0.0,M2019-03-02D,Race(6),,
12,5,0,0,5,0,8,1,9,0,1,2,3,5,9,3,17,19,19,1.0,M2019-03-02D,Race(6),,
1,3,5,2,10,2,0,0,2,4,1,0,5,9,6,2,17,9,9,2.0,M2019-03-02D,Race(7),,
2,0,0,0,0,0,0,0,0,0,0,0,0,0,0,0,0,31,31,0.0,M2019-03-02D,Race(7),,
3,14,0,6,20,11,6,5,22,13,9,2,24,38,15,13,66,2.6,2.6,0.0,M2019-03-02D,Race(7),,
4,0,0,0,0,0,0,0,0,0,0,0,0,0,0,0,0,81,81,0.0,M2019-03-02D,Race(7),,
5,0,0,2,2,8,0,0,8,2,0,0,2,10,0,2,12,41,41,0.0,M2019-03-02D,Race(7),,
6,0,0,0,0,0,0,0,0,0,0,0,0,0,0,0,0,81,81,0.0,M2019-03-02D,Race(7),,
7,0,0,0,0,0,0,0,0,0,0,0,0,0,0,0,0,81,81,0.0,M2019-03-02D,Race(7),,
8,5,9,0,14,2,6,5,13,2,3,5,10,9,18,10,37,6.5,6.5,1.0,M2019-03-02D,Race(7),,
9,0,0,0,0,0,0,0,0,0,0,1,1,0,0,1,1,126,126,0.0,M2019-03-02D,Race(7),,
10,3,7,14,24,3,9,5,17,1,6,5,12,7,22,24,53,6,6,0.0,M2019-03-02D,Race(7),,
11,5,9,2,16,4,8,5,17,4,3,12,19,13,20,19,52,3.4,3.4,3.0,M2019-03-02D,Race(7),,
12,0,0,4,4,0,1,10,11,0,4,1,5,0,5,15,20,15,15,0.0,M2019-03-02D,Race(7),,
1,0,0,2,2,1,0,0,1,0,0,0,0,1,0,2,3,41,41,0.0,M2019-03-02D,Race(8),,
2,19,8,3,30,14,8,1,23,19,4,1,24,52,20,5,77,3,3,1.0,M2019-03-02D,Race(8),,
3,0,0,0,0,0,0,0,0,0,0,0,0,0,0,0,0,101,101,0.0,M2019-03-02D,Race(8),,
4,0,0,0,0,0,0,2,2,1,1,1,3,1,1,3,5,14,14,0.0,M2019-03-02D,Race(8),,
5,0,0,0,0,0,0,0,0,0,2,0,2,0,2,0,2,81,81,0.0,M2019-03-02D,Race(8),,
6,0,0,0,0,0,0,0,0,0,0,0,0,0,0,0,0,71,67,0.0,M2019-03-02D,Race(8),,
7,0,0,0,0,0,0,0,0,0,0,1,1,0,0,1,1,41,41,0.0,M2019-03-02D,Race(8),,
8,0,5,0,5,1,8,7,16,0,4,7,11,1,17,14,32,13,13,0.0,M2019-03-02D,Race(8),,
9,0,3,7,10,8,0,2,10,0,0,4,4,8,3,13,24,15,15,0.0,M2019-03-02D,Race(8),,
10,8,5,10,23,5,5,6,16,4,7,6,17,17,17,22,56,4.6,4.5,3.0,M2019-03-02D,Race(8),,
11,0,0,3,3,0,0,0,0,0,0,0,0,0,0,3,3,12,12,0.0,M2019-03-02D,Race(8),,
12,0,9,0,9,1,8,4,13,2,7,5,14,3,24,9,36,5.5,5.5,0.0,M2019-03-02D,Race(8),,
13,0,0,0,0,0,0,0,0,0,0,0,0,0,0,0,0,41,41,0.0,M2019-03-02D,Race(8),,
14,3,0,5,8,0,0,8,8,0,1,1,2,3,1,14,18,7.5,7.5,2.0,M2019-03-02D,Race(8),,
1,21,7,2,30,11,9,1,21,16,6,0,22,48,22,3,73,2.25,2.4,1.0,M2019-03-02D,Race(9),,
2,7,16,3,26,10,9,4,23,8,15,3,26,25,40,10,75,4.8,4.8,3.0,M2019-03-02D,Race(9),,
3,2,0,0,2,0,0,8,8,0,1,0,1,2,1,8,11,16,16,0.0,M2019-03-02D,Race(9),,
4,0,2,0,2,0,0,0,0,0,0,2,2,0,2,2,4,34,35,0.0,M2019-03-02D,Race(9),,
5,0,0,2,2,1,0,0,1,1,0,0,1,2,0,2,4,14,14,2.0,M2019-03-02D,Race(9),,
6,0,5,8,13,0,1,12,13,1,1,8,10,1,7,28,36,8.5,8.5,0.0,M2019-03-02D,Race(9),,
7,0,0,13,13,8,3,5,16,0,1,11,12,8,4,29,41,9,9,0.0,M2019-03-02D,Race(9),,
8,0,0,0,0,0,8,0,8,0,2,1,3,0,10,1,11,11,11,0.0,M2019-03-02D,Race(9),,
9,0,0,0,0,0,0,0,0,0,0,0,0,0,0,0,0,21,21,0.0,M2019-03-02D,Race(9),,
10,0,0,0,0,0,0,0,0,0,0,0,0,0,0,0,0,31,31,0.0,M2019-03-02D,Race(9),,
11,0,0,0,0,0,0,0,0,0,0,1,1,0,0,1,1,34,35,0.0,M2019-03-02D,Race(9),,
12,0,0,2,2,0,0,0,0,0,0,0,0,0,0,2,2,16,16,0.0,M2019-03-02D,Race(9),,
1,3,6,5,14,3,12,6,21,2,6,3,11,8,24,14,46,7.5,7.5,3.0,M2019-03-06D,Race(1),,
2,18,7,5,30,20,5,5,30,12,6,4,22,50,18,14,82,2.4,2.4,2.0,M2019-03-06D,Race(1),,
3,0,7,6,13,5,7,6,18,6,6,2,14,11,20,14,45,8,8,0.0,M2019-03-06D,Race(1),,
4,0,0,0,0,0,1,0,1,1,0,1,2,1,1,1,3,41,41,0.0,M2019-03-06D,Race(1),,
5,0,2,4,6,0,1,4,5,1,3,6,10,1,6,14,21,7.5,7.5,0.0,M2019-03-06D,Race(1),,
6,0,0,2,2,0,0,0,0,0,0,0,0,0,0,2,2,26,26,0.0,M2019-03-06D,Race(1),,
7,0,0,0,0,1,0,2,3,1,0,0,1,2,0,2,4,18,18,1.0,M2019-03-06D,Race(1),,
8,0,0,0,0,0,0,0,0,0,0,0,0,0,0,0,0,71,67,0.0,M2019-03-06D,Race(1),,
9,3,2,0,5,0,0,2,2,1,0,3,4,4,2,5,11,9,9,0.0,M2019-03-06D,Race(1),,
10,4,6,3,13,1,3,4,8,2,4,4,10,7,13,11,31,8,8,4.0,M2019-03-06D,Race(1),,
11,2,0,5,7,0,1,1,2,0,1,3,4,2,2,9,13,13,13,0.0,M2019-03-06D,Race(1),,
12,0,0,0,0,0,0,0,0,0,0,0,0,0,0,0,0,41,41,0.0,M2019-03-06D,Race(1),,
1,2,6,2,10,2,2,1,5,1,1,4,6,5,9,7,21,14,14,0.0,M2019-03-06D,Race(2),,
2,11,12,2,25,15,8,7,30,17,3,6,26,43,23,15,81,3.8,3.8,0.0,M2019-03-06D,Race(2),,
3,3,0,0,3,3,7,6,16,1,7,2,10,7,14,8,29,11,11,0.0,M2019-03-06D,Race(2),,
4,2,2,13,17,3,7,6,16,2,3,2,7,7,12,21,40,6,6,1.0,M2019-03-06D,Race(2),,
5,2,0,0,2,0,0,0,0,0,0,0,0,2,0,0,2,26,26,0.0,M2019-03-06D,Race(2),,
6,0,0,3,3,0,1,1,2,1,1,0,2,1,2,4,7,17,17,0.0,M2019-03-06D,Race(2),,
7,0,0,0,0,0,0,0,0,0,0,0,0,0,0,0,0,41,41,0.0,M2019-03-06D,Race(2),,
8,0,0,0,0,0,0,0,0,0,0,0,0,0,0,0,0,71,67,0.0,M2019-03-06D,Race(2),,
9,10,8,10,28,6,3,8,17,2,9,9,20,18,20,27,65,2.8,2.8,2.0,M2019-03-06D,Race(2),,
10,0,0,0,0,1,2,1,4,2,1,2,5,3,3,3,9,15,15,0.0,M2019-03-06D,Race(2),,
11,0,2,0,2,0,0,0,0,0,0,1,1,0,2,1,3,18,18,3.0,M2019-03-06D,Race(2),,
12,0,0,0,0,0,0,0,0,0,1,0,1,0,1,0,1,14,14,0.0,M2019-03-06D,Race(2),,
1,9,8,5,22,9,9,9,27,8,8,2,18,26,25,16,67,4,4,0.0,M2019-03-06D,Race(3),,
2,4,6,0,10,7,7,6,20,3,1,7,11,14,14,13,41,7.5,7.5,0.0,M2019-03-06D,Race(3),,
3,0,0,0,0,0,0,0,0,0,0,0,0,0,0,0,0,41,41,0.0,M2019-03-06D,Race(3),,
4,0,5,2,7,7,5,6,18,5,7,2,14,12,17,10,39,6.5,6.5,0.0,M2019-03-06D,Race(3),,
5,2,0,0,2,1,0,1,2,0,0,1,1,3,0,2,5,31,31,0.0,M2019-03-06D,Race(3),,
6,2,4,5,11,2,3,3,8,1,1,2,4,5,8,10,23,12,12,0.0,M2019-03-06D,Race(3),,
7,0,0,0,0,0,1,0,1,0,0,1,1,0,1,1,2,31,31,0.0,M2019-03-06D,Race(3),,
8,0,0,0,0,0,0,1,1,0,0,2,2,0,0,3,3,21,21,3.0,M2019-03-06D,Race(3),,
9,8,2,2,12,2,3,2,7,5,4,5,14,15,9,9,33,3.8,3.8,1.0,M2019-03-06D,Race(3),,
10,5,3,6,14,0,1,0,1,3,3,0,6,8,7,6,21,14,14,0.0,M2019-03-06D,Race(3),,
11,0,0,0,0,0,0,0,0,0,0,1,1,0,0,1,1,41,41,0.0,M2019-03-06D,Race(3),,
12,0,2,10,12,2,1,2,5,1,2,3,6,3,5,15,23,6,6,2.0,M2019-03-06D,Race(3),,
1,0,0,3,3,1,2,2,5,0,1,3,4,1,3,8,12,15,15,0.0,M2019-03-06D,Race(4),,
2,0,0,2,2,1,0,0,1,2,1,1,4,3,1,3,7,18,18,0.0,M2019-03-06D,Race(4),,
3,0,0,0,0,5,4,8,17,2,0,6,8,7,4,14,25,12,12,0.0,M2019-03-06D,Race(4),,
4,18,9,3,30,15,7,5,27,12,7,5,24,45,23,13,81,2.3,2.3,3.0,M2019-03-06D,Race(4),,
5,2,9,7,18,8,11,7,26,8,11,3,22,18,31,17,66,5,5,2.0,M2019-03-06D,Race(4),,
6,8,6,3,17,0,0,3,3,0,0,4,4,8,6,10,24,13,13,1.0,M2019-03-06D,Race(4),,
7,0,0,0,0,0,0,0,0,0,1,0,1,0,1,0,1,61,61,0.0,M2019-03-06D,Race(4),,
8,2,3,2,7,0,5,0,5,1,1,1,3,3,9,3,15,9,9,0.0,M2019-03-06D,Race(4),,
9,0,0,0,0,0,0,0,0,0,0,0,0,0,0,0,0,41,41,0.0,M2019-03-06D,Race(4),,
10,0,0,0,0,0,0,0,0,0,0,0,0,0,0,0,0,21,21,0.0,M2019-03-06D,Race(4),,
11,0,3,8,11,0,1,5,6,1,4,3,8,1,8,16,25,10,10,0.0,M2019-03-06D,Race(4),,
12,0,0,2,2,0,0,0,0,0,0,0,0,0,0,2,2,16,16,0.0,M2019-03-06D,Race(4),,
1,0,0,0,0,0,0,0,0,0,0,0,0,0,0,0,0,17,17,0.0,M2019-03-06D,Race(5),,
2,0,0,0,0,0,0,1,1,0,0,1,1,0,0,2,2,34,35,0.0,M2019-03-06D,Race(5),,
3,11,13,4,28,17,10,4,31,14,8,1,23,42,31,9,82,2.2,2.2,2.0,M2019-03-06D,Race(5),,
4,3,5,6,14,1,2,2,5,2,8,7,17,6,15,15,36,9.5,9.5,0.0,M2019-03-06D,Race(5),,
5,0,5,12,17,7,8,9,24,8,5,5,18,15,18,26,59,8.5,8.5,0.0,M2019-03-06D,Race(5),,
6,0,0,3,3,0,1,2,3,0,2,2,4,0,3,7,10,12,12,0.0,M2019-03-06D,Race(5),,
7,8,0,5,13,1,3,3,7,0,2,3,5,9,5,11,25,8,8,1.0,M2019-03-06D,Race(5),,
8,2,2,0,4,3,5,8,16,1,0,3,4,6,7,11,24,11,11,3.0,M2019-03-06D,Race(5),,
9,6,3,0,9,0,1,0,1,0,1,2,3,6,5,2,13,11,11,0.0,M2019-03-06D,Race(5),,
10,0,2,0,2,1,0,0,1,0,0,0,0,1,2,0,3,26,26,0.0,M2019-03-06D,Race(5),,
11,0,0,0,0,0,0,1,1,1,0,2,3,1,0,3,4,21,21,0.0,M2019-03-06D,Race(5),,
12,0,0,0,0,0,0,0,0,0,0,0,0,0,0,0,0,26,26,0.0,M2019-03-06D,Race(5),,
1,0,4,7,11,2,0,0,2,0,0,1,1,2,4,8,14,11,11,3.0,M2019-03-06D,Race(6),,
2,14,11,0,25,10,8,6,24,13,6,4,23,37,25,10,72,5,5,0.0,M2019-03-06D,Race(6),,
3,0,0,0,0,0,0,2,2,0,0,2,2,0,0,4,4,14,14,0.0,M2019-03-06D,Race(6),,
4,14,3,4,21,12,8,6,26,8,9,2,19,34,20,12,66,3,3,1.0,M2019-03-06D,Race(6),,
5,0,3,0,3,0,0,0,0,0,0,0,0,0,3,0,3,41,41,0.0,M2019-03-06D,Race(6),,
6,0,4,9,13,1,3,4,8,1,1,3,5,2,8,16,26,7.5,7.5,0.0,M2019-03-06D,Race(6),,
7,0,3,3,6,0,1,0,1,0,0,2,2,0,4,5,9,21,21,0.0,M2019-03-06D,Race(6),,
8,0,0,0,0,0,0,0,0,0,0,0,0,0,0,0,0,21,21,0.0,M2019-03-06D,Race(6),,
9,2,2,4,8,5,10,7,22,3,10,6,19,10,22,17,49,6,6,2.0,M2019-03-06D,Race(6),,
10,0,0,0,0,0,0,0,0,0,0,0,0,0,0,0,0,41,41,0.0,M2019-03-06D,Race(6),,
11,0,0,0,0,0,0,3,3,0,0,2,2,0,0,5,5,13,13,0.0,M2019-03-06D,Race(6),,
12,0,0,3,3,0,0,2,2,1,0,4,5,1,0,9,10,16,16,0.0,M2019-03-06D,Race(6),,
1,0,0,0,0,0,0,0,0,1,0,0,1,1,0,0,1,26,26,1.0,M2019-03-06D,Race(7),,
2,0,0,3,3,1,1,1,3,0,0,0,0,1,1,4,6,11,11,0.0,M2019-03-06D,Race(7),,
3,0,3,0,3,0,0,0,0,1,0,0,1,1,3,0,4,34,34,0.0,M2019-03-06D,Race(7),,
4,8,7,7,22,11,10,5,26,9,4,6,19,28,21,18,67,3.7,3.7,0.0,M2019-03-06D,Race(7),,
5,0,0,5,5,0,1,0,1,0,2,1,3,0,3,6,9,10,10,2.0,M2019-03-06D,Race(7),,
6,5,0,0,5,2,4,3,9,2,5,3,10,9,9,6,24,12,12,0.0,M2019-03-06D,Race(7),,
7,7,10,7,24,7,7,8,22,8,7,5,20,22,24,20,66,4.2,4.2,3.0,M2019-03-06D,Race(7),,
8,0,3,3,6,5,5,3,13,2,2,2,6,7,10,8,25,13,13,0.0,M2019-03-06D,Race(7),,
9,0,0,0,0,1,1,5,7,1,1,6,8,2,2,11,15,10,10,0.0,M2019-03-06D,Race(7),,
10,8,5,5,18,3,1,5,9,2,5,3,10,13,11,13,37,5,5,0.0,M2019-03-06D,Race(7),,
11,2,2,0,4,0,0,0,0,0,0,0,0,2,2,0,4,34,34,0.0,M2019-03-06D,Race(7),,
12,0,0,0,0,0,0,0,0,0,0,0,0,0,0,0,0,51,51,0.0,M2019-03-06D,Race(7),,
1,11,7,3,21,13,8,8,29,14,6,2,22,38,21,13,72,3.5,3.5,0.0,M2019-03-06D,Race(8),,
2,0,3,0,3,1,1,7,9,1,1,8,10,2,5,15,22,18,18,0.0,M2019-03-06D,Race(8),,
3,0,5,4,9,1,4,0,5,3,1,0,4,4,10,4,18,6.5,6.5,2.0,M2019-03-06D,Race(8),,
4,4,7,8,19,6,5,10,21,5,9,6,20,15,21,24,60,3.6,3.6,0.0,M2019-03-06D,Race(8),,
5,2,0,0,2,0,0,0,0,0,0,0,0,2,0,0,2,21,21,0.0,M2019-03-06D,Race(8),,
6,5,3,11,19,6,8,3,17,0,6,2,8,11,17,16,44,8.5,8.5,0.0,M2019-03-06D,Race(8),,
7,0,2,0,2,1,1,1,3,0,3,6,9,1,6,7,14,12,12,0.0,M2019-03-06D,Race(8),,
8,2,0,0,2,0,0,0,0,0,0,0,0,2,0,0,2,51,51,0.0,M2019-03-06D,Race(8),,
9,0,0,0,0,0,0,0,0,0,0,0,0,0,0,0,0,34,35,3.0,M2019-03-06D,Race(8),,
10,0,0,0,0,1,0,0,1,0,0,1,1,1,0,1,2,26,26,1.0,M2019-03-06D,Race(8),,
11,0,0,2,2,0,1,0,1,0,0,1,1,0,1,3,4,18,18,0.0,M2019-03-06D,Race(8),,
12,6,3,2,11,1,2,1,4,3,0,0,3,10,5,3,18,8.5,8.5,0.0,M2019-03-06D,Race(8),,
1,2,11,9,22,10,13,8,31,5,10,8,23,17,34,25,76,7,7,0.0,M2019-03-10D,Race(1),,
2,19,8,3,30,16,7,9,32,17,9,0,26,52,24,12,88,1.6,1.6,1.0,M2019-03-10D,Race(1),,
3,0,2,10,12,0,0,3,3,0,2,7,9,0,4,20,24,12,12,0.0,M2019-03-10D,Race(1),,
4,9,9,8,26,4,10,10,24,4,5,5,14,17,24,23,64,3.1,3.1,2.0,M2019-03-10D,Race(1),,
1,6,0,0,6,1,8,2,11,1,0,1,2,8,8,3,19,6.5,6.5,0.0,M2019-03-10D,Race(10),,
2,6,12,7,25,5,3,4,12,5,4,5,14,16,19,16,51,5,5,0.0,M2019-03-10D,Race(10),,
3,7,3,7,17,2,8,6,16,4,8,6,18,13,19,19,51,8.5,8.5,0.0,M2019-03-10D,Race(10),,
4,0,0,0,0,8,2,4,14,0,5,6,11,8,7,10,25,17,17,0.0,M2019-03-10D,Race(10),,
5,0,0,0,0,0,0,0,0,0,0,0,0,0,0,0,0,15,15,0.0,M2019-03-10D,Race(10),,
6,4,13,8,25,13,4,4,21,15,4,5,24,32,21,17,70,3.1,3.1,1.0,M2019-03-10D,Race(10),,
7,0,0,0,0,0,0,0,0,0,0,0,0,0,0,0,0,51,51,0.0,M2019-03-10D,Race(10),,
8,0,0,0,0,0,0,0,0,0,0,1,1,0,0,1,1,26,26,3.0,M2019-03-10D,Race(10),,
9,0,0,0,0,0,0,0,0,0,0,0,0,0,0,0,0,81,81,0.0,M2019-03-10D,Race(10),,
10,0,0,0,0,0,0,0,0,0,0,0,0,0,0,0,0,31,31,0.0,M2019-03-10D,Race(10),,
11,7,2,8,17,1,5,10,16,1,5,2,8,9,12,20,41,4.6,4.6,2.0,M2019-03-10D,Race(10),,
12,0,0,0,0,0,0,0,0,0,0,0,0,0,0,0,0,26,26,0.0,M2019-03-10D,Race(10),,
1,0,2,5,7,3,5,5,13,3,4,3,10,6,11,13,30,13,13,0.0,M2019-03-10D,Race(11),,
2,5,0,2,7,0,0,3,3,1,0,3,4,6,0,8,14,10,10,0.0,M2019-03-10D,Race(11),,
3,0,0,0,0,0,8,1,9,1,3,2,6,1,11,3,15,19,19,0.0,M2019-03-10D,Race(11),,
4,0,0,0,0,0,0,0,0,0,0,0,0,0,0,0,0,31,31,0.0,M2019-03-10D,Race(11),,
5,2,8,6,16,1,9,5,15,1,9,6,16,4,26,17,47,5.5,5.5,2.0,M2019-03-10D,Race(11),,
6,13,12,5,30,17,3,2,22,17,3,2,22,47,18,9,74,4,4,0.0,M2019-03-10D,Race(11),,
7,0,0,0,0,0,0,0,0,0,0,0,0,0,0,0,0,81,81,0.0,M2019-03-10D,Race(11),,
8,0,0,0,0,0,0,0,0,0,0,1,1,0,0,1,1,16,16,3.0,M2019-03-10D,Race(11),,
9,0,3,2,5,0,1,1,2,0,2,2,4,0,6,5,11,9,9,1.0,M2019-03-10D,Race(11),,
10,2,0,0,2,0,0,0,0,0,0,0,0,2,0,0,2,17,17,0.0,M2019-03-10D,Race(11),,
11,0,0,3,3,0,0,0,0,0,1,0,1,0,1,3,4,17,17,0.0,M2019-03-10D,Race(11),,
12,0,0,0,0,0,0,8,8,0,0,2,2,0,0,10,10,11,11,0.0,M2019-03-10D,Race(11),,
13,5,5,2,12,8,2,1,11,2,0,2,4,15,7,5,27,10,10,0.0,M2019-03-10D,Race(11),,
14,3,0,5,8,1,2,4,7,1,4,3,8,5,6,12,23,11,11,0.0,M2019-03-10D,Race(11),,
1,0,5,2,7,0,1,8,9,0,1,4,5,0,7,14,21,17,17,0.0,M2019-03-10D,Race(2),,
2,5,11,3,19,6,10,6,22,7,8,7,22,18,29,16,63,4.6,4.6,0.0,M2019-03-10D,Race(2),,
3,2,0,3,5,0,8,2,10,3,1,2,6,5,9,7,21,11,11,0.0,M2019-03-10D,Race(2),,
4,7,2,5,14,3,4,8,15,1,6,7,14,11,12,20,43,4.6,4.6,2.0,M2019-03-10D,Race(2),,
5,3,0,0,3,7,0,0,7,0,0,0,0,10,0,0,10,13,13,0.0,M2019-03-10D,Race(2),,
6,0,0,0,0,0,0,0,0,0,0,0,0,0,0,0,0,51,51,0.0,M2019-03-10D,Race(2),,
7,0,6,5,11,0,0,0,0,0,1,0,1,0,7,5,12,8,8,1.0,M2019-03-10D,Race(2),,
8,13,6,7,26,14,6,3,23,14,9,0,23,41,21,10,72,3.5,3.5,0.0,M2019-03-10D,Race(2),,
9,0,0,2,2,0,0,0,0,0,0,2,2,0,0,4,4,21,21,0.0,M2019-03-10D,Race(2),,
10,0,0,0,0,0,0,0,0,0,0,0,0,0,0,0,0,41,41,0.0,M2019-03-10D,Race(2),,
11,0,0,3,3,0,1,3,4,1,0,4,5,1,1,10,12,9,9,3.0,M2019-03-10D,Race(2),,
1,3,0,7,10,9,4,5,18,2,2,7,11,14,6,19,39,9,9,0.0,M2019-03-10D,Race(3),,
2,2,20,8,30,8,9,4,21,8,9,4,21,18,38,16,72,3.5,3.5,2.0,M2019-03-10D,Race(3),,
3,22,5,3,30,11,7,3,21,13,8,4,25,46,20,10,76,2.6,2.6,0.0,M2019-03-10D,Race(3),,
4,0,0,0,0,0,0,0,0,0,1,0,1,0,1,0,1,21,21,0.0,M2019-03-10D,Race(3),,
5,0,3,0,3,0,0,8,8,1,0,1,2,1,3,9,13,12,12,0.0,M2019-03-10D,Race(3),,
6,0,0,0,0,0,0,0,0,0,0,0,0,0,0,0,0,21,21,0.0,M2019-03-10D,Race(3),,
7,0,0,0,0,0,0,0,0,0,0,0,0,0,0,0,0,41,41,0.0,M2019-03-10D,Race(3),,
8,0,0,0,0,0,0,0,0,0,2,0,2,0,2,0,2,26,26,0.0,M2019-03-10D,Race(3),,
9,0,2,0,2,0,0,0,0,0,0,0,0,0,2,0,2,21,21,1.0,M2019-03-10D,Race(3),,
10,3,0,12,15,2,10,10,22,2,4,10,16,7,14,32,53,5.5,5.5,3.0,M2019-03-10D,Race(3),,
11,0,0,0,0,0,0,0,0,0,0,0,0,0,0,0,0,34,41,0.0,M2019-03-10D,Race(3),,
1,2,7,5,14,4,9,6,19,2,9,8,19,8,25,19,52,6,6,2.0,M2019-03-10D,Race(4),,
2,0,5,2,7,0,2,10,12,0,1,1,2,0,8,13,21,13,13,1.0,M2019-03-10D,Race(4),,
3,0,0,0,0,0,0,0,0,0,0,0,0,0,0,0,0,51,51,0.0,M2019-03-10D,Race(4),,
4,0,0,0,0,0,8,0,8,1,1,2,4,1,9,2,12,18,18,0.0,M2019-03-10D,Race(4),,
5,0,0,4,4,0,1,0,1,1,0,2,3,1,1,6,8,6.5,6.5,3.0,M2019-03-10D,Race(4),,
6,0,0,0,0,0,0,0,0,0,0,0,0,0,0,0,0,61,61,0.0,M2019-03-10D,Race(4),,
7,6,13,4,23,4,4,6,14,2,5,7,14,12,22,17,51,11,11,0.0,M2019-03-10D,Race(4),,
8,2,0,6,8,0,1,0,1,0,0,0,0,2,1,6,9,17,17,0.0,M2019-03-10D,Race(4),,
9,20,5,3,28,14,3,5,22,18,5,2,25,52,13,10,75,2.3,2.3,0.0,M2019-03-10D,Race(4),,
10,0,0,0,0,0,0,0,0,0,1,0,1,0,1,0,1,41,41,0.0,M2019-03-10D,Race(4),,
11,0,0,0,0,0,0,0,0,0,0,0,0,0,0,0,0,18,18,0.0,M2019-03-10D,Race(4),,
12,0,0,6,6,8,2,3,13,2,4,4,10,10,6,13,29,8,8,0.0,M2019-03-10D,Race(4),,
1,3,0,0,3,0,0,0,0,0,0,0,0,3,0,0,3,31,31,0.0,M2019-03-10D,Race(5),,
2,0,0,0,0,0,0,0,0,0,0,0,0,0,0,0,0,0,0,0.0,M2019-03-10D,Race(5),,
3,0,0,0,0,0,0,8,8,0,1,0,1,0,1,8,9,7,7,0.0,M2019-03-10D,Race(5),,
4,0,0,0,0,0,0,0,0,0,0,0,0,0,0,0,0,0,0,0.0,M2019-03-10D,Race(5),,
5,0,3,4,7,0,8,4,12,0,1,2,3,0,12,10,22,6.5,6.5,0.0,M2019-03-10D,Race(5),,
6,0,2,9,11,0,5,0,5,0,1,3,4,0,8,12,20,10,10,3.0,M2019-03-10D,Race(5),,
7,0,0,3,3,0,0,0,0,0,0,1,1,0,0,4,4,21,21,0.0,M2019-03-10D,Race(5),,
8,0,2,3,5,0,0,0,0,0,0,0,0,0,2,3,5,21,21,0.0,M2019-03-10D,Race(5),,
9,4,0,0,4,8,1,0,9,0,0,0,0,12,1,0,13,19,19,0.0,M2019-03-10D,Race(5),,
10,0,0,2,2,0,0,0,0,0,0,0,0,0,0,2,2,21,21,0.0,M2019-03-10D,Race(5),,
11,0,3,3,6,0,0,0,0,0,0,0,0,0,3,3,6,21,21,0.0,M2019-03-10D,Race(5),,
12,11,5,4,20,4,4,6,14,1,8,3,12,16,17,13,46,3.7,3.7,2.0,M2019-03-10D,Race(5),,
13,12,13,2,27,12,4,4,20,7,6,3,16,31,23,9,63,3,3,1.0,M2019-03-10D,Race(5),,
1,16,8,0,24,7,7,4,18,13,5,3,21,36,20,7,63,3,3,1.0,M2019-03-10D,Race(6),,
2,0,0,0,0,0,0,0,0,0,1,0,1,0,1,0,1,21,21,0.0,M2019-03-10D,Race(6),,
3,0,5,7,12,11,1,1,13,1,1,0,2,12,7,8,27,10,10,2.0,M2019-03-10D,Race(6),,
4,3,4,7,14,7,7,5,19,5,10,6,21,15,21,18,54,6.5,6.5,0.0,M2019-03-10D,Race(6),,
5,2,2,6,10,0,2,0,2,0,1,0,1,2,5,6,13,8,8,3.0,M2019-03-10D,Race(6),,
6,0,2,3,5,0,0,0,0,0,0,1,1,0,2,4,6,16,16,0.0,M2019-03-10D,Race(6),,
7,0,0,0,0,0,0,2,2,0,0,2,2,0,0,4,4,34,34,0.0,M2019-03-10D,Race(6),,
8,0,0,0,0,0,0,1,1,0,0,2,2,0,0,3,3,34,34,0.0,M2019-03-10D,Race(6),,
9,3,3,2,8,0,8,3,11,1,2,5,8,4,13,10,27,8,8,0.0,M2019-03-10D,Race(6),,
10,0,0,0,0,0,0,0,0,0,0,0,0,0,0,0,0,21,21,0.0,M2019-03-10D,Race(6),,
11,6,6,5,17,5,5,6,16,6,6,6,18,17,17,17,51,6,6,0.0,M2019-03-10D,Race(6),,
12,0,0,0,0,0,0,8,8,0,0,1,1,0,0,9,9,17,17,0.0,M2019-03-10D,Race(6),,
1,3,2,5,10,2,0,8,10,1,1,1,3,6,3,14,23,8.5,8.5,0.0,M2019-03-10D,Race(7),,
2,5,10,4,19,3,4,3,10,3,4,5,12,11,18,12,41,6,6,2.0,M2019-03-10D,Race(7),,
3,7,5,3,15,5,4,4,13,11,2,1,14,23,11,8,42,3.2,3.2,1.0,M2019-03-10D,Race(7),,
4,3,3,4,10,0,3,2,5,1,3,3,7,4,9,9,22,10,10,0.0,M2019-03-10D,Race(7),,
5,0,0,0,0,0,0,0,0,0,1,0,1,0,1,0,1,26,26,0.0,M2019-03-10D,Race(7),,
6,0,0,0,0,0,0,0,0,0,0,0,0,0,0,0,0,71,67,0.0,M2019-03-10D,Race(7),,
7,0,3,0,3,0,0,0,0,0,0,0,0,0,3,0,3,18,18,0.0,M2019-03-10D,Race(7),,
8,9,0,9,18,10,6,8,24,4,9,6,19,23,15,23,61,5,5,0.0,M2019-03-10D,Race(7),,
9,0,0,0,0,0,0,0,0,0,0,1,1,0,0,1,1,26,26,0.0,M2019-03-10D,Race(7),,
10,3,7,5,15,10,5,4,19,6,6,6,18,19,18,15,52,8,8,3.0,M2019-03-10D,Race(7),,
11,0,0,0,0,0,8,1,9,0,0,3,3,0,8,4,12,15,15,0.0,M2019-03-10D,Race(7),,
12,0,0,0,0,0,0,0,0,0,0,0,0,0,0,0,0,21,21,0.0,M2019-03-10D,Race(7),,
1,2,0,0,2,1,8,1,10,1,2,1,4,4,10,2,16,14,14,0.0,M2019-03-10D,Race(8),,
2,0,4,3,7,2,2,2,6,2,1,0,3,4,7,5,16,18,18,3.0,M2019-03-10D,Race(8),,
3,0,0,0,0,0,0,8,8,2,0,1,3,2,0,9,11,11,11,0.0,M2019-03-10D,Race(8),,
4,12,11,5,28,8,6,3,17,7,4,6,17,27,21,14,62,3,3,0.0,M2019-03-10D,Race(8),,
5,13,10,7,30,9,8,5,22,13,5,2,20,35,23,14,72,3,3,2.0,M2019-03-10D,Race(8),,
6,0,2,2,4,2,3,7,12,1,7,5,13,3,12,14,29,7.5,7.5,1.0,M2019-03-10D,Race(8),,
7,0,0,5,5,0,0,0,0,0,1,2,3,0,1,7,8,12,12,0.0,M2019-03-10D,Race(8),,
8,0,0,0,0,0,0,0,0,0,1,0,1,0,1,0,1,41,41,0.0,M2019-03-10D,Race(8),,
9,3,3,8,14,8,3,4,15,0,5,9,14,11,11,21,43,6.5,6.5,0.0,M2019-03-10D,Race(8),,
1,5,2,0,7,0,8,4,12,0,3,4,7,5,13,8,26,19,19,0.0,M2019-03-10D,Race(9),,
2,22,3,2,27,18,3,0,21,20,3,2,25,60,9,4,73,2,2,0.0,M2019-03-10D,Race(9),,
3,0,0,0,0,8,0,0,8,0,0,0,0,8,0,0,8,41,41,0.0,M2019-03-10D,Race(9),,
4,0,7,11,18,0,3,2,5,1,2,7,10,1,12,20,33,10,10,1.0,M2019-03-10D,Race(9),,
5,0,7,9,16,2,3,9,14,3,2,5,10,5,12,23,40,8.5,8.5,2.0,M2019-03-10D,Race(9),,
6,3,11,6,20,2,10,7,19,2,14,5,21,7,35,18,60,4.4,4.5,3.0,M2019-03-10D,Race(9),,
7,0,0,2,2,0,1,8,9,0,1,3,4,0,2,13,15,15,15,0.0,M2019-03-10D,Race(9),,
8,0,0,0,0,0,2,0,2,0,0,0,0,0,2,0,2,13,13,0.0,M2019-03-10D,Race(9),,
9,0,0,0,0,0,0,0,0,0,0,0,0,0,0,0,0,31,31,0.0,M2019-03-10D,Race(9),,
10,0,0,0,0,0,0,0,0,0,1,0,1,0,1,0,1,21,21,0.0,M2019-03-10D,Race(9),,
11,0,0,0,0,0,0,0,0,0,0,0,0,0,0,0,0,26,26,0.0,M2019-03-10D,Race(9),,
1,5,4,0,9,5,4,0,9,3,0,3,6,13,8,3,24,9,9,1.0,M2019-03-13D,Race(1),,
2,2,0,0,2,2,0,0,2,0,0,0,0,4,0,0,4,15,15,0.0,M2019-03-13D,Race(1),,
3,2,2,4,8,2,2,4,8,0,1,1,2,4,5,9,18,14,14,0.0,M2019-03-13D,Race(1),,
4,3,5,2,10,3,5,2,10,8,8,3,19,14,18,7,39,4.8,4.8,0.0,M2019-03-13D,Race(1),,
5,3,3,5,11,3,3,5,11,4,4,7,15,10,10,17,37,8,8,0.0,M2019-03-13D,Race(1),,
6,3,7,6,16,3,7,6,16,3,4,3,10,9,18,15,42,8.5,8,0.0,M2019-03-13D,Race(1),,
7,2,3,3,8,2,3,3,8,0,2,3,5,4,8,9,21,11,11,3.0,M2019-03-13D,Race(1),,
8,2,3,10,15,2,3,10,15,1,1,1,3,5,7,21,33,4.2,4.2,0.0,M2019-03-13D,Race(1),,
9,0,0,0,0,0,0,0,0,1,0,0,1,1,0,0,1,41,41,0.0,M2019-03-13D,Race(1),,
10,0,0,0,0,0,0,0,0,0,0,0,0,0,0,0,0,34,34,0.0,M2019-03-13D,Race(1),,
11,0,0,0,0,0,0,0,0,0,0,0,0,0,0,0,0,71,67,0.0,M2019-03-13D,Race(1),,
12,8,3,0,11,8,3,0,11,0,2,3,5,16,8,3,27,5.5,5.5,2.0,M2019-03-13D,Race(1),,
1,0,0,0,0,0,0,0,0,0,0,0,0,0,0,0,0,34,34,0.0,M2019-03-13D,Race(2),,
2,0,0,0,0,0,0,0,0,0,0,0,0,0,0,0,0,26,26,0.0,M2019-03-13D,Race(2),,
3,0,9,2,11,0,9,2,11,4,5,1,10,4,23,5,32,6,6,3.0,M2019-03-13D,Race(2),,
4,24,4,2,30,24,4,2,30,19,5,2,26,67,13,6,86,3,3,0.0,M2019-03-13D,Race(2),,
5,0,2,2,4,0,2,2,4,0,1,0,1,0,5,4,9,13,13,1.0,M2019-03-13D,Race(2),,
6,2,3,2,7,2,3,2,7,0,1,2,3,4,7,6,17,19,19,0.0,M2019-03-13D,Race(2),,
7,2,0,6,8,2,0,6,8,2,1,8,11,6,1,20,27,11,11,2.0,M2019-03-13D,Race(2),,
8,2,3,3,8,2,3,3,8,0,10,4,14,4,16,10,30,7.5,7,0.0,M2019-03-13D,Race(2),,
9,0,3,2,5,0,3,2,5,0,0,5,5,0,6,9,15,8.5,8,0.0,M2019-03-13D,Race(2),,
10,0,0,0,0,0,0,0,0,0,0,0,0,0,0,0,0,101,101,0.0,M2019-03-13D,Race(2),,
11,0,3,8,11,0,3,8,11,1,3,4,8,1,9,20,30,9.5,9,0.0,M2019-03-13D,Race(2),,
12,0,3,3,6,0,3,3,6,0,0,0,0,0,6,6,12,7.5,7,0.0,M2019-03-13D,Race(2),,
1,2,3,0,5,2,3,0,5,6,6,7,19,10,12,7,29,15,15,0.0,M2019-03-13D,Race(3),,
2,6,0,6,12,6,0,6,12,4,9,3,16,16,9,15,40,7,7,2.0,M2019-03-13D,Race(3),,
3,0,0,0,0,0,0,0,0,0,0,0,0,0,0,0,0,51,51,0.0,M2019-03-13D,Race(3),,
4,0,2,6,8,0,2,6,8,2,2,4,8,2,6,16,24,17,17,3.0,M2019-03-13D,Race(3),,
5,3,0,2,5,3,0,2,5,4,2,2,8,10,2,6,18,4,4,0.0,M2019-03-13D,Race(3),,
6,0,0,0,0,0,0,0,0,0,0,0,0,0,0,0,0,41,41,0.0,M2019-03-13D,Race(3),,
7,0,0,0,0,0,0,0,0,0,1,0,1,0,1,0,1,51,51,0.0,M2019-03-13D,Race(3),,
8,2,11,12,25,2,11,12,25,4,5,5,14,8,27,29,64,6,6,0.0,M2019-03-13D,Race(3),,
9,9,10,0,19,9,10,0,19,5,1,2,8,23,21,2,46,4,4,1.0,M2019-03-13D,Race(3),,
10,8,2,2,12,8,2,2,12,1,0,0,1,17,4,4,25,8,8,0.0,M2019-03-13D,Race(3),,
11,0,2,0,2,0,2,0,2,0,0,2,2,0,4,2,6,26,26,0.0,M2019-03-13D,Race(3),,
12,0,0,2,2,0,0,2,2,0,0,1,1,0,0,5,5,7,7,0.0,M2019-03-13D,Race(3),,
1,10,2,8,20,10,2,8,20,3,4,1,8,23,8,17,48,9,9,0.0,M2019-03-13D,Race(4),,
2,7,5,5,17,7,5,5,17,5,2,8,15,19,12,18,49,4.6,4.6,0.0,M2019-03-13D,Race(4),,
3,3,8,11,22,3,8,11,22,11,3,5,19,17,19,27,63,4.6,4.6,3.0,M2019-03-13D,Race(4),,
4,0,0,0,0,0,0,0,0,0,2,0,2,0,2,0,2,17,17,0.0,M2019-03-13D,Race(4),,
5,3,7,0,10,3,7,0,10,5,5,5,15,11,19,5,35,5.5,5.5,1.0,M2019-03-13D,Race(4),,
6,0,0,3,3,0,0,3,3,0,0,1,1,0,0,7,7,13,13,0.0,M2019-03-13D,Race(4),,
7,0,0,0,0,0,0,0,0,0,2,0,2,0,2,0,2,10,10,0.0,M2019-03-13D,Race(4),,
8,2,0,0,2,2,0,0,2,0,1,1,2,4,1,1,6,41,41,0.0,M2019-03-13D,Race(4),,
9,0,0,0,0,0,0,0,0,0,0,2,2,0,0,2,2,34,34,0.0,M2019-03-13D,Race(4),,
10,0,0,0,0,0,0,0,0,0,2,0,2,0,2,0,2,26,26,0.0,M2019-03-13D,Race(4),,
11,0,0,0,0,0,0,0,0,0,0,0,0,0,0,0,0,51,51,0.0,M2019-03-13D,Race(4),,
12,5,8,3,16,5,8,3,16,2,5,3,10,12,21,9,42,4.6,4.6,2.0,M2019-03-13D,Race(4),,
1,8,6,14,28,8,6,14,28,10,9,3,22,26,21,31,78,5,5,0.0,M2019-03-13D,Race(5),,
2,8,8,0,16,8,8,0,16,8,7,8,23,24,23,8,55,7,7,0.0,M2019-03-13D,Race(5),,
3,2,0,0,2,2,0,0,2,0,2,3,5,4,2,3,9,13,13,2.0,M2019-03-13D,Race(5),,
4,0,0,0,0,0,0,0,0,0,0,0,0,0,0,0,0,41,41,0.0,M2019-03-13D,Race(5),,
5,0,0,0,0,0,0,0,0,0,0,1,1,0,0,1,1,19,19,0.0,M2019-03-13D,Race(5),,
6,7,5,11,23,7,5,11,23,5,5,5,15,19,15,27,61,4.4,4.4,1.0,M2019-03-13D,Race(5),,
7,3,7,5,15,3,7,5,15,3,2,3,8,9,16,13,38,4,4,0.0,M2019-03-13D,Race(5),,
8,0,2,0,2,0,2,0,2,0,0,0,0,0,4,0,4,14,14,0.0,M2019-03-13D,Race(5),,
9,0,0,0,0,0,0,0,0,0,0,1,1,0,0,1,1,19,19,0.0,M2019-03-13D,Race(5),,
10,0,2,0,2,0,2,0,2,0,1,0,1,0,5,0,5,14,14,0.0,M2019-03-13D,Race(5),,
11,0,0,0,0,0,0,0,0,0,0,0,0,0,0,0,0,17,17,0.0,M2019-03-13D,Race(5),,
12,2,0,0,2,2,0,0,2,0,0,2,2,4,0,2,6,15,15,3.0,M2019-03-13D,Race(5),,
1,0,0,0,0,0,0,0,0,1,0,0,1,1,0,0,1,41,41,0.0,M2019-03-13D,Race(6),,
2,0,0,2,2,0,0,2,2,0,1,1,2,0,1,5,6,34,34,0.0,M2019-03-13D,Race(6),,
3,2,0,0,2,2,0,0,2,0,0,2,2,4,0,2,6,15,15,0.0,M2019-03-13D,Race(6),,
4,2,0,3,5,2,0,3,5,3,0,3,6,7,0,9,16,8,8,0.0,M2019-03-13D,Race(6),,
5,0,7,0,7,0,7,0,7,0,3,4,7,0,17,4,21,17,17,0.0,M2019-03-13D,Race(6),,
6,0,0,0,0,0,0,0,0,0,0,1,1,0,0,1,1,17,17,0.0,M2019-03-13D,Race(6),,
7,5,2,13,20,5,2,13,20,3,3,4,10,13,7,30,50,4.8,4.8,0.0,M2019-03-13D,Race(6),,
8,0,0,0,0,0,0,0,0,0,0,1,1,0,0,1,1,51,51,0.0,M2019-03-13D,Race(6),,
9,13,8,4,25,13,8,4,25,14,6,4,24,40,22,12,74,3.5,3.5,1.0,M2019-03-13D,Race(6),,
10,0,2,3,5,0,2,3,5,0,1,2,3,0,5,8,13,18,18,2.0,M2019-03-13D,Race(6),,
11,0,0,0,0,0,0,0,0,0,0,1,1,0,0,1,1,61,61,0.0,M2019-03-13D,Race(6),,
12,8,11,5,24,8,11,5,24,5,12,3,20,21,34,13,68,3,3,3.0,M2019-03-13D,Race(6),,
1,2,2,2,6,2,2,2,6,1,0,1,2,5,4,5,14,14,14,0.0,M2019-03-13D,Race(7),,
2,2,0,0,2,2,0,0,2,1,0,0,1,5,0,0,5,26,26,0.0,M2019-03-13D,Race(7),,
3,0,2,5,7,0,2,5,7,0,0,0,0,0,4,10,14,6,6,0.0,M2019-03-13D,Race(7),,
4,0,3,0,3,0,3,0,3,0,5,3,8,0,11,3,14,16,16,0.0,M2019-03-13D,Race(7),,
5,0,3,2,5,0,3,2,5,1,1,0,2,1,7,4,12,26,26,0.0,M2019-03-13D,Race(7),,
6,15,9,3,27,15,9,3,27,5,2,8,15,35,20,14,69,3.4,3.3,0.0,M2019-03-13D,Race(7),,
7,0,0,0,0,0,0,0,0,0,0,0,0,0,0,0,0,21,21,3.0,M2019-03-13D,Race(7),,
8,0,2,0,2,0,2,0,2,0,0,2,2,0,4,2,6,13,13,1.0,M2019-03-13D,Race(7),,
9,5,3,8,16,5,3,8,16,0,2,3,5,10,8,19,37,7,7,2.0,M2019-03-13D,Race(7),,
10,6,3,5,14,6,3,5,14,9,5,4,18,21,11,14,46,4,4,0.0,M2019-03-13D,Race(7),,
11,0,0,0,0,0,0,0,0,0,0,1,1,0,0,1,1,51,51,0.0,M2019-03-13D,Race(7),,
12,0,3,5,8,0,3,5,8,1,2,1,4,1,8,11,20,11,11,0.0,M2019-03-13D,Race(7),,
1,3,2,2,7,3,2,2,7,1,2,0,3,7,6,4,17,9.5,9.5,0.0,M2019-03-13D,Race(8),,
2,0,0,0,0,0,0,0,0,1,0,0,1,1,0,0,1,31,31,0.0,M2019-03-13D,Race(8),,
3,0,0,0,0,0,0,0,0,0,1,0,1,0,1,0,1,19,19,0.0,M2019-03-13D,Race(8),,
4,9,5,3,17,9,5,3,17,3,7,6,16,21,17,12,50,4.6,4.5,1.0,M2019-03-13D,Race(8),,
5,13,5,8,26,13,5,8,26,11,1,6,18,37,11,22,70,4,4,0.0,M2019-03-13D,Race(8),,
6,3,7,10,20,3,7,10,20,6,4,1,11,12,18,21,51,6,6,0.0,M2019-03-13D,Race(8),,
7,0,0,0,0,0,0,0,0,0,0,0,0,0,0,0,0,51,51,0.0,M2019-03-13D,Race(8),,
8,2,5,2,9,2,5,2,9,4,7,6,17,8,17,10,35,5,5,3.0,M2019-03-13D,Race(8),,
9,0,0,0,0,0,0,0,0,0,0,0,0,0,0,0,0,41,41,0.0,M2019-03-13D,Race(8),,
10,0,0,0,0,0,0,0,0,0,0,0,0,0,0,0,0,51,51,0.0,M2019-03-13D,Race(8),,
11,0,0,0,0,0,0,0,0,0,0,0,0,0,0,0,0,51,51,0.0,M2019-03-13D,Race(8),,
12,0,6,5,11,0,6,5,11,0,4,7,11,0,16,17,33,6,6,2.0,M2019-03-13D,Race(8),,
1,0,2,0,2,0,0,0,0,0,0,0,0,0,2,0,2,17,17,0.0,M2019-03-17D,Race(1),,
2,24,0,3,27,17,4,1,22,18,4,4,26,59,8,8,75,2.25,2.25,1.0,M2019-03-17D,Race(1),,
3,0,8,2,10,0,4,8,12,3,3,7,13,3,15,17,35,6,6,0.0,M2019-03-17D,Race(1),,
4,0,0,0,0,0,0,0,0,0,0,0,0,0,0,0,0,26,26,0.0,M2019-03-17D,Race(1),,
5,0,0,0,0,0,0,0,0,0,0,0,0,0,0,0,0,26,26,0.0,M2019-03-17D,Race(1),,
6,0,0,0,0,0,0,0,0,0,0,0,0,0,0,0,0,81,81,0.0,M2019-03-17D,Race(1),,
7,0,0,6,6,0,0,0,0,0,0,0,0,0,0,6,6,34,34,2.0,M2019-03-17D,Race(1),,
8,3,8,14,25,13,7,7,27,5,10,7,22,21,25,28,74,4.6,4.6,0.0,M2019-03-17D,Race(1),,
9,0,0,0,0,0,0,0,0,0,0,0,0,0,0,0,0,101,101,0.0,M2019-03-17D,Race(1),,
10,3,10,5,18,0,3,5,8,0,5,6,11,3,18,16,37,7,7,0.0,M2019-03-17D,Race(1),,
11,0,0,0,0,0,0,0,0,0,1,1,2,0,1,1,2,61,61,0.0,M2019-03-17D,Race(1),,
12,0,0,0,0,0,0,0,0,0,0,0,0,0,0,0,0,61,61,3.0,M2019-03-17D,Race(1),,
13,0,2,0,2,0,4,8,12,0,2,1,3,0,8,9,17,14,14,0.0,M2019-03-17D,Race(1),,
14,0,0,0,0,0,0,0,0,0,0,0,0,0,0,0,0,41,41,0.0,M2019-03-17D,Race(1),,
1,4,5,0,9,0,2,3,5,0,0,2,2,4,7,5,16,14,14,0.0,M2019-03-17D,Race(10),,
2,0,0,0,0,0,0,0,0,0,0,0,0,0,0,0,0,61,61,0.0,M2019-03-17D,Race(10),,
3,5,5,16,26,8,12,5,25,4,8,6,18,17,25,27,69,3.8,3.8,0.0,M2019-03-17D,Race(10),,
4,0,2,0,2,1,1,1,3,0,2,2,4,1,5,3,9,10,10,0.0,M2019-03-17D,Race(10),,
5,2,5,3,10,1,0,5,6,1,0,4,5,4,5,12,21,17,17,0.0,M2019-03-17D,Race(10),,
6,0,0,0,0,0,1,1,2,0,2,1,3,0,3,2,5,26,26,0.0,M2019-03-17D,Race(10),,
7,0,0,0,0,0,0,0,0,0,2,0,2,0,2,0,2,34,34,0.0,M2019-03-17D,Race(10),,
8,6,0,6,12,1,6,11,18,4,5,5,14,11,11,22,44,8,8,3.0,M2019-03-17D,Race(10),,
9,3,0,0,3,0,0,0,0,0,0,0,0,3,0,0,3,26,26,1.0,M2019-03-17D,Race(10),,
10,10,13,2,25,18,6,4,28,17,6,2,25,45,25,8,78,2.2,2.4,2.0,M2019-03-17D,Race(10),,
11,0,0,3,3,1,1,0,2,0,0,1,1,1,1,4,6,31,31,0.0,M2019-03-17D,Race(10),,
12,0,0,0,0,0,0,0,0,0,0,0,0,0,0,0,0,81,81,0.0,M2019-03-17D,Race(10),,
13,0,0,0,0,0,0,0,0,0,0,0,0,0,0,0,0,18,18,0.0,M2019-03-17D,Race(10),,
14,0,0,0,0,0,0,0,0,0,0,1,1,0,0,1,1,51,51,0.0,M2019-03-17D,Race(10),,
1,0,3,0,3,0,1,2,3,2,1,3,6,2,5,5,12,10,10,0.0,M2019-03-17D,Race(2),,
2,0,9,11,20,3,4,16,23,9,3,6,18,12,16,33,61,7.5,7.5,0.0,M2019-03-17D,Race(2),,
3,0,0,3,3,0,0,0,0,0,0,0,0,0,0,3,3,13,13,2.0,M2019-03-17D,Race(2),,
4,10,8,2,20,16,9,3,28,6,10,6,22,32,27,11,70,3,3,1.0,M2019-03-17D,Race(2),,
5,0,0,0,0,0,0,0,0,0,0,0,0,0,0,0,0,71,67,0.0,M2019-03-17D,Race(2),,
6,0,3,0,3,0,0,1,1,0,1,2,3,0,4,3,7,34,34,0.0,M2019-03-17D,Race(2),,
7,0,0,0,0,0,0,0,0,0,0,0,0,0,0,0,0,61,61,0.0,M2019-03-17D,Race(2),,
8,0,0,2,2,0,0,0,0,0,0,1,1,0,0,3,3,18,18,0.0,M2019-03-17D,Race(2),,
9,9,2,0,11,2,0,0,2,1,1,1,3,12,3,1,16,6,6,0.0,M2019-03-17D,Race(2),,
10,8,3,12,23,8,16,5,29,6,10,5,21,22,29,22,73,4,4,0.0,M2019-03-17D,Race(2),,
11,0,0,0,0,0,0,0,0,0,0,0,0,0,0,0,0,101,101,0.0,M2019-03-17D,Race(2),,
12,3,2,0,5,1,0,3,4,2,0,2,4,6,2,5,13,11,11,3.0,M2019-03-17D,Race(2),,
1,7,9,11,27,4,3,12,19,4,4,2,10,15,16,25,56,4.8,4.8,1.0,M2019-03-17D,Race(3),,
2,0,0,0,0,1,1,3,5,2,1,4,7,3,2,7,12,13,13,0.0,M2019-03-17D,Race(3),,
3,0,3,3,6,1,0,0,1,0,0,0,0,1,3,3,7,15,15,0.0,M2019-03-17D,Race(3),,
4,6,14,5,25,16,8,3,27,13,8,2,23,35,30,10,75,3.2,3.2,2.0,M2019-03-17D,Race(3),,
5,0,0,0,0,0,0,0,0,0,0,0,0,0,0,0,0,34,35,0.0,M2019-03-17D,Race(3),,
6,10,0,8,18,2,5,1,8,1,3,2,6,13,8,11,32,5,5,0.0,M2019-03-17D,Race(3),,
7,2,0,0,2,1,0,1,2,0,0,1,1,3,0,2,5,17,67,3.0,M2019-03-17D,Race(3),,
8,0,0,0,0,0,0,0,0,0,0,1,1,0,0,1,1,71,71,0.0,M2019-03-17D,Race(3),,
9,0,0,0,0,0,0,0,0,0,0,1,1,0,0,1,1,41,41,0.0,M2019-03-17D,Race(3),,
10,0,0,0,0,0,0,0,0,0,0,1,1,0,0,1,1,21,21,0.0,M2019-03-17D,Race(3),,
11,0,0,0,0,0,0,0,0,0,0,0,0,0,0,0,0,26,26,0.0,M2019-03-17D,Race(3),,
12,5,2,3,10,1,1,0,2,2,4,0,6,8,7,3,18,9,9,0.0,M2019-03-17D,Race(3),,
13,0,0,0,0,0,0,0,0,0,0,0,0,0,0,0,0,51,51,0.0,M2019-03-17D,Race(3),,
14,0,2,0,2,0,0,2,2,0,0,1,1,0,2,3,5,14,14,0.0,M2019-03-17D,Race(3),,
1,4,0,0,4,0,0,0,0,0,0,0,0,4,0,0,4,10,10,3.0,M2019-03-17D,Race(4),,
2,13,4,3,20,6,14,2,22,6,10,3,19,25,28,8,61,5.5,5.5,1.0,M2019-03-17D,Race(4),,
3,2,13,3,18,5,2,11,18,5,4,5,14,12,19,19,50,8,8,0.0,M2019-03-17D,Race(4),,
4,0,0,0,0,0,0,0,0,0,0,0,0,0,0,0,0,31,31,0.0,M2019-03-17D,Race(4),,
5,0,0,0,0,0,0,0,0,0,0,0,0,0,0,0,0,81,81,0.0,M2019-03-17D,Race(4),,
6,0,0,0,0,0,0,0,0,0,0,0,0,0,0,0,0,71,71,0.0,M2019-03-17D,Race(4),,
7,6,4,11,21,0,3,4,7,0,4,5,9,6,11,20,37,5,5,0.0,M2019-03-17D,Race(4),,
8,2,0,2,4,0,0,1,1,0,0,1,1,2,0,4,6,12,12,0.0,M2019-03-17D,Race(4),,
9,0,3,0,3,3,4,3,10,2,3,2,7,5,10,5,20,7.5,7.5,0.0,M2019-03-17D,Race(4),,
10,0,0,0,0,0,0,0,0,0,0,0,0,0,0,0,0,26,26,0.0,M2019-03-17D,Race(4),,
11,0,0,0,0,0,0,0,0,0,1,1,2,0,1,1,2,51,51,0.0,M2019-03-17D,Race(4),,
12,0,0,0,0,0,0,0,0,0,0,0,0,0,0,0,0,41,41,0.0,M2019-03-17D,Race(4),,
13,3,3,2,8,0,1,0,1,0,0,1,1,3,4,3,10,7.5,7.5,0.0,M2019-03-17D,Race(4),,
14,0,3,9,12,1,2,1,4,1,2,2,5,2,7,12,21,5.5,5.5,2.0,M2019-03-17D,Race(4),,
1,8,11,5,24,6,14,5,25,5,2,8,15,19,27,18,64,4.2,4.2,2.0,M2019-03-17D,Race(5),,
2,8,11,2,21,0,3,3,6,0,5,1,6,8,19,6,33,9,9,0.0,M2019-03-17D,Race(5),,
3,0,0,0,0,1,0,0,1,0,0,0,0,1,0,0,1,26,26,0.0,M2019-03-17D,Race(5),,
4,5,3,3,11,5,2,8,15,5,6,0,11,15,11,11,37,10,10,0.0,M2019-03-17D,Race(5),,
5,0,3,0,3,0,1,1,2,1,1,1,3,1,5,2,8,7.5,7.5,0.0,M2019-03-17D,Race(5),,
6,3,0,10,13,16,3,5,24,9,5,6,20,28,8,21,57,5,5,1.0,M2019-03-17D,Race(5),,
7,0,0,0,0,0,0,0,0,0,0,1,1,0,0,1,1,71,67,0.0,M2019-03-17D,Race(5),,
8,2,2,0,4,0,0,1,1,0,1,1,2,2,3,2,7,16,16,0.0,M2019-03-17D,Race(5),,
9,0,0,5,5,1,4,1,6,3,4,1,8,4,8,7,19,8.5,8.5,0.0,M2019-03-17D,Race(5),,
10,0,0,0,0,0,0,0,0,0,0,0,0,0,0,0,0,34,34,0.0,M2019-03-17D,Race(5),,
11,0,0,0,0,0,0,0,0,0,0,0,0,0,0,0,0,17,17,0.0,M2019-03-17D,Race(5),,
12,4,0,5,9,1,3,6,10,3,2,7,12,8,5,18,31,7.5,7.5,3.0,M2019-03-17D,Race(5),,
13,0,0,0,0,0,0,0,0,0,0,0,0,0,0,0,0,34,34,0.0,M2019-03-17D,Race(5),,
14,0,0,0,0,0,0,0,0,0,0,0,0,0,0,0,0,81,81,0.0,M2019-03-17D,Race(5),,
1,0,0,2,2,0,0,1,1,1,0,0,1,1,0,3,4,26,26,0.0,M2019-03-17D,Race(6),,
2,0,2,3,5,3,9,4,16,2,5,2,9,5,16,9,30,7,7,1.0,M2019-03-17D,Race(6),,
3,11,2,6,19,22,8,0,30,16,8,2,26,49,18,8,75,4.4,4.8,2.0,M2019-03-17D,Race(6),,
4,5,2,2,9,1,4,3,8,0,2,4,6,6,8,9,23,11,11,0.0,M2019-03-17D,Race(6),,
5,2,0,3,5,0,0,1,1,0,0,1,1,2,0,5,7,17,17,0.0,M2019-03-17D,Race(6),,
6,0,5,0,5,0,0,1,1,0,2,2,4,0,7,3,10,8.5,8.5,0.0,M2019-03-17D,Race(6),,
7,8,8,4,20,2,7,13,22,4,6,4,14,14,21,21,56,4.2,4.2,0.0,M2019-03-17D,Race(6),,
8,0,0,3,3,0,0,0,0,0,0,0,0,0,0,3,3,41,41,0.0,M2019-03-17D,Race(6),,
9,0,2,0,2,1,0,2,3,1,0,4,5,2,2,6,10,9,9,0.0,M2019-03-17D,Race(6),,
10,0,0,0,0,0,0,0,0,0,0,0,0,0,0,0,0,34,34,0.0,M2019-03-17D,Race(6),,
11,0,0,0,0,0,0,0,0,0,0,0,0,0,0,0,0,31,31,0.0,M2019-03-17D,Race(6),,
12,0,0,0,0,0,0,0,0,0,0,0,0,0,0,0,0,34,34,0.0,M2019-03-17D,Race(6),,
13,0,0,0,0,0,0,0,0,0,0,0,0,0,0,0,0,81,81,0.0,M2019-03-17D,Race(6),,
14,4,9,7,20,1,2,5,8,2,3,7,12,7,14,19,40,7,7,3.0,M2019-03-17D,Race(6),,
1,0,0,3,3,0,1,0,1,0,0,0,0,0,1,3,4,26,26,0.0,M2019-03-17D,Race(7),,
2,2,5,0,7,2,9,1,12,1,2,3,6,5,16,4,25,16,16,0.0,M2019-03-17D,Race(7),,
3,0,0,2,2,0,2,0,2,0,6,1,7,0,8,3,11,21,21,0.0,M2019-03-17D,Race(7),,
4,2,8,2,12,0,11,11,22,0,9,3,12,2,28,16,46,7,7,0.0,M2019-03-17D,Race(7),,
5,26,2,0,28,27,2,1,30,25,0,0,25,78,4,1,83,1.4,1.4,1.0,M2019-03-17D,Race(7),,
6,0,0,4,4,0,0,0,0,0,0,0,0,0,0,4,4,13,13,0.0,M2019-03-17D,Race(7),,
7,0,3,5,8,0,3,8,11,0,6,6,12,0,12,19,31,16,16,3.0,M2019-03-17D,Race(7),,
8,0,10,11,21,0,0,8,8,0,0,10,10,0,10,29,39,26,26,2.0,M2019-03-17D,Race(7),,
9,0,0,3,3,1,0,1,2,0,0,2,2,1,0,6,7,31,31,0.0,M2019-03-17D,Race(7),,
10,0,2,0,2,0,1,0,1,0,1,1,2,0,4,1,5,41,41,0.0,M2019-03-17D,Race(7),,
11,0,0,0,0,0,1,0,1,0,2,0,2,0,3,0,3,41,41,0.0,M2019-03-17D,Race(7),,
12,0,0,0,0,0,0,0,0,0,0,0,0,0,0,0,0,81,81,0.0,M2019-03-17D,Race(7),,
1,8,8,7,23,19,4,2,25,17,3,2,22,44,15,11,70,3.2,3,2.0,M2019-03-17D,Race(8),,
2,7,11,10,28,5,18,5,28,6,11,5,22,18,40,20,78,3,3.5,0.0,M2019-03-17D,Race(8),,
3,10,9,9,28,4,2,15,21,1,7,8,16,15,18,32,65,4.4,5.5,1.0,M2019-03-17D,Race(8),,
4,2,0,0,2,0,1,1,2,0,1,1,2,2,2,2,6,12,10,0.0,M2019-03-17D,Race(8),,
5,3,0,2,5,2,2,4,8,2,1,4,7,7,3,10,20,13,10,0.0,M2019-03-17D,Race(8),,
6,0,0,0,0,0,1,0,1,0,2,1,3,0,3,1,4,23,19,0.0,M2019-03-17D,Race(8),,
7,0,0,0,0,0,0,0,0,0,0,0,0,0,0,0,0,41,26,0.0,M2019-03-17D,Race(8),,
8,0,2,2,4,0,1,2,3,0,1,3,4,0,4,7,11,19,29,0.0,M2019-03-17D,Race(8),,
9,0,0,0,0,0,0,1,1,0,0,1,1,0,0,2,2,23,21,0.0,M2019-03-17D,Race(8),,
10,0,0,0,0,0,1,0,1,0,0,0,0,0,1,0,1,31,26,0.0,M2019-03-17D,Race(8),,
11,0,0,0,0,0,0,0,0,0,0,0,0,0,0,0,0,31,26,0.0,M2019-03-17D,Race(8),,
12,0,0,0,0,0,0,0,0,0,0,0,0,0,0,0,0,91,51,0.0,M2019-03-17D,Race(8),,
13,0,0,0,0,0,0,0,0,0,0,1,1,0,0,1,1,41,41,0.0,M2019-03-17D,Race(8),,
14,0,0,0,0,0,0,0,0,0,0,0,0,0,0,0,0,31,31,3.0,M2019-03-17D,Race(8),,
1,0,0,0,0,0,0,0,0,0,0,0,0,0,0,0,0,81,81,0.0,M2019-03-17D,Race(9),,
2,0,2,0,2,0,0,0,0,0,0,1,1,0,2,1,3,15,15,3.0,M2019-03-17D,Race(9),,
3,0,0,0,0,0,0,0,0,0,1,0,1,0,1,0,1,71,67,0.0,M2019-03-17D,Race(9),,
4,0,0,7,7,3,3,11,17,5,3,4,12,8,6,22,36,8,8,0.0,M2019-03-17D,Race(9),,
5,0,0,3,3,0,1,0,1,0,0,1,1,0,1,4,5,16,16,0.0,M2019-03-17D,Race(9),,
6,0,0,0,0,1,0,0,1,1,0,0,1,2,0,0,2,34,34,0.0,M2019-03-17D,Race(9),,
7,0,0,0,0,0,0,0,0,0,0,0,0,0,0,0,0,41,41,0.0,M2019-03-17D,Race(9),,
8,0,2,7,9,0,1,1,2,0,1,1,2,0,4,9,13,14,14,0.0,M2019-03-17D,Race(9),,
9,6,10,2,18,3,14,7,24,3,8,7,18,12,32,16,60,7,7,0.0,M2019-03-17D,Race(9),,
10,24,3,3,30,22,3,5,30,16,4,4,24,62,10,12,84,2,2,2.0,M2019-03-17D,Race(9),,
11,0,11,5,16,1,7,5,13,1,8,6,15,2,26,16,44,7.5,7.5,1.0,M2019-03-17D,Race(9),,
12,0,2,3,5,0,1,0,1,0,1,0,1,0,4,3,7,34,34,0.0,M2019-03-17D,Race(9),,
13,0,0,0,0,0,0,0,0,0,0,1,1,0,0,1,1,81,81,0.0,M2019-03-17D,Race(9),,
14,0,0,0,0,0,0,1,1,0,0,1,1,0,0,2,2,19,19,0.0,M2019-03-17D,Race(9),,
1,0,7,2,9,4,5,3,12,3,3,1,7,7,15,6,28,8,8,0.0,M2019-03-20D,Race(1),,
2,3,3,3,9,8,4,2,14,5,4,2,11,16,11,7,34,4.4,4.4,0.0,M2019-03-20D,Race(1),,
3,4,0,0,4,5,0,2,7,4,1,1,6,13,1,3,17,10,12,1.0,M2019-03-20D,Race(1),,
4,0,2,12,14,4,5,6,15,4,8,6,18,8,15,24,47,7.5,7.5,0.0,M2019-03-20D,Race(1),,
5,14,4,5,23,9,5,3,17,7,5,6,18,30,14,14,58,3.8,3.8,0.0,M2019-03-20D,Race(1),,
6,2,0,0,2,0,0,0,0,0,0,0,0,2,0,0,2,31,31,0.0,M2019-03-20D,Race(1),,
7,0,9,0,9,0,1,4,5,2,1,6,9,2,11,10,23,15,15,0.0,M2019-03-20D,Race(1),,
8,0,0,0,0,0,1,8,9,0,1,0,1,0,2,8,10,34,34,0.0,M2019-03-20D,Race(1),,
9,2,0,0,2,0,8,0,8,1,2,0,3,3,10,0,13,14,14,0.0,M2019-03-20D,Race(1),,
10,0,0,0,0,0,0,0,0,0,0,1,1,0,0,1,1,41,41,0.0,M2019-03-20D,Race(1),,
11,5,3,8,16,0,1,2,3,0,1,3,4,5,5,13,23,7,7,3.0,M2019-03-20D,Race(1),,
12,0,2,0,2,0,0,0,0,0,0,0,0,0,2,0,2,13,13,2.0,M2019-03-20D,Race(1),,
1,3,0,5,8,9,3,7,19,9,5,4,18,21,8,16,45,9.5,9,0.0,M2019-03-20D,Race(2),,
2,2,0,3,5,8,4,0,12,1,4,2,7,11,8,5,24,12,12,0.0,M2019-03-20D,Race(2),,
3,0,0,0,0,0,0,0,0,1,0,0,1,1,0,0,1,16,16,0.0,M2019-03-20D,Race(2),,
4,0,0,0,0,0,8,0,8,0,1,0,1,0,9,0,9,16,16,0.0,M2019-03-20D,Race(2),,
5,0,0,0,0,0,0,0,0,0,0,1,1,0,0,1,1,31,31,0.0,M2019-03-20D,Race(2),,
6,4,2,6,12,0,0,1,1,0,2,3,5,4,4,10,18,9.5,9,0.0,M2019-03-20D,Race(2),,
7,0,0,0,0,0,0,0,0,0,0,0,0,0,0,0,0,81,81,0.0,M2019-03-20D,Race(2),,
8,5,11,4,20,3,2,2,7,1,1,3,5,9,14,9,32,3.5,3.8,1.0,M2019-03-20D,Race(2),,
9,11,9,5,25,5,6,4,15,7,5,5,17,23,20,14,57,4.2,4,0.0,M2019-03-20D,Race(2),,
10,0,3,0,3,0,0,0,0,0,1,0,1,0,4,0,4,31,41,0.0,M2019-03-20D,Race(2),,
11,0,2,4,6,0,0,8,8,1,2,0,3,1,4,12,17,10,10,3.0,M2019-03-20D,Race(2),,
12,5,3,3,11,5,7,8,20,6,5,8,19,16,15,19,50,6.5,6,2.0,M2019-03-20D,Race(2),,
1,6,9,2,17,11,4,3,18,10,3,5,18,27,16,10,53,4.8,4.8,1.0,M2019-03-20D,Race(3),,
2,0,9,2,11,1,10,5,16,1,2,5,8,2,21,12,35,4.8,4.8,3.0,M2019-03-20D,Race(3),,
3,0,0,2,2,1,0,2,3,2,1,4,7,3,1,8,12,13,13,0.0,M2019-03-20D,Race(3),,
4,2,3,8,13,2,3,4,9,1,7,2,10,5,13,14,32,4.6,4.6,0.0,M2019-03-20D,Race(3),,
5,14,7,6,27,4,6,5,15,7,6,4,17,25,19,15,59,5,5,0.0,M2019-03-20D,Race(3),,
6,6,0,10,16,2,3,3,8,2,2,3,7,10,5,16,31,10,10,2.0,M2019-03-20D,Race(3),,
7,2,2,0,4,8,0,0,8,1,0,2,3,11,2,2,15,6.5,6.5,0.0,M2019-03-20D,Race(3),,
8,0,0,0,0,1,4,8,13,2,6,1,9,3,10,9,22,11,11,0.0,M2019-03-20D,Race(3),,
1,5,5,11,21,8,3,5,16,3,4,5,12,16,12,21,49,6,6,3.0,M2019-03-20D,Race(4),,
2,0,0,0,0,0,0,0,0,0,0,0,0,0,0,0,0,41,41,0.0,M2019-03-20D,Race(4),,
3,2,6,5,13,3,9,5,17,0,5,10,15,5,20,20,45,7.5,7.5,0.0,M2019-03-20D,Race(4),,
4,16,9,3,28,14,6,3,23,17,7,1,25,47,22,7,76,2.3,2.3,2.0,M2019-03-20D,Race(4),,
5,7,0,3,10,1,2,0,3,0,0,1,1,8,2,4,14,7,7,0.0,M2019-03-20D,Race(4),,
6,0,0,0,0,0,0,0,0,0,3,0,3,0,3,0,3,71,71,0.0,M2019-03-20D,Race(4),,
7,0,0,0,0,0,1,1,2,0,0,0,0,0,1,1,2,16,16,0.0,M2019-03-20D,Race(4),,
8,0,5,3,8,3,1,8,12,5,3,0,8,8,9,11,28,9,9,1.0,M2019-03-20D,Race(4),,
9,0,5,3,8,1,0,8,9,1,4,8,13,2,9,19,30,8.5,8.5,0.0,M2019-03-20D,Race(4),,
10,0,0,0,0,0,0,0,0,0,0,1,1,0,0,1,1,51,51,0.0,M2019-03-20D,Race(4),,
11,0,0,2,2,0,8,0,8,0,0,0,0,0,8,2,10,26,26,0.0,M2019-03-20D,Race(4),,
12,0,0,0,0,0,0,0,0,0,0,0,0,0,0,0,0,71,67,0.0,M2019-03-20D,Race(4),,
1,0,0,2,2,0,5,2,7,0,2,5,7,0,7,9,16,16,16,0.0,M2019-03-20D,Race(5),,
2,3,5,6,14,2,3,2,7,4,4,4,12,9,12,12,33,6,6,0.0,M2019-03-20D,Race(5),,
3,0,8,2,10,5,4,8,17,3,7,6,16,8,19,16,43,4.8,4.8,0.0,M2019-03-20D,Race(5),,
4,0,2,0,2,0,0,1,1,0,0,2,2,0,2,3,5,23,23,3.0,M2019-03-20D,Race(5),,
5,12,3,8,23,5,1,2,8,8,1,1,10,25,5,11,41,4.6,4.5,0.0,M2019-03-20D,Race(5),,
6,7,2,5,14,1,4,0,5,1,3,0,4,9,9,5,23,5,5,0.0,M2019-03-20D,Race(5),,
7,3,3,0,6,8,0,1,9,2,1,2,5,13,4,3,20,16,16,0.0,M2019-03-20D,Race(5),,
8,0,2,0,2,0,2,2,4,0,1,2,3,0,5,4,9,21,21,0.0,M2019-03-20D,Race(5),,
9,5,3,2,10,9,3,3,15,8,6,2,16,22,12,7,41,7,7,1.0,M2019-03-20D,Race(5),,
10,0,2,2,4,0,0,8,8,0,0,2,2,0,2,12,14,34,34,0.0,M2019-03-20D,Race(5),,
11,0,0,3,3,0,8,1,9,0,1,0,1,0,9,4,13,19,19,2.0,M2019-03-20D,Race(5),,
12,0,0,0,0,0,0,0,0,0,0,0,0,0,0,0,0,26,26,0.0,M2019-03-20D,Race(5),,
1,22,0,5,27,9,7,3,19,7,8,4,19,38,15,12,65,3.2,3.2,0.0,M2019-03-20D,Race(6),,
2,0,0,2,2,0,1,0,1,1,1,0,2,1,2,2,5,16,16,0.0,M2019-03-20D,Race(6),,
3,3,12,5,20,0,6,6,12,2,4,9,15,5,22,20,47,7,7,1.0,M2019-03-20D,Race(6),,
4,0,0,0,0,0,0,0,0,0,0,0,0,0,0,0,0,51,51,3.0,M2019-03-20D,Race(6),,
5,0,0,0,0,0,0,0,0,0,0,2,2,0,0,2,2,16,16,0.0,M2019-03-20D,Race(6),,
6,0,0,0,0,0,0,0,0,0,0,0,0,0,0,0,0,41,41,0.0,M2019-03-20D,Race(6),,
7,0,0,0,0,8,1,4,13,3,3,5,11,11,4,9,24,10,10,2.0,M2019-03-20D,Race(6),,
8,3,2,3,8,0,8,2,10,1,0,1,2,4,10,6,20,6.5,6.5,0.0,M2019-03-20D,Race(6),,
9,2,11,9,22,10,5,2,17,12,8,3,23,24,24,14,62,3.6,3.6,0.0,M2019-03-20D,Race(6),,
10,0,0,0,0,0,0,0,0,0,0,0,0,0,0,0,0,26,26,0.0,M2019-03-20D,Race(6),,
11,0,5,6,11,3,2,10,15,0,2,2,4,3,9,18,30,12,12,0.0,M2019-03-20D,Race(6),,
1,8,10,7,25,4,5,6,15,4,8,6,18,16,23,19,58,4.6,4.6,0.0,M2019-03-20D,Race(7),,
2,0,2,2,4,8,0,0,8,0,1,0,1,8,3,2,13,21,21,0.0,M2019-03-20D,Race(7),,
3,4,3,3,10,2,9,7,18,4,4,9,17,10,16,19,45,6.5,6.5,2.0,M2019-03-20D,Race(7),,
4,0,0,3,3,0,0,0,0,0,0,0,0,0,0,3,3,20,20,0.0,M2019-03-20D,Race(7),,
5,0,0,0,0,0,8,0,8,0,0,1,1,0,8,1,9,20,20,0.0,M2019-03-20D,Race(7),,
6,0,0,2,2,0,0,0,0,0,2,0,2,0,2,2,4,31,31,0.0,M2019-03-20D,Race(7),,
7,11,10,4,25,14,0,4,18,15,3,3,21,40,13,11,64,2.5,2.5,1.0,M2019-03-20D,Race(7),,
8,0,0,0,0,0,0,0,0,0,0,1,1,0,0,1,1,61,61,0.0,M2019-03-20D,Race(7),,
9,0,0,0,0,0,1,0,1,0,1,0,1,0,2,0,2,19,19,3.0,M2019-03-20D,Race(7),,
10,5,0,3,8,2,6,4,12,2,5,5,12,9,11,12,32,7,7,0.0,M2019-03-20D,Race(7),,
11,2,0,6,8,0,0,0,0,0,0,0,0,2,0,6,8,19,19,0.0,M2019-03-20D,Race(7),,
12,0,5,0,5,0,1,9,10,1,2,1,4,1,8,10,19,16,16,0.0,M2019-03-20D,Race(7),,
1,5,13,3,21,7,9,2,18,9,10,3,22,21,32,8,61,6.5,6.5,0.0,M2019-03-20D,Race(8),,
2,3,5,10,18,7,8,5,20,8,7,5,20,18,20,20,58,6.5,6.5,0.0,M2019-03-20D,Race(8),,
3,17,3,3,23,6,3,3,12,4,3,2,9,27,9,8,44,5.5,5.5,0.0,M2019-03-20D,Race(8),,
4,2,3,2,7,0,0,2,2,0,0,2,2,2,3,6,11,9,9,0.0,M2019-03-20D,Race(8),,
5,0,0,0,0,2,2,2,6,3,2,3,8,5,4,5,14,6.5,6.5,0.0,M2019-03-20D,Race(8),,
6,0,4,3,7,0,0,0,0,0,1,1,2,0,5,4,9,18,18,0.0,M2019-03-20D,Race(8),,
7,0,0,2,2,0,8,0,8,0,2,1,3,0,10,3,13,16,16,2.0,M2019-03-20D,Race(8),,
8,0,0,0,0,0,0,1,1,1,0,1,2,1,0,2,3,16,16,0.0,M2019-03-20D,Race(8),,
9,0,0,0,0,0,0,8,8,0,0,2,2,0,0,10,10,10,10,3.0,M2019-03-20D,Race(8),,
10,3,0,2,5,8,0,4,12,0,1,5,6,11,1,11,23,9,9,1.0,M2019-03-20D,Race(8),,
11,0,2,5,7,0,0,2,2,1,0,1,2,1,2,8,11,10,10,0.0,M2019-03-20D,Race(8),,
12,0,0,0,0,0,0,0,0,0,0,0,0,0,0,0,0,34,34,0.0,M2019-03-20D,Race(8),,
1,13,3,5,21,9,4,2,15,13,5,2,20,35,12,9,56,3.6,3.6,2.0,M2019-03-24D,Race(1),,
2,0,0,0,0,0,0,0,0,0,0,0,0,0,0,0,0,19,19,3.0,M2019-03-24D,Race(1),,
3,0,0,0,0,0,0,0,0,0,1,1,2,0,1,1,2,14,14,0.0,M2019-03-24D,Race(1),,
4,0,0,0,0,0,0,0,0,0,0,0,0,0,0,0,0,51,51,0.0,M2019-03-24D,Race(1),,
5,0,2,2,4,0,1,1,2,3,2,0,5,3,5,3,11,41,41,0.0,M2019-03-24D,Race(1),,
6,0,9,6,15,1,2,1,4,3,5,2,10,4,16,9,29,5,5,0.0,M2019-03-24D,Race(1),,
7,3,8,0,11,0,0,1,1,0,0,2,2,3,8,3,14,13,13,0.0,M2019-03-24D,Race(1),,
8,9,2,5,16,1,2,2,5,2,4,1,7,12,8,8,28,8,8,0.0,M2019-03-24D,Race(1),,
9,0,0,2,2,0,0,2,2,0,0,2,2,0,0,6,6,34,34,0.0,M2019-03-24D,Race(1),,
10,0,0,0,0,2,2,2,6,2,3,2,7,4,5,4,13,12,12,0.0,M2019-03-24D,Race(1),,
11,5,3,10,18,2,2,4,8,1,1,11,13,8,6,25,39,5.5,5.5,0.0,M2019-03-24D,Race(1),,
12,0,3,0,3,1,3,1,5,2,5,3,10,3,11,4,18,13,13,0.0,M2019-03-24D,Race(1),,
13,0,0,0,0,0,0,0,0,0,0,0,0,0,0,0,0,41,41,1.0,M2019-03-24D,Race(1),,
14,0,0,0,0,0,0,0,0,0,0,0,0,0,0,0,0,31,31,0.0,M2019-03-24D,Race(1),,
1,2,8,7,17,5,6,2,13,6,7,5,18,13,21,14,48,6,6,1.0,M2019-03-24D,Race(10),,
2,2,7,3,12,1,1,3,5,2,3,2,7,5,11,8,24,13,13,0.0,M2019-03-24D,Race(10),,
3,21,3,2,26,10,4,1,15,14,5,2,21,45,12,5,62,3.3,3.3,3.0,M2019-03-24D,Race(10),,
4,0,0,0,0,0,0,0,0,0,0,0,0,0,0,0,0,51,51,0.0,M2019-03-24D,Race(10),,
5,0,2,0,2,0,1,1,2,0,3,2,5,0,6,3,9,14,14,0.0,M2019-03-24D,Race(10),,
6,0,3,3,6,0,1,3,4,1,3,4,8,1,7,10,18,14,14,0.0,M2019-03-24D,Race(10),,
7,0,0,0,0,0,0,0,0,0,0,0,0,0,0,0,0,71,67,0.0,M2019-03-24D,Race(10),,
8,0,2,6,8,0,0,0,0,1,1,0,2,1,3,6,10,8,8,0.0,M2019-03-24D,Race(10),,
9,0,3,4,7,0,3,5,8,0,3,7,10,0,9,16,25,9.5,9.5,0.0,M2019-03-24D,Race(10),,
10,3,0,2,5,0,0,1,1,2,1,4,7,5,1,7,13,8,8,0.0,M2019-03-24D,Race(10),,
11,0,0,0,0,0,0,0,0,0,0,0,0,0,0,0,0,21,21,2.0,M2019-03-24D,Race(10),,
12,2,0,0,2,0,0,0,0,0,0,0,0,2,0,0,2,13,13,0.0,M2019-03-24D,Race(10),,
13,0,0,0,0,0,0,0,0,0,0,0,0,0,0,0,0,81,81,0.0,M2019-03-24D,Race(10),,
14,0,2,3,5,0,0,0,0,0,0,0,0,0,2,3,5,16,16,0.0,M2019-03-24D,Race(10),,
1,5,17,6,28,8,3,4,15,8,8,4,20,21,28,14,63,5,5,0.0,M2019-03-24D,Race(2),,
2,0,0,0,0,0,0,0,0,0,0,0,0,0,0,0,0,0,0,0.0,M2019-03-24D,Race(2),,
3,0,0,2,2,0,0,0,0,0,1,0,1,0,1,2,3,19,19,3.0,M2019-03-24D,Race(2),,
4,0,0,0,0,0,0,0,0,0,1,0,1,0,1,0,1,126,126,0.0,M2019-03-24D,Race(2),,
5,3,8,14,25,2,8,3,13,1,11,9,21,6,27,26,59,7,7,0.0,M2019-03-24D,Race(2),,
6,0,0,0,0,0,0,0,0,0,0,0,0,0,0,0,0,31,31,0.0,M2019-03-24D,Race(2),,
7,0,0,0,0,0,0,0,0,0,0,0,0,0,0,0,0,101,101,0.0,M2019-03-24D,Race(2),,
8,22,0,6,28,6,4,5,15,15,2,6,23,43,6,17,66,1.6,1.6,1.0,M2019-03-24D,Race(2),,
9,0,5,2,7,0,1,3,4,0,3,3,6,0,9,8,17,10,10,2.0,M2019-03-24D,Race(2),,
10,0,0,0,0,0,0,0,0,0,0,2,2,0,0,2,2,101,101,0.0,M2019-03-24D,Race(2),,
11,0,0,0,0,0,0,0,0,0,0,0,0,0,0,0,0,81,81,0.0,M2019-03-24D,Race(2),,
12,0,0,0,0,0,0,1,1,0,0,2,2,0,0,3,3,13,13,0.0,M2019-03-24D,Race(2),,
13,0,0,0,0,0,0,0,0,0,0,0,0,0,0,0,0,0,0,0.0,M2019-03-24D,Race(2),,
14,0,0,0,0,0,0,0,0,0,0,0,0,0,0,0,0,101,101,0.0,M2019-03-24D,Race(2),,
1,0,0,0,0,2,0,0,2,0,0,0,0,2,0,0,2,19,19,0.0,M2019-03-24D,Race(3),,
2,0,0,0,0,0,0,0,0,1,0,0,1,1,0,0,1,41,41,0.0,M2019-03-24D,Race(3),,
3,15,5,8,28,6,6,3,15,6,7,8,21,27,18,19,64,2.9,2.9,1.0,M2019-03-24D,Race(3),,
4,11,15,2,28,7,6,1,14,17,7,1,25,35,28,4,67,4.4,4.4,0.0,M2019-03-24D,Race(3),,
5,0,3,0,3,0,0,0,0,0,0,2,2,0,3,2,5,18,18,0.0,M2019-03-24D,Race(3),,
6,0,2,2,4,0,0,1,1,0,0,1,1,0,2,4,6,21,21,0.0,M2019-03-24D,Race(3),,
7,4,3,10,17,0,1,4,5,1,9,3,13,5,13,17,35,9,9,2.0,M2019-03-24D,Race(3),,
8,0,0,0,0,0,0,0,0,0,0,0,0,0,0,0,0,15,15,0.0,M2019-03-24D,Race(3),,
9,0,2,6,8,1,3,5,9,1,3,6,10,2,8,17,27,5,5,0.0,M2019-03-24D,Race(3),,
10,0,0,0,0,0,0,0,0,0,0,0,0,0,0,0,0,61,67,0.0,M2019-03-24D,Race(3),,
11,0,0,2,2,0,0,2,2,0,0,5,5,0,0,9,9,12,12,0.0,M2019-03-24D,Race(3),,
12,0,0,0,0,0,0,0,0,0,0,0,0,0,0,0,0,26,26,3.0,M2019-03-24D,Race(3),,
1,12,8,4,24,10,4,1,15,17,5,2,24,39,17,7,63,3.2,3.2,2.0,M2019-03-24D,Race(4),,
2,3,5,0,8,0,1,1,2,0,1,0,1,3,7,1,11,7,7,0.0,M2019-03-24D,Race(4),,
3,2,8,3,13,1,0,2,3,2,0,3,5,5,8,8,21,10,10,0.0,M2019-03-24D,Race(4),,
4,0,0,4,4,0,0,0,0,0,1,0,1,0,1,4,5,26,26,0.0,M2019-03-24D,Race(4),,
5,0,0,0,0,0,1,1,2,0,0,2,2,0,1,3,4,13,13,0.0,M2019-03-24D,Race(4),,
6,0,0,0,0,0,0,0,0,0,1,0,1,0,1,0,1,126,126,0.0,M2019-03-24D,Race(4),,
7,11,3,0,14,1,5,5,11,2,9,9,20,14,17,14,45,5,5,0.0,M2019-03-24D,Race(4),,
8,0,0,0,0,0,1,0,1,1,1,0,2,1,2,0,3,34,35,0.0,M2019-03-24D,Race(4),,
9,2,0,5,7,0,2,0,2,1,2,1,4,3,4,6,13,9,9,1.0,M2019-03-24D,Race(4),,
10,0,2,0,2,0,0,0,0,0,1,0,1,0,3,0,3,34,35,0.0,M2019-03-24D,Race(4),,
11,0,4,14,18,4,2,6,12,3,5,9,17,7,11,29,47,4.6,4.6,0.0,M2019-03-24D,Race(4),,
12,0,0,0,0,0,0,0,0,0,0,0,0,0,0,0,0,71,71,3.0,M2019-03-24D,Race(4),,
1,0,5,6,11,5,4,1,10,7,8,4,19,12,17,11,40,5,5,2.0,M2019-03-24D,Race(5),,
2,8,14,0,22,1,1,2,4,0,1,2,3,9,16,4,29,5,5,0.0,M2019-03-24D,Race(5),,
3,3,0,7,10,3,2,3,8,6,3,3,12,12,5,13,30,7,7,1.0,M2019-03-24D,Race(5),,
4,0,0,0,0,0,0,0,0,0,0,0,0,0,0,0,0,31,31,0.0,M2019-03-24D,Race(5),,
5,0,3,0,3,0,0,0,0,0,0,1,1,0,3,1,4,21,21,0.0,M2019-03-24D,Race(5),,
6,0,0,5,5,0,0,0,0,0,0,0,0,0,0,5,5,31,31,0.0,M2019-03-24D,Race(5),,
7,0,0,0,0,0,0,0,0,0,0,0,0,0,0,0,0,51,51,0.0,M2019-03-24D,Race(5),,
8,3,6,3,12,0,0,5,5,0,1,4,5,3,7,12,22,9,9,3.0,M2019-03-24D,Race(5),,
9,4,0,2,6,0,0,1,1,1,1,1,3,5,1,4,10,8.5,8.5,0.0,M2019-03-24D,Race(5),,
10,2,0,7,9,2,3,2,7,3,3,6,12,7,6,15,28,6.5,6.5,0.0,M2019-03-24D,Race(5),,
11,2,0,0,2,2,1,1,4,1,1,1,3,5,2,2,9,31,31,0.0,M2019-03-24D,Race(5),,
12,2,0,0,2,0,0,0,0,1,0,0,1,3,0,0,3,12,12,0.0,M2019-03-24D,Race(5),,
13,6,2,0,8,1,3,1,5,1,3,2,6,8,8,3,19,11,11,0.0,M2019-03-24D,Race(5),,
14,0,0,0,0,0,0,0,0,0,0,0,0,0,0,0,0,61,61,0.0,M2019-03-24D,Race(5),,
1,3,10,10,23,0,0,2,2,0,4,5,9,3,14,17,34,5.5,5.5,3.0,M2019-03-24D,Race(6),,
2,2,0,0,2,1,2,4,7,1,0,3,4,4,2,7,13,9.5,9.5,0.0,M2019-03-24D,Race(6),,
3,2,9,0,11,0,2,1,3,3,2,2,7,5,13,3,21,9.5,9.5,0.0,M2019-03-24D,Race(6),,
4,0,0,0,0,0,0,0,0,0,0,0,0,0,0,0,0,41,41,0.0,M2019-03-24D,Race(6),,
5,0,2,5,7,0,3,3,6,3,6,6,15,3,11,14,28,5,5,0.0,M2019-03-24D,Race(6),,
6,0,0,0,0,0,0,0,0,0,0,0,0,0,0,0,0,21,21,0.0,M2019-03-24D,Race(6),,
7,0,0,2,2,0,0,4,4,0,0,4,4,0,0,10,10,11,11,0.0,M2019-03-24D,Race(6),,
8,0,0,0,0,0,1,0,1,0,0,0,0,0,1,0,1,26,26,0.0,M2019-03-24D,Race(6),,
9,12,5,10,27,11,3,0,14,15,5,0,20,38,13,10,61,4.6,4.6,1.0,M2019-03-24D,Race(6),,
10,0,0,0,0,0,0,0,0,0,0,0,0,0,0,0,0,51,51,0.0,M2019-03-24D,Race(6),,
11,0,0,0,0,0,0,0,0,0,0,0,0,0,0,0,0,81,81,0.0,M2019-03-24D,Race(6),,
12,11,4,3,18,4,5,2,11,4,8,6,18,19,17,11,47,4.8,4.8,2.0,M2019-03-24D,Race(6),,
13,0,0,0,0,0,0,0,0,0,1,0,1,0,1,0,1,71,67,0.0,M2019-03-24D,Race(6),,
14,0,0,0,0,0,0,0,0,0,0,0,0,0,0,0,0,71,67,0.0,M2019-03-24D,Race(6),,
1,13,13,4,30,12,2,1,15,18,5,0,23,43,20,5,68,3.3,3.3,2.0,M2019-03-24D,Race(7),,
2,0,0,15,15,0,2,3,5,1,4,2,7,1,6,20,27,5,5,0.0,M2019-03-24D,Race(7),,
3,13,13,0,26,3,12,1,16,6,17,1,24,22,42,2,66,2.35,2.35,1.0,M2019-03-24D,Race(7),,
4,0,0,0,0,0,0,0,0,0,0,2,2,0,0,2,2,26,26,3.0,M2019-03-24D,Race(7),,
5,0,0,0,0,0,0,0,0,0,0,0,0,0,0,0,0,18,18,0.0,M2019-03-24D,Race(7),,
6,4,2,3,9,1,0,5,6,0,0,9,9,5,2,17,24,10,10,0.0,M2019-03-24D,Race(7),,
7,0,0,0,0,0,0,2,2,1,0,5,6,1,0,7,8,14,14,0.0,M2019-03-24D,Race(7),,
8,0,0,0,0,0,0,0,0,0,0,0,0,0,0,0,0,71,67,0.0,M2019-03-24D,Race(7),,
9,0,2,8,10,0,0,4,4,0,0,7,7,0,2,19,21,15,15,0.0,M2019-03-24D,Race(7),,
1,20,6,4,30,5,7,3,15,12,8,4,24,37,21,11,69,2.3,2.5,2.0,M2019-03-24D,Race(8),,
2,0,0,0,0,2,3,5,10,0,0,0,0,2,3,5,10,0,0,0.0,M2019-03-24D,Race(8),,
3,0,4,0,4,0,0,1,1,0,2,3,5,0,6,4,10,9,9,0.0,M2019-03-24D,Race(8),,
4,0,0,6,6,0,1,5,6,0,1,7,8,0,2,18,20,11,11,0.0,M2019-03-24D,Race(8),,
5,10,14,4,28,9,5,1,15,10,10,1,21,29,29,6,64,2.8,2.7,1.0,M2019-03-24D,Race(8),,
6,0,4,16,20,0,0,1,1,0,0,1,1,0,4,18,22,6.5,6.5,3.0,M2019-03-24D,Race(8),,
7,0,0,0,0,0,0,0,0,0,0,0,0,0,0,0,0,41,41,0.0,M2019-03-24D,Race(8),,
8,0,0,0,0,0,0,0,0,0,0,0,0,0,0,0,0,71,67,0.0,M2019-03-24D,Race(8),,
9,0,0,0,0,0,0,0,0,0,0,1,1,0,0,1,1,41,41,0.0,M2019-03-24D,Race(8),,
10,0,2,0,2,0,0,0,0,0,0,0,0,0,2,0,2,15,15,0.0,M2019-03-24D,Race(8),,
11,0,0,0,0,0,0,0,0,0,0,0,0,0,0,0,0,51,51,0.0,M2019-03-24D,Race(8),,
1,0,7,0,7,2,2,2,6,3,5,2,10,5,14,4,23,11,11,0.0,M2019-03-24D,Race(9),,
2,3,2,11,16,3,2,1,6,3,5,3,11,9,9,15,33,7.5,7.5,0.0,M2019-03-24D,Race(9),,
3,0,0,0,0,0,0,0,0,1,0,0,1,1,0,0,1,26,26,0.0,M2019-03-24D,Race(9),,
4,0,0,0,0,0,0,0,0,0,0,1,1,0,0,1,1,81,81,0.0,M2019-03-24D,Race(9),,
5,2,6,5,13,3,2,2,7,9,5,1,15,14,13,8,35,6.5,6.5,2.0,M2019-03-24D,Race(9),,
6,0,0,0,0,0,0,1,1,0,0,2,2,0,0,3,3,19,19,0.0,M2019-03-24D,Race(9),,
7,2,5,3,10,0,1,1,2,0,1,1,2,2,7,5,14,7.5,7.5,0.0,M2019-03-24D,Race(9),,
8,23,5,0,28,7,3,3,13,6,4,5,15,36,12,8,56,2.7,2.7,1.0,M2019-03-24D,Race(9),,
9,0,3,8,11,1,5,5,11,2,5,8,15,3,13,21,37,7,7,0.0,M2019-03-24D,Race(9),,
10,0,0,0,0,0,0,0,0,0,0,0,0,0,0,0,0,41,41,0.0,M2019-03-24D,Race(9),,
11,0,0,0,0,0,1,1,2,1,1,2,4,1,2,3,6,21,21,0.0,M2019-03-24D,Race(9),,
12,0,2,3,5,0,0,0,0,1,0,1,2,1,2,4,7,13,13,3.0,M2019-03-24D,Race(9),,
1,0,4,0,4,2,3,1,6,2,2,1,5,4,9,2,15,15,15,0.0,M2019-03-27D,Race(1),,
2,3,2,0,5,0,1,2,3,2,0,2,4,5,3,4,12,11,11,0.0,M2019-03-27D,Race(1),,
3,2,2,3,7,0,2,0,2,1,1,1,3,3,5,4,12,11,11,0.0,M2019-03-27D,Race(1),,
4,3,2,8,13,6,11,2,19,6,5,4,15,15,18,14,47,7.5,7.5,0.0,M2019-03-27D,Race(1),,
5,5,3,5,13,17,3,4,24,6,5,5,16,28,11,14,53,5,5,0.0,M2019-03-27D,Race(1),,
6,0,0,0,0,0,0,0,0,1,0,2,3,1,0,2,3,61,61,0.0,M2019-03-27D,Race(1),,
7,0,0,0,0,0,0,0,0,0,0,1,1,0,0,1,1,41,41,0.0,M2019-03-27D,Race(1),,
8,0,3,7,10,1,0,2,3,2,0,2,4,3,3,11,17,7.5,7.5,3.0,M2019-03-27D,Race(1),,
9,4,3,5,12,0,2,4,6,1,1,3,5,5,6,12,23,6.5,6.5,1.0,M2019-03-27D,Race(1),,
10,0,0,0,0,0,0,0,0,0,0,0,0,0,0,0,0,19,19,0.0,M2019-03-27D,Race(1),,
11,5,0,2,7,0,2,1,3,0,1,1,2,5,3,4,12,7.5,7.5,2.0,M2019-03-27D,Race(1),,
12,8,11,0,19,4,6,14,24,5,11,4,20,17,28,18,63,5.5,5.5,0.0,M2019-03-27D,Race(1),,
1,0,5,0,5,4,13,3,20,3,5,4,12,7,23,7,37,8.5,8.5,0.0,M2019-03-27D,Race(2),,
2,5,2,2,9,2,4,9,15,1,3,9,13,8,9,20,37,11,11,0.0,M2019-03-27D,Race(2),,
3,18,5,2,25,16,8,3,27,13,7,1,21,47,20,6,73,3.1,3.1,2.0,M2019-03-27D,Race(2),,
4,0,5,12,17,0,2,1,3,1,3,2,6,1,10,15,26,5,5,0.0,M2019-03-27D,Race(2),,
5,5,11,3,19,4,2,13,19,3,7,8,18,12,20,24,56,5.5,5.5,0.0,M2019-03-27D,Race(2),,
6,0,0,0,0,0,0,0,0,0,0,0,0,0,0,0,0,26,26,0.0,M2019-03-27D,Race(2),,
7,2,0,8,10,2,0,0,2,2,0,1,3,6,0,9,15,8,8,1.0,M2019-03-27D,Race(2),,
8,0,0,0,0,0,0,0,0,0,0,0,0,0,0,0,0,71,67,0.0,M2019-03-27D,Race(2),,
9,0,0,0,0,0,0,0,0,0,0,1,1,0,0,1,1,26,26,0.0,M2019-03-27D,Race(2),,
10,0,2,3,5,1,1,1,3,2,1,0,3,3,4,4,11,10,10,3.0,M2019-03-27D,Race(2),,
11,0,0,0,0,1,0,0,1,1,0,0,1,2,0,0,2,31,31,0.0,M2019-03-27D,Race(2),,
12,0,0,0,0,0,0,0,0,0,0,0,0,0,0,0,0,71,67,0.0,M2019-03-27D,Race(2),,
1,0,2,0,2,0,0,0,0,0,0,0,0,0,2,0,2,11,11,0.0,M2019-03-27D,Race(3),,
2,0,5,8,13,0,1,9,10,0,2,7,9,0,8,24,32,8.5,8.5,0.0,M2019-03-27D,Race(3),,
3,0,6,5,11,2,3,2,7,1,0,3,4,3,9,10,22,8.5,8.5,0.0,M2019-03-27D,Race(3),,
4,0,0,3,3,0,1,0,1,0,0,1,1,0,1,4,5,21,21,0.0,M2019-03-27D,Race(3),,
5,19,0,6,25,18,5,4,27,15,7,3,25,52,12,13,77,3.2,3.2,3.0,M2019-03-27D,Race(3),,
6,0,0,0,0,2,2,0,4,1,1,0,2,3,3,0,6,12,12,0.0,M2019-03-27D,Race(3),,
7,0,5,2,7,0,0,0,0,0,1,1,2,0,6,3,9,16,16,0.0,M2019-03-27D,Race(3),,
8,3,3,2,8,0,1,0,1,0,2,1,3,3,6,3,12,9.5,9.5,1.0,M2019-03-27D,Race(3),,
9,6,9,4,19,3,2,9,14,14,6,2,22,23,17,15,55,4.8,4.8,2.0,M2019-03-27D,Race(3),,
10,0,0,0,0,0,0,0,0,0,0,0,0,0,0,0,0,41,41,0.0,M2019-03-27D,Race(3),,
11,0,0,0,0,1,0,1,2,0,0,2,2,1,0,3,4,41,41,0.0,M2019-03-27D,Race(3),,
12,2,0,0,2,0,1,1,2,0,1,1,2,2,2,2,6,12,12,0.0,M2019-03-27D,Race(3),,
1,17,5,3,25,26,1,2,29,22,2,1,25,65,8,6,79,1.9,1.9,1.0,M2019-03-27D,Race(4),,
2,3,2,0,5,0,3,1,4,0,3,4,7,3,8,5,16,17,17,0.0,M2019-03-27D,Race(4),,
3,0,4,5,9,1,4,3,8,1,6,1,8,2,14,9,25,10,10,0.0,M2019-03-27D,Race(4),,
4,0,11,9,20,0,6,9,15,0,5,9,14,0,22,27,49,5,5,2.0,M2019-03-27D,Race(4),,
5,0,0,3,3,0,0,0,0,0,2,0,2,0,2,3,5,41,41,0.0,M2019-03-27D,Race(4),,
6,0,0,0,0,2,8,0,10,1,0,1,2,3,8,1,12,41,41,0.0,M2019-03-27D,Race(4),,
7,8,8,3,19,1,7,13,21,2,5,8,15,11,20,24,55,7.5,7.5,0.0,M2019-03-27D,Race(4),,
8,2,0,7,9,0,1,2,3,0,3,2,5,2,4,11,17,8.5,8.5,0.0,M2019-03-27D,Race(4),,
9,0,0,0,0,0,0,0,0,0,0,0,0,0,0,0,0,34,34,3.0,M2019-03-27D,Race(4),,
10,0,0,0,0,0,0,0,0,0,0,0,0,0,0,0,0,81,81,0.0,M2019-03-27D,Race(4),,
11,0,0,0,0,0,0,0,0,0,0,0,0,0,0,0,0,51,51,0.0,M2019-03-27D,Race(4),,
12,0,0,0,0,0,0,0,0,0,0,0,0,0,0,0,0,31,31,0.0,M2019-03-27D,Race(4),,
1,3,0,0,3,3,2,12,17,5,1,4,10,11,3,16,30,8.5,8.5,0.0,M2019-03-27D,Race(5),,
2,5,8,2,15,2,4,6,12,2,3,9,14,9,15,17,41,7,7,3.0,M2019-03-27D,Race(5),,
3,0,6,14,20,4,13,4,21,6,3,3,12,10,22,21,53,7,7,0.0,M2019-03-27D,Race(5),,
4,17,9,4,30,21,6,1,28,12,12,0,24,50,27,5,82,2.4,2.4,1.0,M2019-03-27D,Race(5),,
5,0,0,0,0,0,0,0,0,0,0,0,0,0,0,0,0,34,34,0.0,M2019-03-27D,Race(5),,
6,0,0,0,0,0,0,0,0,0,0,0,0,0,0,0,0,21,21,0.0,M2019-03-27D,Race(5),,
7,0,0,0,0,0,0,0,0,0,0,0,0,0,0,0,0,0,0,0.0,M2019-03-27D,Race(5),,
8,0,0,0,0,0,0,0,0,0,0,0,0,0,0,0,0,26,26,0.0,M2019-03-27D,Race(5),,
9,0,0,0,0,0,0,1,1,0,0,1,1,0,0,2,2,19,19,2.0,M2019-03-27D,Race(5),,
10,0,2,3,5,0,0,0,0,0,1,1,2,0,3,4,7,16,16,0.0,M2019-03-27D,Race(5),,
11,3,0,2,5,0,0,2,2,0,0,4,4,3,0,8,11,10,10,0.0,M2019-03-27D,Race(5),,
12,2,5,5,12,0,5,4,9,1,6,4,11,3,16,13,32,8,8,0.0,M2019-03-27D,Race(5),,
1,0,0,0,0,0,0,0,0,0,0,0,0,0,0,0,0,126,126,0.0,M2019-03-27D,Race(6),,
2,5,0,0,5,5,12,7,24,5,5,7,17,15,17,14,46,8.5,8.5,0.0,M2019-03-27D,Race(6),,
3,0,3,0,3,0,0,0,0,0,0,0,0,0,3,0,3,31,31,0.0,M2019-03-27D,Race(6),,
4,10,5,8,23,15,5,4,24,5,6,3,14,30,16,15,61,3.8,3.8,1.0,M2019-03-27D,Race(6),,
5,6,0,6,12,2,3,1,6,3,3,2,8,11,6,9,26,8,8,0.0,M2019-03-27D,Race(6),,
6,0,0,0,0,0,0,0,0,0,0,0,0,0,0,0,0,51,51,0.0,M2019-03-27D,Race(6),,
7,0,2,10,12,3,2,5,10,8,2,6,16,11,6,21,38,8,8,2.0,M2019-03-27D,Race(6),,
8,0,2,0,2,0,3,0,3,0,1,0,1,0,6,0,6,26,26,0.0,M2019-03-27D,Race(6),,
9,0,0,0,0,0,1,1,2,0,0,0,0,0,1,1,2,26,26,0.0,M2019-03-27D,Race(6),,
10,0,5,4,9,0,0,0,0,0,0,0,0,0,5,4,9,15,15,0.0,M2019-03-27D,Race(6),,
11,2,0,0,2,0,0,1,1,0,2,3,5,2,2,4,8,9,9,0.0,M2019-03-27D,Race(6),,
12,7,13,2,22,5,4,11,20,5,7,5,17,17,24,18,59,3,3,3.0,M2019-03-27D,Race(6),,
1,0,5,2,7,2,5,1,8,2,4,2,8,4,14,5,23,7.5,7.5,0.0,M2019-03-27D,Race(7),,
2,3,2,10,15,5,3,11,19,10,4,2,16,18,9,23,50,5,5,0.0,M2019-03-27D,Race(7),,
3,4,11,8,23,4,14,6,24,5,8,6,19,13,33,20,66,5.5,5.5,0.0,M2019-03-27D,Race(7),,
4,0,0,0,0,0,0,1,1,0,0,2,2,0,0,3,3,34,34,0.0,M2019-03-27D,Race(7),,
5,2,0,0,2,0,2,3,5,1,1,2,4,3,3,5,11,8.5,8.5,0.0,M2019-03-27D,Race(7),,
6,21,4,3,28,18,5,1,24,8,7,2,17,47,16,6,69,3.8,3.8,2.0,M2019-03-27D,Race(7),,
7,0,3,5,8,1,1,1,3,0,1,6,7,1,5,12,18,9,9,1.0,M2019-03-27D,Race(7),,
8,0,0,0,0,0,0,2,2,0,1,2,3,0,1,4,5,26,26,0.0,M2019-03-27D,Race(7),,
9,0,0,0,0,0,0,0,0,0,0,0,0,0,0,0,0,17,17,3.0,M2019-03-27D,Race(7),,
10,0,0,0,0,0,0,3,3,0,0,1,1,0,0,4,4,16,16,0.0,M2019-03-27D,Race(7),,
11,0,3,0,3,0,0,0,0,0,0,0,0,0,3,0,3,41,41,0.0,M2019-03-27D,Race(7),,
12,0,2,2,4,0,0,1,1,0,0,1,1,0,2,4,6,17,17,0.0,M2019-03-27D,Race(7),,
1,0,2,0,2,0,1,1,2,0,0,0,0,0,3,1,4,31,31,0.0,M2019-03-27D,Race(8),,
2,0,8,0,8,3,12,4,19,7,6,2,15,10,26,6,42,9,9,0.0,M2019-03-27D,Race(8),,
3,7,5,7,19,4,4,10,18,2,5,3,10,13,14,20,47,6,6,0.0,M2019-03-27D,Race(8),,
4,19,5,4,28,18,2,6,26,12,7,6,25,49,14,16,79,3.6,3.6,0.0,M2019-03-27D,Race(8),,
5,0,0,0,0,0,0,0,0,0,0,0,0,0,0,0,0,21,21,0.0,M2019-03-27D,Race(8),,
6,0,0,3,3,0,0,2,2,0,0,4,4,0,0,9,9,26,26,0.0,M2019-03-27D,Race(8),,
7,0,0,10,10,1,4,0,5,0,3,3,6,1,7,13,21,14,14,1.0,M2019-03-27D,Race(8),,
8,0,0,0,0,0,2,2,4,0,1,2,3,0,3,4,7,16,16,0.0,M2019-03-27D,Race(8),,
9,0,2,0,2,0,2,2,4,0,0,3,3,0,4,5,9,16,16,0.0,M2019-03-27D,Race(8),,
10,2,0,3,5,3,1,0,4,3,0,1,4,8,1,4,13,12,12,0.0,M2019-03-27D,Race(8),,
11,0,0,0,0,1,0,2,3,2,2,1,5,3,2,3,8,7,7,2.0,M2019-03-27D,Race(8),,
12,2,8,3,13,0,2,1,3,0,2,1,3,2,12,5,19,5,5,3.0,M2019-03-27D,Race(8),,
1,0,0,0,0,0,0,0,0,0,0,0,0,0,0,0,0,34,34,0.0,M2019-03-31D,Race(1),,
2,0,0,0,0,0,0,0,0,0,0,0,0,0,0,0,0,51,51,0.0,M2019-03-31D,Race(1),,
3,2,0,0,2,0,0,0,0,0,0,0,0,2,0,0,2,26,26,0.0,M2019-03-31D,Race(1),,
4,0,0,3,3,2,5,15,22,1,5,7,13,3,10,25,38,12,12,2.0,M2019-03-31D,Race(1),,
5,2,0,0,2,0,0,0,0,2,0,0,2,4,0,0,4,21,21,1.0,M2019-03-31D,Race(1),,
6,0,3,4,7,0,0,0,0,0,0,0,0,0,3,4,7,16,16,0.0,M2019-03-31D,Race(1),,
7,13,5,7,25,4,15,9,28,7,12,7,26,24,32,23,79,3.4,3.4,0.0,M2019-03-31D,Race(1),,
8,0,2,3,5,2,1,3,6,1,1,2,4,3,4,8,15,26,26,0.0,M2019-03-31D,Race(1),,
9,0,0,0,0,0,0,0,0,0,0,3,3,0,0,3,3,34,34,0.0,M2019-03-31D,Race(1),,
10,6,11,2,19,18,8,1,27,15,6,2,23,39,25,5,69,2.3,2.3,0.0,M2019-03-31D,Race(1),,
11,5,2,11,18,2,1,1,4,0,1,3,4,7,4,15,26,8.5,8.5,3.0,M2019-03-31D,Race(1),,
12,2,7,0,9,2,0,1,3,0,1,2,3,4,8,3,15,12,12,0.0,M2019-03-31D,Race(1),,
1,0,0,0,0,0,1,0,1,0,0,0,0,0,1,0,1,26,26,0.0,M2019-03-31D,Race(10),,
2,9,9,6,24,4,10,7,21,11,11,2,24,24,30,15,69,3.8,3.8,1.0,M2019-03-31D,Race(10),,
3,0,4,0,4,1,1,4,6,1,0,3,4,2,5,7,14,13,13,3.0,M2019-03-31D,Race(10),,
4,0,0,0,0,0,0,0,0,1,0,0,1,1,0,0,1,41,41,0.0,M2019-03-31D,Race(10),,
5,15,9,2,26,14,5,3,22,6,9,3,18,35,23,8,66,2.65,2.9,0.0,M2019-03-31D,Race(10),,
6,2,0,0,2,0,0,0,0,0,0,0,0,2,0,0,2,41,41,0.0,M2019-03-31D,Race(10),,
7,0,0,0,0,0,0,0,0,0,0,0,0,0,0,0,0,41,41,0.0,M2019-03-31D,Race(10),,
8,0,0,0,0,1,0,0,1,0,0,0,0,1,0,0,1,14,14,0.0,M2019-03-31D,Race(10),,
9,2,0,5,7,0,0,0,0,0,0,0,0,2,0,5,7,34,34,0.0,M2019-03-31D,Race(10),,
10,0,0,0,0,0,0,0,0,0,0,0,0,0,0,0,0,41,41,0.0,M2019-03-31D,Race(10),,
11,0,0,6,6,1,4,4,9,0,2,6,8,1,6,16,23,11,11,0.0,M2019-03-31D,Race(10),,
12,0,3,0,3,0,0,0,0,1,0,3,4,1,3,3,7,11,11,2.0,M2019-03-31D,Race(10),,
13,0,3,0,3,0,0,2,2,0,0,2,2,0,3,4,7,31,31,0.0,M2019-03-31D,Race(10),,
14,2,2,11,15,4,5,5,14,3,2,6,11,9,9,22,40,6.5,6.5,0.0,M2019-03-31D,Race(10),,
1,5,0,0,5,3,0,5,8,2,0,3,5,10,0,8,18,17,17,0.0,M2019-03-31D,Race(2),,
2,0,5,0,5,0,0,0,0,0,0,0,0,0,5,0,5,26,26,0.0,M2019-03-31D,Race(2),,
3,11,2,12,25,15,7,6,28,9,8,3,20,35,17,21,73,3.6,3.6,0.0,M2019-03-31D,Race(2),,
4,5,9,3,17,8,9,4,21,8,3,4,15,21,21,11,53,7,7,1.0,M2019-03-31D,Race(2),,
5,0,2,4,6,1,3,3,7,0,3,3,6,1,8,10,19,10,10,0.0,M2019-03-31D,Race(2),,
6,0,0,0,0,0,0,2,2,2,0,1,3,2,0,3,5,16,16,0.0,M2019-03-31D,Race(2),,
7,0,0,0,0,0,0,0,0,0,1,0,1,0,1,0,1,26,26,0.0,M2019-03-31D,Race(2),,
8,4,0,8,12,1,1,5,7,1,2,4,7,6,3,17,26,8,8,2.0,M2019-03-31D,Race(2),,
9,0,2,0,2,0,0,0,0,0,0,1,1,0,2,1,3,21,21,0.0,M2019-03-31D,Race(2),,
10,0,0,0,0,0,0,0,0,2,1,1,4,2,1,1,4,21,21,0.0,M2019-03-31D,Race(2),,
11,0,0,0,0,0,0,0,0,0,0,3,3,0,0,3,3,10,10,0.0,M2019-03-31D,Race(2),,
12,5,10,3,18,2,10,5,17,2,8,2,12,9,28,10,47,4.8,4.8,3.0,M2019-03-31D,Race(2),,
13,0,0,0,0,0,0,0,0,0,0,1,1,0,0,1,1,126,126,0.0,M2019-03-31D,Race(2),,
14,0,0,0,0,0,0,0,0,0,0,0,0,0,0,0,0,41,41,0.0,M2019-03-31D,Race(2),,
1,0,5,10,15,0,2,1,3,1,3,0,4,1,10,11,22,15,15,3.0,M2019-03-31D,Race(3),,
2,6,2,5,13,0,9,11,20,2,5,5,12,8,16,21,45,7,7,2.0,M2019-03-31D,Race(3),,
3,0,0,2,2,0,1,1,2,1,0,1,2,1,1,4,6,19,19,0.0,M2019-03-31D,Race(3),,
4,19,2,3,24,18,7,2,27,13,9,1,23,50,18,6,74,2.2,2.2,1.0,M2019-03-31D,Race(3),,
5,2,16,4,22,9,7,6,22,4,6,7,17,15,29,17,61,5,5,0.0,M2019-03-31D,Race(3),,
6,0,0,0,0,0,1,0,1,0,0,0,0,0,1,0,1,31,31,0.0,M2019-03-31D,Race(3),,
7,0,0,0,0,2,2,6,10,0,0,0,0,2,2,6,10,0,0,0.0,M2019-03-31D,Race(3),,
8,3,0,0,3,0,1,2,3,0,0,1,1,3,1,3,7,11,11,0.0,M2019-03-31D,Race(3),,
9,0,0,0,0,1,0,0,1,1,1,2,4,2,1,2,5,26,26,0.0,M2019-03-31D,Race(3),,
10,0,5,0,5,0,0,1,1,0,1,2,3,0,6,3,9,31,31,0.0,M2019-03-31D,Race(3),,
11,0,0,0,0,0,0,0,0,0,0,0,0,0,0,0,0,81,81,0.0,M2019-03-31D,Race(3),,
12,0,0,3,3,0,0,0,0,2,0,2,4,2,0,5,7,10,10,0.0,M2019-03-31D,Race(3),,
13,0,0,3,3,0,0,0,0,0,0,0,0,0,0,3,3,18,18,0.0,M2019-03-31D,Race(3),,
1,7,18,0,25,11,11,5,27,8,9,2,19,26,38,7,71,3.5,3.5,0.0,M2019-03-31D,Race(4),,
2,2,4,16,22,5,2,8,15,5,2,7,14,12,8,31,51,8,8,0.0,M2019-03-31D,Race(4),,
3,13,8,3,24,11,12,4,27,10,8,3,21,34,28,10,72,3.3,3.3,3.0,M2019-03-31D,Race(4),,
4,0,0,0,0,0,0,0,0,0,1,2,3,0,1,2,3,21,21,0.0,M2019-03-31D,Race(4),,
5,8,0,3,11,0,0,5,5,1,4,6,11,9,4,14,27,4.2,4.2,1.0,M2019-03-31D,Race(4),,
6,0,0,0,0,0,0,0,0,0,0,0,0,0,0,0,0,0,0,0.0,M2019-03-31D,Race(4),,
7,0,0,0,0,0,1,3,4,0,0,0,0,0,1,3,4,16,16,0.0,M2019-03-31D,Race(4),,
8,0,0,0,0,0,0,0,0,0,0,0,0,0,0,0,0,0,0,0.0,M2019-03-31D,Race(4),,
9,0,0,0,0,0,0,0,0,0,0,0,0,0,0,0,0,81,81,0.0,M2019-03-31D,Race(4),,
10,0,0,2,2,2,0,0,2,2,0,1,3,4,0,3,7,16,16,0.0,M2019-03-31D,Race(4),,
11,0,0,2,2,1,4,5,10,0,2,2,4,1,6,9,16,16,16,2.0,M2019-03-31D,Race(4),,
12,0,0,0,0,0,0,0,0,0,0,1,1,0,0,1,1,41,41,0.0,M2019-03-31D,Race(4),,
13,0,0,4,4,0,0,0,0,0,0,2,2,0,0,6,6,19,19,0.0,M2019-03-31D,Race(4),,
1,2,2,3,7,1,0,1,2,0,1,3,4,3,3,7,13,21,21,0.0,M2019-03-31D,Race(5),,
2,0,0,3,3,3,1,2,6,0,0,0,0,3,1,5,9,11,11,0.0,M2019-03-31D,Race(5),,
3,0,5,2,7,7,10,7,24,11,5,2,18,18,20,11,49,7.5,7.5,0.0,M2019-03-31D,Race(5),,
4,2,3,0,5,2,1,2,5,2,2,2,6,6,6,4,16,15,15,0.0,M2019-03-31D,Race(5),,
5,0,14,5,19,5,5,4,14,3,6,1,10,8,25,10,43,4.2,4.2,1.0,M2019-03-31D,Race(5),,
6,2,2,3,7,0,0,0,0,0,1,1,2,2,3,4,9,18,18,0.0,M2019-03-31D,Race(5),,
7,5,2,7,14,6,6,6,18,5,4,8,17,16,12,21,49,4.6,4.6,2.0,M2019-03-31D,Race(5),,
8,3,0,2,5,2,3,1,6,2,3,5,10,7,6,8,21,7.5,7.5,0.0,M2019-03-31D,Race(5),,
9,0,0,3,3,0,2,0,2,0,1,0,1,0,3,3,6,9,9,0.0,M2019-03-31D,Race(5),,
10,16,2,2,20,4,2,7,13,3,3,4,10,23,7,13,43,6,6,3.0,M2019-03-31D,Race(5),,
11,0,0,0,0,0,0,0,0,0,0,0,0,0,0,0,0,51,51,0.0,M2019-03-31D,Race(5),,
1,0,0,0,0,0,0,0,0,0,0,1,1,0,0,1,1,61,61,0.0,M2019-03-31D,Race(6),,
2,19,2,7,28,14,7,5,26,16,7,2,25,49,16,14,79,3.4,3.4,1.0,M2019-03-31D,Race(6),,
3,0,0,0,0,0,0,0,0,0,0,0,0,0,0,0,0,126,126,0.0,M2019-03-31D,Race(6),,
4,0,13,5,18,7,12,5,24,3,10,3,16,10,35,13,58,7,7,0.0,M2019-03-31D,Race(6),,
5,6,5,8,19,9,5,6,20,3,8,10,21,18,18,24,60,2.5,2.5,0.0,M2019-03-31D,Race(6),,
6,0,0,3,3,0,2,0,2,0,0,0,0,0,2,3,5,31,31,2.0,M2019-03-31D,Race(6),,
7,0,0,0,0,0,0,0,0,0,0,1,1,0,0,1,1,21,21,0.0,M2019-03-31D,Race(6),,
8,0,0,0,0,0,0,2,2,0,0,1,1,0,0,3,3,26,26,0.0,M2019-03-31D,Race(6),,
9,0,0,0,0,0,0,0,0,0,0,0,0,0,0,0,0,51,51,0.0,M2019-03-31D,Race(6),,
10,2,2,0,4,0,2,5,7,0,1,2,3,2,5,7,14,15,15,0.0,M2019-03-31D,Race(6),,
11,0,3,5,8,0,1,3,4,0,0,3,3,0,4,11,15,17,17,0.0,M2019-03-31D,Race(6),,
12,0,2,0,2,0,1,0,1,0,0,0,0,0,3,0,3,21,21,0.0,M2019-03-31D,Race(6),,
13,3,3,2,8,0,0,4,4,1,0,3,4,4,3,9,16,11,11,3.0,M2019-03-31D,Race(6),,
14,0,0,0,0,0,0,0,0,0,0,0,0,0,0,0,0,61,61,0.0,M2019-03-31D,Race(6),,
1,25,5,0,30,30,0,0,30,23,1,2,26,78,6,2,86,1.5,1.5,1.0,M2019-03-31D,Race(7),,
2,3,5,7,15,0,10,15,25,1,9,9,19,4,24,31,59,10,10,2.0,M2019-03-31D,Race(7),,
3,0,0,0,0,0,0,0,0,0,1,1,2,0,1,1,2,26,26,0.0,M2019-03-31D,Race(7),,
4,0,0,0,0,0,0,0,0,0,0,0,0,0,0,0,0,81,81,0.0,M2019-03-31D,Race(7),,
5,0,5,8,13,0,0,3,3,1,2,4,7,1,7,15,23,17,17,3.0,M2019-03-31D,Race(7),,
6,0,0,4,4,0,2,2,4,0,0,3,3,0,2,9,11,51,51,0.0,M2019-03-31D,Race(7),,
7,0,0,0,0,0,0,0,0,0,0,0,0,0,0,0,0,81,81,0.0,M2019-03-31D,Race(7),,
8,0,0,0,0,0,0,0,0,0,0,0,0,0,0,0,0,41,41,0.0,M2019-03-31D,Race(7),,
9,0,0,0,0,0,0,0,0,0,0,0,0,0,0,0,0,41,41,0.0,M2019-03-31D,Race(7),,
10,0,0,0,0,0,0,0,0,0,0,0,0,0,0,0,0,41,41,0.0,M2019-03-31D,Race(7),,
11,2,15,3,20,0,18,10,28,1,12,7,20,3,45,20,68,5.5,5.5,0.0,M2019-03-31D,Race(7),,
12,0,0,0,0,0,0,0,0,0,0,0,0,0,0,0,0,21,21,0.0,M2019-03-31D,Race(7),,
13,0,0,0,0,0,0,0,0,0,0,0,0,0,0,0,0,126,126,0.0,M2019-03-31D,Race(7),,
14,0,0,8,8,0,0,0,0,0,1,0,1,0,1,8,9,17,17,0.0,M2019-03-31D,Race(7),,
1,0,0,2,2,0,0,0,0,0,0,0,0,0,0,2,2,71,67,0.0,M2019-03-31D,Race(8),,
2,2,0,3,5,4,3,4,11,2,1,4,7,8,4,11,23,12,12,0.0,M2019-03-31D,Race(8),,
3,12,2,5,19,4,11,5,20,3,7,3,13,19,20,13,52,3.3,3.3,0.0,M2019-03-31D,Race(8),,
4,0,0,0,0,0,0,0,0,1,0,0,1,1,0,0,1,13,13,0.0,M2019-03-31D,Race(8),,
5,0,0,0,0,0,0,0,0,0,2,0,2,0,2,0,2,20,26,0.0,M2019-03-31D,Race(8),,
6,0,0,0,0,1,0,0,1,4,1,1,6,5,1,1,7,17,17,0.0,M2019-03-31D,Race(8),,
7,0,0,0,0,0,0,0,0,0,0,0,0,0,0,0,0,81,81,0.0,M2019-03-31D,Race(8),,
8,0,2,2,4,0,0,0,0,0,1,2,3,0,3,4,7,26,26,1.0,M2019-03-31D,Race(8),,
9,0,0,0,0,0,0,0,0,0,0,0,0,0,0,0,0,41,41,0.0,M2019-03-31D,Race(8),,
10,8,13,3,24,0,5,10,15,0,4,5,9,8,22,18,48,9.5,9.5,2.0,M2019-03-31D,Race(8),,
11,3,11,4,18,5,2,5,12,4,2,7,13,12,15,16,43,8,8,3.0,M2019-03-31D,Race(8),,
12,0,0,0,0,1,0,1,2,1,0,2,3,2,0,3,5,81,81,0.0,M2019-03-31D,Race(8),,
13,5,2,11,18,15,7,5,27,11,8,2,21,31,17,18,66,3,3,0.0,M2019-03-31D,Race(8),,
14,0,0,0,0,0,2,0,2,0,0,0,0,0,2,0,2,19,19,0.0,M2019-03-31D,Race(8),,
1,5,3,9,17,10,8,8,26,7,8,7,22,22,19,24,65,5.5,5.5,3.0,M2019-03-31D,Race(9),,
2,6,0,2,8,1,3,4,8,0,1,3,4,7,4,9,20,15,15,0.0,M2019-03-31D,Race(9),,
3,0,0,0,0,1,1,0,2,0,0,1,1,1,1,1,3,21,21,0.0,M2019-03-31D,Race(9),,
4,0,0,0,0,0,0,0,0,0,0,0,0,0,0,0,0,61,61,0.0,M2019-03-31D,Race(9),,
5,2,0,0,2,0,0,0,0,1,0,0,1,3,0,0,3,21,21,0.0,M2019-03-31D,Race(9),,
6,2,3,3,8,0,4,2,6,1,2,3,6,3,9,8,20,8.5,8.5,1.0,M2019-03-31D,Race(9),,
7,0,0,0,0,0,0,1,1,0,0,0,0,0,0,1,1,26,26,0.0,M2019-03-31D,Race(9),,
8,0,0,3,3,0,0,0,0,0,0,1,1,0,0,4,4,14,14,0.0,M2019-03-31D,Race(9),,
9,0,2,0,2,0,1,3,4,0,0,2,2,0,3,5,8,21,21,0.0,M2019-03-31D,Race(9),,
10,10,7,8,25,16,7,7,30,15,6,3,24,41,20,18,79,3.1,2.9,2.0,M2019-03-31D,Race(9),,
11,5,13,5,23,1,6,4,11,2,8,5,15,8,27,14,49,4,4,0.0,M2019-03-31D,Race(9),,
12,0,2,0,2,1,0,1,2,0,0,1,1,1,2,2,5,15,15,0.0,M2019-03-31D,Race(9),,
13,0,0,0,0,0,0,0,0,0,1,0,1,0,1,0,1,34,34,0.0,M2019-03-31D,Race(9),,
1,3,9,2,14,2,2,3,7,5,3,1,9,10,14,6,30,6.5,6.5,0.0,M2019-04-03D,Race(1),,
2,0,0,0,0,0,1,0,1,0,0,0,0,0,1,0,1,14,14,0.0,M2019-04-03D,Race(1),,
3,4,5,5,14,3,6,4,13,3,5,3,11,10,16,12,38,8,8,0.0,M2019-04-03D,Race(1),,
4,0,0,0,0,1,1,0,2,2,2,1,5,3,3,1,7,34,34,0.0,M2019-04-03D,Race(1),,
5,0,0,0,0,0,0,1,1,0,1,2,3,0,1,3,4,21,21,0.0,M2019-04-03D,Race(1),,
6,21,7,2,30,11,8,8,27,10,6,2,18,42,21,12,75,3.5,3.5,0.0,M2019-04-03D,Race(1),,
7,0,0,0,0,0,1,1,2,1,2,4,7,1,3,5,9,9,9,2.0,M2019-04-03D,Race(1),,
8,0,4,7,11,8,9,2,19,1,4,2,7,9,17,11,37,13,13,0.0,M2019-04-03D,Race(1),,
9,0,0,2,2,2,0,0,2,1,0,1,2,3,0,3,6,21,21,1.0,M2019-04-03D,Race(1),,
10,0,3,9,12,2,1,4,7,2,2,3,7,4,6,16,26,7,7,3.0,M2019-04-03D,Race(1),,
11,0,0,0,0,0,0,0,0,0,0,0,0,0,0,0,0,51,51,0.0,M2019-04-03D,Race(1),,
12,2,2,3,7,1,1,7,9,1,1,7,9,4,4,17,25,7.5,7.5,0.0,M2019-04-03D,Race(1),,
13,0,0,0,0,0,0,0,0,0,0,0,0,0,0,0,0,31,31,0.0,M2019-04-03D,Race(1),,
1,0,0,0,0,0,0,0,0,0,0,0,0,0,0,0,0,71,67,0.0,M2019-04-03D,Race(2),,
2,2,5,2,9,0,1,2,3,0,0,2,2,2,6,6,14,18,18,0.0,M2019-04-03D,Race(2),,
3,0,3,0,3,0,1,0,1,0,0,0,0,0,4,0,4,15,15,0.0,M2019-04-03D,Race(2),,
4,0,0,0,0,0,0,0,0,1,0,1,2,1,0,1,2,101,101,0.0,M2019-04-03D,Race(2),,
5,0,0,0,0,7,7,8,22,0,0,1,1,7,7,9,23,21,21,0.0,M2019-04-03D,Race(2),,
6,9,7,5,21,13,4,5,22,13,6,4,23,35,17,14,66,2.8,2.8,1.0,M2019-04-03D,Race(2),,
7,8,0,0,8,0,7,3,10,1,10,3,14,9,17,6,32,7.5,7.5,0.0,M2019-04-03D,Race(2),,
8,0,0,0,0,0,0,0,0,0,0,1,1,0,0,1,1,17,17,0.0,M2019-04-03D,Race(2),,
9,3,3,8,14,3,3,1,7,5,6,2,13,11,12,11,34,5,5,3.0,M2019-04-03D,Race(2),,
10,6,5,4,15,5,3,4,12,3,2,4,9,14,10,12,36,6.5,6.5,0.0,M2019-04-03D,Race(2),,
11,2,5,8,15,1,4,7,12,2,2,7,11,5,11,22,38,7,7,0.0,M2019-04-03D,Race(2),,
12,0,2,3,5,1,0,0,1,1,0,1,2,2,2,4,8,26,26,2.0,M2019-04-03D,Race(2),,
1,6,16,8,30,6,8,8,22,4,8,9,21,16,32,25,73,4.8,4.8,0.0,M2019-04-03D,Race(3),,
2,0,0,2,2,8,11,8,27,1,3,1,5,9,14,11,34,19,19,0.0,M2019-04-03D,Race(3),,
3,0,11,15,26,6,6,6,18,5,8,8,21,11,25,29,65,3.8,3.8,3.0,M2019-04-03D,Race(3),,
4,0,0,0,0,0,0,0,0,1,1,0,2,1,1,0,2,41,41,0.0,M2019-04-03D,Race(3),,
5,0,0,0,0,0,0,1,1,0,0,0,0,0,0,1,1,17,17,0.0,M2019-04-03D,Race(3),,
6,2,0,0,2,0,0,0,0,0,1,4,5,2,1,4,7,12,12,1.0,M2019-04-03D,Race(3),,
7,22,3,5,30,10,5,6,21,15,5,3,23,47,13,14,74,2,2,2.0,M2019-04-03D,Race(3),,
8,0,0,0,0,0,0,0,0,0,0,0,0,0,0,0,0,0,0,0.0,M2019-04-03D,Race(3),,
9,0,0,0,0,0,0,1,1,0,0,1,1,0,0,2,2,15,15,0.0,M2019-04-03D,Race(3),,
10,0,0,0,0,0,0,1,1,0,0,0,0,0,0,1,1,0,0,0.0,M2019-04-03D,Race(3),,
11,0,0,0,0,0,0,0,0,0,0,0,0,0,0,0,0,0,0,0.0,M2019-04-03D,Race(3),,
12,0,0,0,0,0,0,0,0,0,0,0,0,0,0,0,0,0,0,0.0,M2019-04-03D,Race(3),,
13,0,0,0,0,0,0,0,0,0,0,0,0,0,0,0,0,0,0,0.0,M2019-04-03D,Race(3),,
14,0,0,0,0,0,0,0,0,0,0,0,0,0,0,0,0,0,0,0.0,M2019-04-03D,Race(3),,
1,3,0,2,5,6,2,1,9,5,3,2,10,14,5,5,24,8.5,8.5,0.0,M2019-04-03D,Race(4),,
2,2,5,3,10,4,6,1,11,5,3,2,10,11,14,6,31,9.5,9.5,2.0,M2019-04-03D,Race(4),,
3,3,6,5,14,8,9,9,26,1,1,3,5,12,16,17,45,6,6,3.0,M2019-04-03D,Race(4),,
4,5,3,2,10,2,3,4,9,6,2,5,13,13,8,11,32,6.5,6.5,0.0,M2019-04-03D,Race(4),,
5,7,0,0,7,0,1,0,1,0,2,0,2,7,3,0,10,17,17,0.0,M2019-04-03D,Race(4),,
6,0,2,3,5,1,0,1,2,0,2,1,3,1,4,5,10,12,12,0.0,M2019-04-03D,Race(4),,
7,0,0,0,0,0,1,1,2,1,0,2,3,1,1,3,5,19,19,0.0,M2019-04-03D,Race(4),,
8,0,9,4,13,1,1,4,6,1,1,5,7,2,11,13,26,11,11,0.0,M2019-04-03D,Race(4),,
9,0,0,0,0,0,0,1,1,0,0,0,0,0,0,1,1,34,35,1.0,M2019-04-03D,Race(4),,
10,2,2,0,4,0,2,2,4,0,4,1,5,2,8,3,13,12,12,0.0,M2019-04-03D,Race(4),,
11,6,3,8,17,8,3,6,17,7,8,4,19,21,14,18,53,3.5,3.5,0.0,M2019-04-03D,Race(4),,
12,2,0,3,5,0,2,0,2,0,0,1,1,2,2,4,8,19,19,0.0,M2019-04-03D,Race(4),,
1,6,4,2,12,1,8,8,17,4,8,3,15,11,20,13,44,4.6,4.6,2.0,M2019-04-03D,Race(5),,
2,3,13,5,21,4,8,6,18,5,6,7,18,12,27,18,57,6,6,0.0,M2019-04-03D,Race(5),,
3,9,3,3,15,8,7,11,26,2,3,6,11,19,13,20,52,5.5,5.5,0.0,M2019-04-03D,Race(5),,
4,0,0,0,0,0,0,0,0,1,0,0,1,1,0,0,1,41,41,0.0,M2019-04-03D,Race(5),,
5,0,0,5,5,1,0,2,3,1,1,3,5,2,1,10,13,13,13,0.0,M2019-04-03D,Race(5),,
6,0,0,0,0,0,0,0,0,0,1,0,1,0,1,0,1,31,31,0.0,M2019-04-03D,Race(5),,
7,2,0,0,2,0,0,0,0,0,0,1,1,2,0,1,3,21,21,1.0,M2019-04-03D,Race(5),,
8,0,3,6,9,1,2,1,4,1,0,1,2,2,5,8,15,8,8,0.0,M2019-04-03D,Race(5),,
9,0,0,0,0,0,0,0,0,0,0,0,0,0,0,0,0,41,41,0.0,M2019-04-03D,Race(5),,
10,10,5,7,22,15,4,2,21,12,6,5,23,37,15,14,66,2.9,2.9,3.0,M2019-04-03D,Race(5),,
11,0,2,2,4,0,1,0,1,0,1,0,1,0,4,2,6,26,26,0.0,M2019-04-03D,Race(5),,
1,0,0,0,0,0,0,0,0,0,0,0,0,0,0,0,0,51,51,0.0,M2019-04-03D,Race(6),,
2,13,10,2,25,13,3,2,18,14,3,2,19,40,16,6,62,3.8,3.8,0.0,M2019-04-03D,Race(6),,
3,7,0,2,9,4,9,2,15,8,8,1,17,19,17,5,41,4.2,4.2,1.0,M2019-04-03D,Race(6),,
4,5,0,8,13,8,9,10,27,1,2,2,5,14,11,20,45,7.5,7.5,0.0,M2019-04-03D,Race(6),,
5,0,0,0,0,0,0,0,0,0,0,2,2,0,0,2,2,61,61,0.0,M2019-04-03D,Race(6),,
6,0,0,0,0,0,0,0,0,0,0,0,0,0,0,0,0,12,12,0.0,M2019-04-03D,Race(6),,
7,0,10,8,18,5,5,6,16,3,6,8,17,8,21,22,51,8,8,0.0,M2019-04-03D,Race(6),,
8,5,7,8,20,0,2,3,5,0,2,3,5,5,11,14,30,6.5,6.5,3.0,M2019-04-03D,Race(6),,
9,0,0,0,0,0,0,0,0,0,0,0,0,0,0,0,0,81,81,0.0,M2019-04-03D,Race(6),,
10,0,0,0,0,0,1,1,2,0,2,0,2,0,3,1,4,21,21,0.0,M2019-04-03D,Race(6),,
11,0,0,0,0,0,0,1,1,0,1,1,2,0,1,2,3,17,17,2.0,M2019-04-03D,Race(6),,
12,0,3,2,5,0,1,5,6,0,2,7,9,0,6,14,20,8,8,0.0,M2019-04-03D,Race(6),,
1,0,0,0,0,0,0,0,0,0,0,0,0,0,0,0,0,61,67,0.0,M2019-04-03D,Race(7),,
2,0,0,0,0,0,0,0,0,0,0,0,0,0,0,0,0,71,67,0.0,M2019-04-03D,Race(7),,
3,0,3,2,5,2,3,7,12,3,1,6,10,5,7,15,27,11,11,0.0,M2019-04-03D,Race(7),,
4,3,0,10,13,7,9,12,28,1,2,6,9,11,11,28,50,7,7,0.0,M2019-04-03D,Race(7),,
5,0,0,3,3,0,0,0,0,0,1,0,1,0,1,3,4,41,41,0.0,M2019-04-03D,Race(7),,
6,0,3,0,3,1,3,1,5,0,2,2,4,1,8,3,12,17,17,0.0,M2019-04-03D,Race(7),,
7,21,3,3,27,16,5,1,22,17,7,1,25,54,15,5,74,1.65,1.65,1.0,M2019-04-03D,Race(7),,
8,3,5,4,12,0,0,3,3,0,1,5,6,3,6,12,21,10,10,3.0,M2019-04-03D,Race(7),,
9,3,16,8,27,4,10,6,20,5,12,6,23,12,38,20,70,3.4,4,2.0,M2019-04-03D,Race(7),,
10,0,0,0,0,0,0,0,0,0,0,0,0,0,0,0,0,51,51,0.0,M2019-04-03D,Race(7),,
1,0,2,0,2,0,1,3,4,1,0,1,2,1,3,4,8,14,15,0.0,M2019-04-03D,Race(8),,
2,0,0,0,0,0,0,2,2,3,0,5,8,3,0,7,10,21,21,0.0,M2019-04-03D,Race(8),,
3,5,8,8,21,14,8,12,34,9,6,3,18,28,22,23,73,3.6,4,0.0,M2019-04-03D,Race(8),,
4,0,3,0,3,0,0,0,0,0,1,0,1,0,4,0,4,41,41,3.0,M2019-04-03D,Race(8),,
5,0,3,6,9,6,6,3,15,4,4,5,13,10,13,14,37,8,8,0.0,M2019-04-03D,Race(8),,
6,0,11,0,11,0,5,5,10,0,6,3,9,0,22,8,30,8,8,0.0,M2019-04-03D,Race(8),,
7,0,0,0,0,1,0,1,2,1,0,1,2,2,0,2,4,17,18,2.0,M2019-04-03D,Race(8),,
8,0,0,0,0,0,0,0,0,0,1,0,1,0,1,0,1,34,34,0.0,M2019-04-03D,Race(8),,
9,3,0,0,3,2,0,1,3,3,1,2,6,8,1,3,12,8,8,0.0,M2019-04-03D,Race(8),,
10,0,0,0,0,0,0,0,0,0,0,0,0,0,0,0,0,51,51,0.0,M2019-04-03D,Race(8),,
11,3,0,6,9,0,2,1,3,0,0,2,2,3,2,9,14,15,15,0.0,M2019-04-03D,Race(8),,
12,4,0,0,4,0,0,0,0,0,0,0,0,4,0,0,4,26,26,0.0,M2019-04-03D,Race(8),,
13,15,3,7,25,7,6,2,15,5,5,2,12,27,14,11,52,3.5,4,1.0,M2019-04-03D,Race(8),,
14,0,0,3,3,0,2,0,2,0,2,2,4,0,4,5,9,12,12,0.0,M2019-04-03D,Race(8),,
1,3,2,3,8,3,0,0,3,0,0,2,2,6,2,5,13,18,18,0.0,M2019-04-07D,Race(1),,
2,0,0,0,0,0,0,8,8,0,0,1,1,0,0,9,9,26,26,0.0,M2019-04-07D,Race(1),,
3,7,7,3,17,5,7,6,18,8,8,4,20,20,22,13,55,2.6,2.6,0.0,M2019-04-07D,Race(1),,
4,2,5,12,19,8,6,9,23,2,6,9,17,12,17,30,59,4.2,4.2,0.0,M2019-04-07D,Race(1),,
5,0,0,0,0,0,0,0,0,0,0,0,0,0,0,0,0,101,101,0.0,M2019-04-07D,Race(1),,
6,0,0,0,0,0,8,1,9,0,0,1,1,0,8,2,10,23,23,3.0,M2019-04-07D,Race(1),,
7,0,3,5,8,1,3,2,6,2,4,1,7,3,10,8,21,13,15,0.0,M2019-04-07D,Race(1),,
8,15,13,2,30,12,5,2,19,13,5,2,20,40,23,6,69,3.1,3.1,1.0,M2019-04-07D,Race(1),,
9,0,0,0,0,0,0,0,0,0,0,0,0,0,0,0,0,81,81,0.0,M2019-04-07D,Race(1),,
10,3,0,5,8,1,1,2,4,1,2,6,9,5,3,13,21,10,10,2.0,M2019-04-07D,Race(1),,
11,0,0,0,0,0,0,0,0,0,1,0,1,0,1,0,1,126,126,0.0,M2019-04-07D,Race(1),,
1,15,5,5,25,8,9,3,20,9,10,2,21,32,24,10,66,4.8,5,1.0,M2019-04-07D,Race(10),,
2,0,4,0,4,0,0,0,0,1,0,1,2,1,4,1,6,21,21,0.0,M2019-04-07D,Race(10),,
3,0,0,2,2,0,0,0,0,1,0,1,2,1,0,3,4,16,17,0.0,M2019-04-07D,Race(10),,
4,0,0,0,0,0,0,0,0,0,0,0,0,0,0,0,0,26,27,0.0,M2019-04-07D,Race(10),,
5,2,6,10,18,3,3,5,11,3,4,4,11,8,13,19,40,9.5,8.5,0.0,M2019-04-07D,Race(10),,
6,0,0,0,0,0,0,2,2,1,0,2,3,1,0,4,5,11,11,0.0,M2019-04-07D,Race(10),,
7,0,2,3,5,9,3,4,16,2,2,4,8,11,7,11,29,8,7.5,3.0,M2019-04-07D,Race(10),,
8,0,0,0,0,0,0,8,8,0,0,1,1,0,0,9,9,18,17,0.0,M2019-04-07D,Race(10),,
9,0,0,2,2,0,0,0,0,0,0,0,0,0,0,2,2,26,26,0.0,M2019-04-07D,Race(10),,
10,0,0,0,0,0,0,0,0,0,0,0,0,0,0,0,0,91,81,0.0,M2019-04-07D,Race(10),,
11,10,8,5,23,8,7,5,20,7,9,7,23,25,24,17,66,2.75,2.8,0.0,M2019-04-07D,Race(10),,
12,0,0,0,0,0,0,0,0,0,0,0,0,0,0,0,0,51,46,0.0,M2019-04-07D,Race(10),,
13,3,5,3,11,2,8,3,13,2,1,4,7,7,14,10,31,9.5,9.5,2.0,M2019-04-07D,Race(10),,
14,0,0,0,0,0,0,0,0,0,0,0,0,0,0,0,0,91,81,0.0,M2019-04-07D,Race(10),,
1,0,2,0,2,0,0,0,0,0,0,0,0,0,2,0,2,41,51,0.0,M2019-04-07D,Race(2),,
2,0,2,2,4,0,1,5,6,0,2,3,5,0,5,10,15,34,35,0.0,M2019-04-07D,Race(2),,
3,0,0,0,0,0,0,0,0,0,0,1,1,0,0,1,1,51,51,0.0,M2019-04-07D,Race(2),,
4,7,18,3,28,10,9,3,22,7,11,3,21,24,38,9,71,3.1,3.2,1.0,M2019-04-07D,Race(2),,
5,0,0,0,0,0,0,0,0,1,0,0,1,1,0,0,1,101,101,0.0,M2019-04-07D,Race(2),,
6,0,0,3,3,0,0,4,4,3,0,7,10,3,0,14,17,8.5,8.5,3.0,M2019-04-07D,Race(2),,
7,19,3,6,28,10,11,2,23,14,7,2,23,43,21,10,74,2.6,2.7,0.0,M2019-04-07D,Race(2),,
8,0,0,0,0,0,8,0,8,0,0,0,0,0,8,0,8,126,126,0.0,M2019-04-07D,Race(2),,
9,2,5,9,16,9,2,6,17,1,4,5,10,12,11,20,43,7,7,0.0,M2019-04-07D,Race(2),,
10,0,0,3,3,0,0,2,2,0,0,1,1,0,0,6,6,17,17,0.0,M2019-04-07D,Race(2),,
11,0,0,0,0,0,0,8,8,0,1,1,2,0,1,9,10,15,15,0.0,M2019-04-07D,Race(2),,
12,0,0,0,0,0,0,0,0,0,0,0,0,0,0,0,0,151,151,0.0,M2019-04-07D,Race(2),,
13,2,0,0,2,0,0,0,0,0,0,2,2,2,0,2,4,16,16,2.0,M2019-04-07D,Race(2),,
14,0,0,4,4,0,0,0,0,0,1,1,2,0,1,5,6,18,18,0.0,M2019-04-07D,Race(2),,
1,25,3,2,30,19,4,0,23,21,5,0,26,65,12,2,79,1.75,2,0.0,M2019-04-07D,Race(3),,
2,5,23,2,30,11,15,3,29,5,18,2,25,21,56,7,84,2.45,2.3,2.0,M2019-04-07D,Race(3),,
3,0,2,8,10,0,3,8,11,0,2,7,9,0,7,23,30,9,8,1.0,M2019-04-07D,Race(3),,
4,0,0,11,11,0,0,8,8,0,1,8,9,0,1,27,28,11,15,0.0,M2019-04-07D,Race(3),,
5,0,2,7,9,0,0,11,11,0,0,9,9,0,2,27,29,15,41,0.0,M2019-04-07D,Race(3),,
6,0,0,0,0,0,8,0,8,0,0,0,0,0,8,0,8,71,101,0.0,M2019-04-07D,Race(3),,
1,0,0,0,0,0,0,0,0,0,0,0,0,0,0,0,0,51,51,0.0,M2019-04-07D,Race(4),,
2,0,0,0,0,8,0,0,8,0,0,0,0,8,0,0,8,26,26,0.0,M2019-04-07D,Race(4),,
3,0,0,3,3,0,0,0,0,0,0,1,1,0,0,4,4,21,21,0.0,M2019-04-07D,Race(4),,
4,7,10,5,22,6,8,4,18,6,10,4,20,19,28,13,60,4,4,0.0,M2019-04-07D,Race(4),,
5,3,0,5,8,1,0,9,10,1,0,1,2,5,0,15,20,15,15,2.0,M2019-04-07D,Race(4),,
6,8,0,3,11,7,9,4,20,11,7,1,19,26,16,8,50,4.4,4.5,3.0,M2019-04-07D,Race(4),,
7,0,0,0,0,0,0,0,0,0,0,0,0,0,0,0,0,34,35,0.0,M2019-04-07D,Race(4),,
8,0,13,7,20,5,2,4,11,3,3,2,8,8,18,13,39,5.5,5.5,1.0,M2019-04-07D,Race(4),,
9,0,2,0,2,0,0,0,0,0,1,0,1,0,3,0,3,11,11,0.0,M2019-04-07D,Race(4),,
10,2,5,5,12,1,8,3,12,3,2,6,11,6,15,14,35,12,12,0.0,M2019-04-07D,Race(4),,
11,10,0,2,12,2,2,6,10,2,3,11,16,14,5,19,38,4,4,0.0,M2019-04-07D,Race(4),,
1,14,5,2,21,15,2,1,18,14,3,6,23,43,10,9,62,4.6,4.5,2.0,M2019-04-07D,Race(5),,
2,8,12,2,22,3,6,3,12,2,6,3,11,13,24,8,45,3.1,3.1,0.0,M2019-04-07D,Race(5),,
3,0,3,4,7,1,4,9,14,1,2,2,5,2,9,15,26,16,16,0.0,M2019-04-07D,Race(5),,
4,2,6,13,21,0,4,13,17,2,4,10,16,4,14,36,54,7.5,7.5,0.0,M2019-04-07D,Race(5),,
5,0,0,3,3,0,10,2,12,0,4,1,5,0,14,6,20,14,14,3.0,M2019-04-07D,Race(5),,
6,0,0,0,0,0,0,0,0,0,0,0,0,0,0,0,0,61,61,0.0,M2019-04-07D,Race(5),,
7,0,0,0,0,0,0,0,0,0,0,0,0,0,0,0,0,21,21,0.0,M2019-04-07D,Race(5),,
8,0,0,0,0,0,0,0,0,0,0,1,1,0,0,1,1,101,101,0.0,M2019-04-07D,Race(5),,
9,0,0,3,3,8,0,0,8,0,0,0,0,8,0,3,11,15,15,0.0,M2019-04-07D,Race(5),,
10,0,0,3,3,0,0,0,0,1,2,0,3,1,2,3,6,14,14,0.0,M2019-04-07D,Race(5),,
11,0,2,0,2,0,0,0,0,0,0,1,1,0,2,1,3,17,17,1.0,M2019-04-07D,Race(5),,
12,6,0,0,6,3,4,2,9,6,5,2,13,15,9,4,28,8.5,8.5,0.0,M2019-04-07D,Race(5),,
13,0,2,0,2,0,0,0,0,0,0,0,0,0,2,0,2,15,15,0.0,M2019-04-07D,Race(5),,
14,0,0,0,0,0,0,0,0,0,0,0,0,0,0,0,0,81,81,0.0,M2019-04-07D,Race(5),,
1,0,0,5,5,0,1,0,1,0,0,3,3,0,1,8,9,34,34,0.0,M2019-04-07D,Race(6),,
2,2,2,0,4,0,0,0,0,1,1,3,5,3,3,3,9,51,51,0.0,M2019-04-07D,Race(6),,
3,18,2,2,22,22,3,3,28,17,6,0,23,57,11,5,73,2.1,2.1,3.0,M2019-04-07D,Race(6),,
4,5,8,8,21,4,13,4,21,4,8,5,17,13,29,17,59,7,7,0.0,M2019-04-07D,Race(6),,
5,0,0,3,3,0,1,8,9,1,0,4,5,1,1,15,17,16,16,0.0,M2019-04-07D,Race(6),,
6,0,0,0,0,0,0,5,5,0,0,1,1,0,0,6,6,19,19,0.0,M2019-04-07D,Race(6),,
7,0,0,0,0,0,0,0,0,0,0,0,0,0,0,0,0,26,26,0.0,M2019-04-07D,Race(6),,
8,0,0,0,0,0,0,0,0,0,0,1,1,0,0,1,1,51,51,0.0,M2019-04-07D,Race(6),,
9,0,14,9,23,2,7,5,14,3,9,6,18,5,30,20,55,5.5,5.5,2.0,M2019-04-07D,Race(6),,
10,2,0,0,2,0,1,0,1,0,1,3,4,2,2,3,7,26,26,0.0,M2019-04-07D,Race(6),,
11,0,0,0,0,0,0,0,0,0,0,0,0,0,0,0,0,101,101,0.0,M2019-04-07D,Race(6),,
12,3,2,3,8,2,3,2,7,0,1,0,1,5,6,5,16,8,8,1.0,M2019-04-07D,Race(6),,
13,0,0,0,0,0,1,0,1,0,0,0,0,0,1,0,1,41,41,0.0,M2019-04-07D,Race(6),,
14,0,2,0,2,0,0,3,3,0,0,0,0,0,2,3,5,16,16,0.0,M2019-04-07D,Race(6),,
1,28,0,0,28,30,0,0,30,26,0,0,26,84,0,0,84,1.18,1.2,1.0,M2019-04-07D,Race(7),,
2,2,0,12,14,0,1,1,2,0,2,5,7,2,3,18,23,12,21,3.0,M2019-04-07D,Race(7),,
3,0,23,7,30,0,15,6,21,0,19,5,24,0,57,18,75,8,7,0.0,M2019-04-07D,Race(7),,
4,0,5,0,5,0,4,8,12,0,1,0,1,0,10,8,18,26,31,2.0,M2019-04-07D,Race(7),,
5,0,2,8,10,0,2,2,4,0,1,3,4,0,5,13,18,41,41,0.0,M2019-04-07D,Race(7),,
6,0,0,0,0,0,0,0,0,0,0,0,0,0,0,0,0,31,21,0.0,M2019-04-07D,Race(7),,
7,0,0,0,0,0,0,1,1,0,0,1,1,0,0,2,2,26,21,0.0,M2019-04-07D,Race(7),,
8,0,0,0,0,0,0,1,1,0,1,2,3,0,1,3,4,26,34,0.0,M2019-04-07D,Race(7),,
9,0,0,3,3,0,8,11,19,0,2,10,12,0,10,24,34,17,13,0.0,M2019-04-07D,Race(7),,
1,0,0,0,0,2,2,8,12,1,1,3,5,3,3,11,17,20,19,0.0,M2019-04-07D,Race(8),,
2,0,0,0,0,0,0,0,0,1,1,0,2,1,1,0,2,41,41,0.0,M2019-04-07D,Race(8),,
3,2,13,7,22,11,8,2,21,4,9,1,14,17,30,10,57,7,6.5,3.0,M2019-04-07D,Race(8),,
4,0,2,0,2,0,7,8,15,0,5,7,12,0,14,15,29,9.5,9.5,1.0,M2019-04-07D,Race(8),,
5,25,0,5,30,17,3,3,23,17,3,3,23,59,6,11,76,2,2.1,2.0,M2019-04-07D,Race(8),,
6,0,0,2,2,0,0,3,3,0,1,3,4,0,1,8,9,20,20,0.0,M2019-04-07D,Race(8),,
7,3,5,9,17,0,2,3,5,2,0,3,5,5,7,15,27,5.5,5.5,0.0,M2019-04-07D,Race(8),,
8,0,0,0,0,0,0,0,0,0,2,1,3,0,2,1,3,23,23,0.0,M2019-04-07D,Race(8),,
9,0,7,0,7,0,8,0,8,1,1,1,3,1,16,1,18,23,23,0.0,M2019-04-07D,Race(8),,
10,0,3,7,10,0,0,3,3,0,3,4,7,0,6,14,20,14,14,0.0,M2019-04-07D,Race(8),,
11,0,0,0,0,0,0,0,0,0,0,0,0,0,0,0,0,31,26,0.0,M2019-04-07D,Race(8),,
12,0,0,0,0,0,0,0,0,0,0,0,0,0,0,0,0,61,51,0.0,M2019-04-07D,Race(8),,
13,0,0,0,0,0,0,0,0,0,0,0,0,0,0,0,0,81,81,0.0,M2019-04-07D,Race(8),,
1,0,0,3,3,8,0,0,8,0,0,0,0,8,0,3,11,34,41,0.0,M2019-04-07D,Race(9),,
2,15,10,2,27,18,3,0,21,15,5,2,22,48,18,4,70,2.3,2.45,0.0,M2019-04-07D,Race(9),,
3,0,2,0,2,0,1,1,2,0,1,2,3,0,4,3,7,31,27,2.0,M2019-04-07D,Race(9),,
4,5,5,10,20,1,13,6,20,1,10,8,19,7,28,24,59,3.9,4,1.0,M2019-04-07D,Race(9),,
5,0,0,5,5,0,0,3,3,0,0,1,1,0,0,9,9,18,18,0.0,M2019-04-07D,Race(9),,
6,3,0,7,10,0,3,5,8,3,6,2,11,6,9,14,29,8,8.5,3.0,M2019-04-07D,Race(9),,
7,2,0,0,2,0,0,0,0,0,0,0,0,2,0,0,2,41,27,0.0,M2019-04-07D,Race(9),,
8,0,0,0,0,1,1,0,2,2,1,0,3,3,2,0,5,41,27,0.0,M2019-04-07D,Race(9),,
9,3,8,0,11,1,1,6,8,3,3,7,13,7,12,13,32,10,10,0.0,M2019-04-07D,Race(9),,
10,0,0,0,0,0,0,0,0,0,0,0,0,0,0,0,0,31,41,0.0,M2019-04-07D,Race(9),,
11,0,2,3,5,0,0,8,8,0,0,0,0,0,2,11,13,26,27,0.0,M2019-04-07D,Race(9),,
12,2,0,0,2,0,0,0,0,0,0,1,1,2,0,1,3,41,41,0.0,M2019-04-07D,Race(9),,
13,0,0,0,0,0,0,0,0,0,0,0,0,0,0,0,0,26,23,0.0,M2019-04-07D,Race(9),,
14,0,3,0,3,1,8,1,10,2,0,3,5,3,11,4,18,12,11,0.0,M2019-04-07D,Race(9),,
1,0,0,0,0,0,0,0,0,0,0,0,0,0,0,0,0,18,18,0.0,M2019-04-10D,Race(1),,
2,3,12,13,28,0,0,0,0,7,8,5,20,10,20,18,48,2.4,2.4,0.0,M2019-04-10D,Race(1),,
3,4,0,2,6,0,0,0,0,1,2,2,5,5,2,4,11,9,9,2.0,M2019-04-10D,Race(1),,
4,0,5,5,10,0,0,0,0,0,3,2,5,0,8,7,15,8,8,0.0,M2019-04-10D,Race(1),,
5,13,8,5,26,0,0,0,0,9,3,7,19,22,11,12,45,4,4,0.0,M2019-04-10D,Race(1),,
6,8,3,3,14,0,0,0,0,1,4,4,9,9,7,7,23,6,6,1.0,M2019-04-10D,Race(1),,
7,0,0,0,0,0,0,0,0,0,0,0,0,0,0,0,0,0,0,0.0,M2019-04-10D,Race(1),,
8,0,0,0,0,0,0,0,0,1,0,0,1,1,0,0,1,18,18,0.0,M2019-04-10D,Race(1),,
9,2,2,2,6,0,0,0,0,0,0,1,1,2,2,3,7,13,13,3.0,M2019-04-10D,Race(1),,
1,0,0,0,0,0,0,0,0,1,0,0,1,1,0,0,1,12,12,0.0,M2019-04-10D,Race(2),,
2,0,5,2,7,0,0,0,0,5,3,2,10,5,8,4,17,26,26,3.0,M2019-04-10D,Race(2),,
3,3,6,5,14,0,0,0,0,0,11,10,21,3,17,15,35,5,5,0.0,M2019-04-10D,Race(2),,
4,2,0,3,5,0,0,0,0,2,3,4,9,4,3,7,14,15,15,0.0,M2019-04-10D,Race(2),,
5,0,0,0,0,0,0,0,0,0,0,3,3,0,0,3,3,12,12,0.0,M2019-04-10D,Race(2),,
6,18,8,0,26,0,0,0,0,18,5,0,23,36,13,0,49,2.3,2.3,2.0,M2019-04-10D,Race(2),,
7,0,0,0,0,0,0,0,0,0,0,0,0,0,0,0,0,51,51,0.0,M2019-04-10D,Race(2),,
8,0,0,0,0,0,0,0,0,0,0,2,2,0,0,2,2,31,31,0.0,M2019-04-10D,Race(2),,
9,2,0,0,2,0,0,0,0,0,0,0,0,2,0,0,2,15,15,0.0,M2019-04-10D,Race(2),,
10,0,2,0,2,0,0,0,0,0,0,0,0,0,2,0,2,34,34,0.0,M2019-04-10D,Race(2),,
11,0,3,13,16,0,0,0,0,0,2,2,4,0,5,15,20,10,10,0.0,M2019-04-10D,Race(2),,
12,5,6,7,18,0,0,0,0,0,2,3,5,5,8,10,23,8,8,1.0,M2019-04-10D,Race(2),,
1,2,2,2,6,0,0,0,0,0,0,1,1,2,2,3,7,34,34,0.0,M2019-04-10D,Race(3),,
2,2,0,0,2,0,0,0,0,1,5,5,11,3,5,5,13,9,9,0.0,M2019-04-10D,Race(3),,
3,5,13,0,18,0,0,0,0,13,6,5,24,18,19,5,42,5,5,2.0,M2019-04-10D,Race(3),,
4,0,0,0,0,0,0,0,0,0,1,0,1,0,1,0,1,21,21,0.0,M2019-04-10D,Race(3),,
5,0,3,0,3,0,0,0,0,1,0,2,3,1,3,2,6,11,11,0.0,M2019-04-10D,Race(3),,
6,11,2,8,21,0,0,0,0,6,9,3,18,17,11,11,39,6.5,6.5,3.0,M2019-04-10D,Race(3),,
7,0,0,0,0,0,0,0,0,0,0,0,0,0,0,0,0,15,15,0.0,M2019-04-10D,Race(3),,
8,5,5,3,13,0,0,0,0,3,4,0,7,8,9,3,20,3.4,3.4,1.0,M2019-04-10D,Race(3),,
9,2,3,12,17,0,0,0,0,0,0,4,4,2,3,16,21,18,18,0.0,M2019-04-10D,Race(3),,
10,3,2,2,7,0,0,0,0,2,1,3,6,5,3,5,13,9,9,0.0,M2019-04-10D,Race(3),,
11,0,0,0,0,0,0,0,0,0,0,1,1,0,0,1,1,19,19,0.0,M2019-04-10D,Race(3),,
12,0,0,3,3,0,0,0,0,0,0,2,2,0,0,5,5,15,15,0.0,M2019-04-10D,Race(3),,
1,8,4,10,22,0,0,0,0,5,3,6,14,13,7,16,36,6,6,3.0,M2019-04-10D,Race(4),,
2,5,11,12,28,0,0,0,0,0,6,13,19,5,17,25,47,3.2,3.2,0.0,M2019-04-10D,Race(4),,
3,0,0,0,0,0,0,0,0,0,0,0,0,0,0,0,0,0,0,0.0,M2019-04-10D,Race(4),,
4,0,0,0,0,0,0,0,0,0,1,0,1,0,1,0,1,31,31,0.0,M2019-04-10D,Race(4),,
5,17,8,0,25,0,0,0,0,16,5,2,23,33,13,2,48,2,2,1.0,M2019-04-10D,Race(4),,
6,0,0,0,0,0,0,0,0,0,1,0,1,0,1,0,1,31,31,2.0,M2019-04-10D,Race(4),,
7,0,7,6,13,0,0,0,0,5,9,3,17,5,16,9,30,7.5,7.5,0.0,M2019-04-10D,Race(4),,
8,0,0,0,0,0,0,0,0,0,0,0,0,0,0,0,0,23,23,0.0,M2019-04-10D,Race(4),,
9,0,0,2,2,0,0,0,0,0,1,0,1,0,1,2,3,21,21,0.0,M2019-04-10D,Race(4),,
10,0,0,0,0,0,0,0,0,0,0,1,1,0,0,1,1,101,101,0.0,M2019-04-10D,Race(4),,
1,0,3,0,3,0,0,0,0,0,0,2,2,0,3,2,5,31,31,0.0,M2019-04-10D,Race(5),,
2,3,4,0,7,0,0,0,0,1,0,1,2,4,4,1,9,7.5,7.5,0.0,M2019-04-10D,Race(5),,
3,5,0,3,8,0,0,0,0,0,2,1,3,5,2,4,11,12,12,0.0,M2019-04-10D,Race(5),,
4,0,2,5,7,0,0,0,0,0,2,10,12,0,4,15,19,13,13,0.0,M2019-04-10D,Race(5),,
5,10,13,2,25,0,0,0,0,9,7,1,17,19,20,3,42,5,5,1.0,M2019-04-10D,Race(5),,
6,0,0,0,0,0,0,0,0,0,0,0,0,0,0,0,0,126,126,0.0,M2019-04-10D,Race(5),,
7,9,6,7,22,0,0,0,0,11,4,7,22,20,10,14,44,3.5,3.5,2.0,M2019-04-10D,Race(5),,
8,3,0,11,14,0,0,0,0,2,4,2,8,5,4,13,22,11,11,0.0,M2019-04-10D,Race(5),,
9,0,0,2,2,0,0,0,0,2,4,2,8,2,4,4,10,4,4,0.0,M2019-04-10D,Race(5),,
10,0,0,0,0,0,0,0,0,1,2,0,3,1,2,0,3,26,26,0.0,M2019-04-10D,Race(5),,
11,0,2,0,2,0,0,0,0,0,1,0,1,0,3,0,3,41,41,0.0,M2019-04-10D,Race(5),,
12,0,0,0,0,0,0,0,0,0,0,0,0,0,0,0,0,18,18,3.0,M2019-04-10D,Race(5),,
1,0,2,0,2,2,5,4,11,1,6,2,9,3,13,6,22,14,14,0.0,M2019-04-10D,Race(6),,
2,24,4,2,30,15,4,1,20,21,2,2,25,60,10,5,75,3.8,3.8,1.0,M2019-04-10D,Race(6),,
3,0,18,9,27,0,4,5,9,0,4,6,10,0,26,20,46,6,6,0.0,M2019-04-10D,Race(6),,
4,4,6,16,26,5,6,1,12,3,4,2,9,12,16,19,47,4.6,4.6,3.0,M2019-04-10D,Race(6),,
5,0,0,0,0,0,2,1,3,1,7,2,10,1,9,3,13,11,11,0.0,M2019-04-10D,Race(6),,
6,0,0,0,0,1,0,2,3,0,0,3,3,1,0,5,6,26,26,0.0,M2019-04-10D,Race(6),,
7,0,0,0,0,0,0,0,0,0,0,1,1,0,0,1,1,26,26,0.0,M2019-04-10D,Race(6),,
8,0,0,0,0,0,9,11,20,0,0,0,0,0,9,11,20,7.5,7.5,0.0,M2019-04-10D,Race(6),,
9,0,0,0,0,0,0,0,0,0,0,0,0,0,0,0,0,19,19,0.0,M2019-04-10D,Race(6),,
10,2,0,0,2,0,0,2,2,0,0,2,2,2,0,4,6,9,9,2.0,M2019-04-10D,Race(6),,
11,0,0,0,0,0,0,0,0,0,0,0,0,0,0,0,0,51,51,0.0,M2019-04-10D,Race(6),,
12,0,0,3,3,0,0,3,3,0,2,4,6,0,2,10,12,13,13,0.0,M2019-04-10D,Race(6),,
1,0,6,0,6,0,2,1,3,0,3,1,4,0,11,2,13,13,13,0.0,M2019-04-10D,Race(7),,
2,2,3,10,15,2,3,6,11,2,3,6,11,6,9,22,37,7.5,7.5,0.0,M2019-04-10D,Race(7),,
3,5,0,0,5,2,3,3,8,2,2,3,7,9,5,6,20,10,10,3.0,M2019-04-10D,Race(7),,
4,3,0,6,9,2,2,2,6,4,2,1,7,9,4,9,22,9,9,0.0,M2019-04-10D,Race(7),,
5,18,5,7,30,7,4,6,17,11,4,6,21,36,13,19,68,4,4,0.0,M2019-04-10D,Race(7),,
6,0,7,2,9,1,1,2,4,1,2,4,7,2,10,8,20,13,13,2.0,M2019-04-10D,Race(7),,
7,2,7,3,12,16,12,9,37,6,9,4,19,24,28,16,68,3.6,3.6,1.0,M2019-04-10D,Race(7),,
8,0,0,2,2,0,0,0,0,0,0,0,0,0,0,2,2,26,26,0.0,M2019-04-10D,Race(7),,
9,0,2,0,2,0,3,1,4,0,1,1,2,0,6,2,8,7,7,0.0,M2019-04-10D,Race(7),,
10,0,0,0,0,0,0,0,0,0,0,0,0,0,0,0,0,31,31,0.0,M2019-04-10D,Race(7),,
11,0,0,0,0,0,0,0,0,0,0,0,0,0,0,0,0,91,91,0.0,M2019-04-10D,Race(7),,
12,0,0,0,0,0,0,0,0,0,0,0,0,0,0,0,0,34,34,0.0,M2019-04-10D,Race(7),,
1,4,4,0,8,0,0,1,1,0,0,0,0,4,4,1,9,26,26,0.0,M2019-04-10D,Race(8),,
2,10,10,3,23,10,4,3,17,4,5,5,14,24,19,11,54,4,4,0.0,M2019-04-10D,Race(8),,
3,3,3,9,15,10,10,10,30,5,6,2,13,18,19,21,58,7.5,7.5,2.0,M2019-04-10D,Race(8),,
4,0,0,0,0,1,0,2,3,1,1,0,2,2,1,2,5,18,18,0.0,M2019-04-10D,Race(8),,
5,0,0,3,3,1,1,1,3,4,3,3,10,5,4,7,16,14,14,0.0,M2019-04-10D,Race(8),,
6,0,0,5,5,0,1,1,2,0,1,1,2,0,2,7,9,31,31,0.0,M2019-04-10D,Race(8),,
7,5,0,5,10,2,6,4,12,1,2,7,10,8,8,16,32,7,7,3.0,M2019-04-10D,Race(8),,
8,0,3,0,3,0,1,1,2,0,1,0,1,0,5,1,6,8.5,8.5,1.0,M2019-04-10D,Race(8),,
9,8,8,5,21,6,3,5,14,10,1,3,14,24,12,13,49,3.6,3.6,0.0,M2019-04-10D,Race(8),,
10,0,0,0,0,0,0,0,0,0,0,0,0,0,0,0,0,31,31,0.0,M2019-04-10D,Race(8),,
11,0,2,0,2,0,4,2,6,0,5,2,7,0,11,4,15,15,15,0.0,M2019-04-10D,Race(8),,
12,0,0,0,0,0,0,0,0,0,0,0,0,0,0,0,0,17,17,0.0,M2019-04-10D,Race(8),,
1,0,0,0,0,1,0,1,2,0,0,1,1,1,0,2,3,14,14,0.0,M2019-04-24D,Race(1),,
2,0,0,0,0,0,0,0,0,0,0,0,0,0,0,0,0,7.5,7.5,1.0,M2019-04-24D,Race(1),,
3,0,0,0,0,0,0,0,0,0,0,1,1,0,0,1,1,51,51,0.0,M2019-04-24D,Race(1),,
4,2,3,11,16,1,3,5,9,3,8,2,13,6,14,18,38,7.5,7.5,0.0,M2019-04-24D,Race(1),,
5,6,7,7,20,15,5,2,22,12,6,4,22,33,18,13,64,5,5,0.0,M2019-04-24D,Race(1),,
6,7,6,2,15,2,1,1,4,2,0,4,6,11,7,7,25,6,6,2.0,M2019-04-24D,Race(1),,
7,3,4,4,11,2,7,5,14,4,2,5,11,9,13,14,36,8,8,0.0,M2019-04-24D,Race(1),,
8,0,3,0,3,1,2,2,5,0,0,3,3,1,5,5,11,9,9,0.0,M2019-04-24D,Race(1),,
9,0,0,0,0,0,0,0,0,0,0,0,0,0,0,0,0,18,18,0.0,M2019-04-24D,Race(1),,
10,0,0,0,0,0,0,1,1,1,1,0,2,1,1,1,3,12,12,0.0,M2019-04-24D,Race(1),,
11,2,2,0,4,1,0,1,2,0,0,3,3,3,2,4,9,21,21,0.0,M2019-04-24D,Race(1),,
12,0,0,6,6,0,5,4,9,2,8,3,13,2,13,13,28,7.5,7.5,3.0,M2019-04-24D,Race(1),,
1,0,3,0,3,1,2,3,6,1,3,5,9,2,8,8,18,12,12,0.0,M2019-04-24D,Race(2),,
2,0,0,0,0,0,0,0,0,0,0,1,1,0,0,1,1,41,41,0.0,M2019-04-24D,Race(2),,
3,10,11,7,28,2,2,2,6,3,6,1,10,15,19,10,44,3.2,3.2,0.0,M2019-04-24D,Race(2),,
4,3,7,0,10,13,14,11,38,6,3,2,11,22,24,13,59,7.5,7.5,2.0,M2019-04-24D,Race(2),,
5,0,0,0,0,0,1,0,1,0,1,0,1,0,2,0,2,41,41,0.0,M2019-04-24D,Race(2),,
6,2,7,3,12,3,0,3,6,4,0,1,5,9,7,7,23,8.5,8.5,1.0,M2019-04-24D,Race(2),,
7,0,0,0,0,0,0,0,0,0,0,0,0,0,0,0,0,16,16,0.0,M2019-04-24D,Race(2),,
8,11,0,14,25,4,9,3,16,6,6,5,17,21,15,22,58,3.6,3.6,3.0,M2019-04-24D,Race(2),,
9,0,2,6,8,2,1,2,5,1,4,2,7,3,7,10,20,14,14,0.0,M2019-04-24D,Race(2),,
10,2,0,0,2,1,0,2,3,1,0,1,2,4,0,3,7,26,26,0.0,M2019-04-24D,Race(2),,
11,2,0,0,2,2,0,3,5,3,1,6,10,7,1,9,17,10,10,0.0,M2019-04-24D,Race(2),,
12,0,0,0,0,0,0,0,0,0,0,1,1,0,0,1,1,34,34,0.0,M2019-04-24D,Race(2),,
1,0,0,0,0,0,0,0,0,0,0,0,0,0,0,0,0,21,21,0.0,M2019-04-24D,Race(3),,
2,13,8,4,25,14,7,2,23,10,11,3,24,37,26,9,72,3.3,3.3,0.0,M2019-04-24D,Race(3),,
3,0,7,2,9,9,9,12,30,1,1,5,7,10,17,19,46,9,9,3.0,M2019-04-24D,Race(3),,
4,0,2,5,7,3,4,3,10,6,6,5,17,9,12,13,34,11,11,0.0,M2019-04-24D,Race(3),,
5,0,0,5,5,0,2,2,4,1,1,1,3,1,3,8,12,7.5,7.5,2.0,M2019-04-24D,Race(3),,
6,9,11,8,28,4,6,6,16,4,4,6,14,17,21,20,58,3.8,3.8,1.0,M2019-04-24D,Race(3),,
7,2,0,0,2,0,0,0,0,0,0,0,0,2,0,0,2,15,15,0.0,M2019-04-24D,Race(3),,
8,0,0,0,0,0,0,1,1,0,0,0,0,0,0,1,1,21,21,0.0,M2019-04-24D,Race(3),,
9,0,2,0,2,0,0,1,1,0,2,1,3,0,4,2,6,18,18,0.0,M2019-04-24D,Race(3),,
10,0,0,0,0,0,0,0,0,0,0,0,0,0,0,0,0,61,61,0.0,M2019-04-24D,Race(3),,
11,0,0,0,0,0,1,2,3,2,1,3,6,2,2,5,9,23,23,0.0,M2019-04-24D,Race(3),,
12,6,0,6,12,0,1,1,2,2,0,2,4,8,1,9,18,10,10,0.0,M2019-04-24D,Race(3),,
1,6,0,8,14,2,6,2,10,1,3,5,9,9,9,15,33,7,7,0.0,M2019-04-24D,Race(4),,
2,3,7,3,13,1,1,10,12,7,1,10,18,11,9,23,43,7,7,0.0,M2019-04-24D,Race(4),,
3,0,0,5,5,0,1,2,3,0,1,1,2,0,2,8,10,11,11,0.0,M2019-04-24D,Race(4),,
4,0,3,7,10,1,0,1,2,0,0,2,2,1,3,10,14,11,11,0.0,M2019-04-24D,Race(4),,
5,8,8,0,16,13,13,9,35,7,10,3,20,28,31,12,71,4.2,4.2,2.0,M2019-04-24D,Race(4),,
6,0,0,0,0,0,0,0,0,0,0,0,0,0,0,0,0,61,61,0.0,M2019-04-24D,Race(4),,
7,0,0,0,0,0,0,0,0,0,0,1,1,0,0,1,1,61,61,0.0,M2019-04-24D,Race(4),,
8,0,0,0,0,0,1,0,1,0,0,0,0,0,1,0,1,31,31,0.0,M2019-04-24D,Race(4),,
9,0,0,3,3,0,2,1,3,0,2,2,4,0,4,6,10,14,14,3.0,M2019-04-24D,Race(4),,
10,0,0,0,0,0,0,0,0,0,0,0,0,0,0,0,0,81,81,0.0,M2019-04-24D,Race(4),,
11,13,12,2,27,13,4,4,21,11,8,1,20,37,24,7,68,2.6,2.6,1.0,M2019-04-24D,Race(4),,
12,0,0,2,2,0,2,1,3,0,1,1,2,0,3,4,7,26,26,0.0,M2019-04-24D,Race(4),,
1,0,2,0,2,1,0,1,2,2,0,1,3,3,2,2,7,34,35,0.0,M2019-04-24D,Race(5),,
2,2,0,2,4,0,0,1,1,0,0,0,0,2,0,3,5,41,41,2.0,M2019-04-24D,Race(5),,
3,15,10,0,25,23,11,10,44,17,6,2,25,55,27,12,94,2,2,3.0,M2019-04-24D,Race(5),,
4,0,0,4,4,0,1,0,1,0,0,0,0,0,1,4,5,16,16,0.0,M2019-04-24D,Race(5),,
5,8,7,2,17,3,7,3,13,4,7,4,15,15,21,9,45,5,5,0.0,M2019-04-24D,Race(5),,
6,2,6,12,20,1,6,3,10,0,8,6,14,3,20,21,44,7.5,7.5,0.0,M2019-04-24D,Race(5),,
7,0,3,3,6,2,3,6,11,2,3,3,8,4,9,12,25,10,10,1.0,M2019-04-24D,Race(5),,
8,0,2,0,2,0,0,1,1,0,0,1,1,0,2,2,4,21,21,0.0,M2019-04-24D,Race(5),,
9,0,0,5,5,0,0,0,0,0,0,0,0,0,0,5,5,51,51,0.0,M2019-04-24D,Race(5),,
10,0,0,0,0,0,0,1,1,0,0,1,1,0,0,2,2,41,41,0.0,M2019-04-24D,Race(5),,
11,0,0,0,0,0,0,0,0,0,0,2,2,0,0,2,2,26,26,0.0,M2019-04-24D,Race(5),,
12,3,0,2,5,0,2,4,6,1,2,6,9,4,4,12,20,10,10,0.0,M2019-04-24D,Race(5),,
1,0,2,0,2,0,0,0,0,0,0,0,0,0,2,0,2,61,61,0.0,M2019-04-24D,Race(6),,
2,15,0,11,26,18,13,9,40,20,4,0,24,53,17,20,90,3,3,2.0,M2019-04-24D,Race(6),,
3,0,3,0,3,2,0,2,4,0,0,3,3,2,3,5,10,11,11,3.0,M2019-04-24D,Race(6),,
4,0,6,4,10,1,5,5,11,1,6,5,12,2,17,14,33,5.5,5.5,0.0,M2019-04-24D,Race(6),,
5,0,0,0,0,0,0,0,0,0,0,0,0,0,0,0,0,81,81,0.0,M2019-04-24D,Race(6),,
6,0,0,0,0,0,1,1,2,0,0,0,0,0,1,1,2,31,31,0.0,M2019-04-24D,Race(6),,
7,0,0,0,0,0,1,0,1,0,0,2,2,0,1,2,3,31,31,0.0,M2019-04-24D,Race(6),,
8,0,2,0,2,0,0,0,0,0,0,1,1,0,2,1,3,14,14,0.0,M2019-04-24D,Race(6),,
9,3,0,2,5,1,0,2,3,0,1,2,3,4,1,6,11,16,16,1.0,M2019-04-24D,Race(6),,
10,2,2,0,4,1,3,1,5,1,1,1,3,4,6,2,12,21,21,0.0,M2019-04-24D,Race(6),,
11,5,10,8,23,1,1,5,7,0,5,4,9,6,16,17,39,5.5,5.5,0.0,M2019-04-24D,Race(6),,
12,5,5,5,15,6,6,5,17,4,9,8,21,15,20,18,53,4.6,4.6,0.0,M2019-04-24D,Race(6),,
1,5,13,7,25,15,13,12,40,11,7,3,21,31,33,22,86,4.8,4.8,0.0,M2019-04-24D,Race(7),,
2,16,8,4,28,12,7,3,22,12,9,4,25,40,24,11,75,2.4,2.4,3.0,M2019-04-24D,Race(7),,
3,0,0,0,0,0,0,1,1,0,0,1,1,0,0,2,2,21,21,0.0,M2019-04-24D,Race(7),,
4,0,0,0,0,0,0,0,0,0,0,0,0,0,0,0,0,81,81,0.0,M2019-04-24D,Race(7),,
5,0,0,2,2,1,2,0,3,0,2,1,3,1,4,3,8,12,12,0.0,M2019-04-24D,Race(7),,
6,0,0,0,0,0,1,2,3,1,2,5,8,1,3,7,11,10,10,2.0,M2019-04-24D,Race(7),,
7,0,0,0,0,1,1,1,3,0,1,2,3,1,2,3,6,21,21,0.0,M2019-04-24D,Race(7),,
8,0,2,0,2,0,1,0,1,0,1,0,1,0,4,0,4,13,13,0.0,M2019-04-24D,Race(7),,
9,5,2,9,16,0,3,4,7,0,3,3,6,5,8,16,29,9,9,0.0,M2019-04-24D,Race(7),,
10,4,5,8,17,1,1,6,8,2,1,7,10,7,7,21,35,8,8,0.0,M2019-04-24D,Race(7),,
11,0,0,0,0,0,1,1,2,0,0,0,0,0,1,1,2,26,26,0.0,M2019-04-24D,Race(7),,
12,0,0,0,0,0,0,0,0,0,0,0,0,0,0,0,0,51,51,1.0,M2019-04-24D,Race(7),,
1,9,5,8,22,2,5,4,11,3,3,7,13,14,13,19,46,2.65,2.75,1.0,M2019-04-24D,Race(8),,
2,0,0,0,0,0,0,0,0,0,0,0,0,0,0,0,0,101,101,0.0,M2019-04-24D,Race(8),,
3,0,11,7,18,11,17,14,42,7,11,7,25,18,39,28,85,6.5,7,0.0,M2019-04-24D,Race(8),,
4,0,0,0,0,0,0,1,1,0,0,1,1,0,0,2,2,41,41,0.0,M2019-04-24D,Race(8),,
5,0,0,0,0,0,0,1,1,0,0,0,0,0,0,1,1,26,21,2.0,M2019-04-24D,Race(8),,
6,0,2,4,6,1,4,5,10,0,4,5,9,1,10,14,25,12,12,0.0,M2019-04-24D,Race(8),,
7,0,0,0,0,0,0,0,0,0,0,1,1,0,0,1,1,51,41,0.0,M2019-04-24D,Race(8),,
8,0,0,0,0,0,0,0,0,0,0,0,0,0,0,0,0,16,15,0.0,M2019-04-24D,Race(8),,
9,19,7,2,28,16,3,2,21,16,6,1,23,51,16,5,72,2.5,3,0.0,M2019-04-24D,Race(8),,
10,2,0,6,8,0,0,1,1,0,1,1,2,2,1,8,11,17,15,0.0,M2019-04-24D,Race(8),,
11,0,2,3,5,0,1,1,2,0,1,0,1,0,4,4,8,34,31,0.0,M2019-04-24D,Race(8),,
12,0,3,0,3,0,0,1,1,0,0,3,3,0,3,4,7,12,11,3.0,M2019-04-24D,Race(8),,
1,2,9,3,14,2,6,4,12,3,2,4,9,7,17,11,35,11,11,2.0,M2019-04-28D,Race(1),,
2,0,0,0,0,0,0,1,1,0,0,1,1,0,0,2,2,21,21,3.0,M2019-04-28D,Race(1),,
3,7,0,0,7,8,1,3,12,3,2,7,12,18,3,10,31,6.5,6.5,0.0,M2019-04-28D,Race(1),,
4,0,0,0,0,0,0,0,0,0,0,0,0,0,0,0,0,41,41,0.0,M2019-04-28D,Race(1),,
5,6,13,5,24,14,5,3,22,14,7,2,23,34,25,10,69,4.6,4.5,0.0,M2019-04-28D,Race(1),,
6,8,0,5,13,0,5,4,9,1,7,3,11,9,12,12,33,6.5,6.5,0.0,M2019-04-28D,Race(1),,
7,2,3,13,18,5,4,5,14,5,5,5,15,12,12,23,47,3.5,3.5,0.0,M2019-04-28D,Race(1),,
8,5,3,2,10,1,8,2,11,0,3,1,4,6,14,5,25,10,10,1.0,M2019-04-28D,Race(1),,
9,0,0,0,0,0,0,0,0,0,0,0,0,0,0,0,0,51,51,0.0,M2019-04-28D,Race(1),,
10,0,0,0,0,0,0,0,0,0,0,0,0,0,0,0,0,51,51,0.0,M2019-04-28D,Race(1),,
11,0,0,2,2,0,1,8,9,0,0,2,2,0,1,12,13,10,10,0.0,M2019-04-28D,Race(1),,
12,0,0,0,0,0,0,0,0,0,0,0,0,0,0,0,0,126,126,0.0,M2019-04-28D,Race(1),,
13,0,0,0,0,0,0,0,0,0,0,1,1,0,0,1,1,81,81,0.0,M2019-04-28D,Race(1),,
14,0,2,0,2,0,0,0,0,0,0,0,0,0,2,0,2,26,26,0.0,M2019-04-28D,Race(1),,
1,2,3,8,13,0,3,5,8,0,4,7,11,2,10,20,32,13,13,0.0,M2019-04-28D,Race(10),,
2,18,10,2,30,30,0,0,30,26,0,0,26,74,10,2,86,2.2,2.2,2.0,M2019-04-28D,Race(10),,
3,5,10,10,25,0,14,6,20,0,15,5,20,5,39,21,65,5.5,5.5,0.0,M2019-04-28D,Race(10),,
4,0,2,4,6,0,9,3,12,0,0,4,4,0,11,11,22,7,7,0.0,M2019-04-28D,Race(10),,
5,0,0,0,0,0,0,0,0,0,1,1,2,0,1,1,2,17,17,0.0,M2019-04-28D,Race(10),,
6,0,0,0,0,0,0,0,0,0,0,0,0,0,0,0,0,41,41,0.0,M2019-04-28D,Race(10),,
7,0,0,6,6,0,0,3,3,0,0,3,3,0,0,12,12,14,14,3.0,M2019-04-28D,Race(10),,
8,0,0,0,0,0,0,0,0,0,0,0,0,0,0,0,0,51,51,0.0,M2019-04-28D,Race(10),,
9,0,0,0,0,0,0,8,8,0,0,1,1,0,0,9,9,34,34,0.0,M2019-04-28D,Race(10),,
10,0,0,0,0,0,0,0,0,0,0,1,1,0,0,1,1,51,51,0.0,M2019-04-28D,Race(10),,
11,0,0,0,0,0,0,0,0,0,0,0,0,0,0,0,0,51,51,0.0,M2019-04-28D,Race(10),,
12,5,5,0,10,0,4,5,9,0,6,3,9,5,15,8,28,11,11,1.0,M2019-04-28D,Race(10),,
13,0,0,0,0,0,0,0,0,0,0,1,1,0,0,1,1,34,34,0.0,M2019-04-28D,Race(10),,
14,0,0,0,0,0,0,0,0,0,0,0,0,0,0,0,0,17,17,0.0,M2019-04-28D,Race(10),,
1,24,6,0,30,14,8,1,23,17,8,0,25,55,22,1,78,1.7,1.7,0.0,M2019-04-28D,Race(2),,
2,0,0,0,0,0,0,0,0,0,0,0,0,0,0,0,0,61,61,0.0,M2019-04-28D,Race(2),,
3,0,0,0,0,0,0,4,4,0,0,4,4,0,0,8,8,41,41,0.0,M2019-04-28D,Race(2),,
4,3,0,5,8,0,0,1,1,0,0,3,3,3,0,9,12,16,15,2.0,M2019-04-28D,Race(2),,
5,0,0,0,0,0,0,0,0,0,0,0,0,0,0,0,0,151,151,0.0,M2019-04-28D,Race(2),,
6,0,0,3,3,0,0,0,0,0,0,0,0,0,0,3,3,151,151,0.0,M2019-04-28D,Race(2),,
7,0,4,0,4,0,2,3,5,0,2,3,5,0,8,6,14,16,15,0.0,M2019-04-28D,Race(2),,
8,0,0,0,0,0,0,0,0,0,0,0,0,0,0,0,0,71,81,0.0,M2019-04-28D,Race(2),,
9,0,0,0,0,0,0,1,1,0,0,2,2,0,0,3,3,61,51,0.0,M2019-04-28D,Race(2),,
10,0,3,8,11,0,2,7,9,0,2,10,12,0,7,25,32,8,7.5,3.0,M2019-04-28D,Race(2),,
11,0,0,0,0,0,0,0,0,0,0,0,0,0,0,0,0,91,81,0.0,M2019-04-28D,Race(2),,
12,0,2,3,5,0,8,0,8,0,1,1,2,0,11,4,15,21,21,0.0,M2019-04-28D,Race(2),,
13,3,13,9,25,16,8,5,29,9,13,2,24,28,34,16,78,4.2,4.6,1.0,M2019-04-28D,Race(2),,
14,0,2,2,4,0,2,8,10,0,0,1,1,0,4,11,15,17,17,0.0,M2019-04-28D,Race(2),,
1,13,7,7,27,10,4,4,18,10,7,4,21,33,18,15,66,4.6,4.6,1.0,M2019-04-28D,Race(3),,
2,0,0,0,0,0,0,0,0,2,2,0,4,2,2,0,4,41,41,0.0,M2019-04-28D,Race(3),,
3,0,0,8,8,0,2,7,9,0,2,5,7,0,4,20,24,7.5,8.5,3.0,M2019-04-28D,Race(3),,
4,8,14,0,22,6,4,2,12,7,6,5,18,21,24,7,52,3.1,3.2,0.0,M2019-04-28D,Race(3),,
5,5,5,13,23,5,10,6,21,5,8,6,19,15,23,25,63,4.6,4.6,0.0,M2019-04-28D,Race(3),,
6,2,2,0,4,1,8,3,12,0,0,5,5,3,10,8,21,12,12,2.0,M2019-04-28D,Race(3),,
7,0,0,2,2,0,0,0,0,0,0,0,0,0,0,2,2,51,51,0.0,M2019-04-28D,Race(3),,
8,0,0,0,0,0,0,0,0,0,0,0,0,0,0,0,0,51,51,0.0,M2019-04-28D,Race(3),,
9,2,2,0,4,0,0,8,8,1,0,1,2,3,2,9,14,8.5,8.5,0.0,M2019-04-28D,Race(3),,
10,0,0,0,0,8,2,0,10,1,1,0,2,9,3,0,12,13,13,0.0,M2019-04-28D,Race(3),,
11,0,0,0,0,0,0,0,0,0,0,0,0,0,0,0,0,101,101,0.0,M2019-04-28D,Race(3),,
12,0,0,0,0,0,0,0,0,0,0,0,0,0,0,0,0,81,81,0.0,M2019-04-28D,Race(3),,
13,0,0,0,0,0,0,0,0,0,0,0,0,0,0,0,0,26,26,0.0,M2019-04-28D,Race(3),,
14,0,0,0,0,0,0,0,0,0,0,0,0,0,0,0,0,61,101,0.0,M2019-04-28D,Race(3),,
1,5,0,2,7,4,8,2,14,3,1,3,7,12,9,7,28,10,10,0.0,M2019-04-28D,Race(4),,
2,0,0,0,0,0,0,0,0,0,0,0,0,0,0,0,0,51,51,0.0,M2019-04-28D,Race(4),,
3,5,11,8,24,3,11,2,16,4,11,2,17,12,33,12,57,5,5,0.0,M2019-04-28D,Race(4),,
4,0,5,6,11,2,2,8,12,2,0,6,8,4,7,20,31,9.5,9,0.0,M2019-04-28D,Race(4),,
5,5,4,6,15,4,3,2,9,6,3,6,15,15,10,14,39,6.5,7.5,1.0,M2019-04-28D,Race(4),,
6,0,0,0,0,0,0,0,0,0,0,0,0,0,0,0,0,26,26,0.0,M2019-04-28D,Race(4),,
7,0,0,0,0,8,0,1,9,0,0,0,0,8,0,1,9,16,16,0.0,M2019-04-28D,Race(4),,
8,2,0,0,2,0,0,1,1,0,1,1,2,2,1,2,5,10,10,2.0,M2019-04-28D,Race(4),,
9,10,8,5,23,9,5,6,20,11,7,4,22,30,20,15,65,3.1,3,3.0,M2019-04-28D,Race(4),,
10,0,0,0,0,0,0,0,0,0,1,0,1,0,1,0,1,16,16,0.0,M2019-04-28D,Race(4),,
11,3,2,3,8,0,0,8,8,0,2,2,4,3,4,13,20,13,15,0.0,M2019-04-28D,Race(4),,
12,0,0,0,0,0,0,0,0,0,0,2,2,0,0,2,2,20,19,0.0,M2019-04-28D,Race(4),,
1,5,8,5,18,3,7,7,17,6,2,8,16,14,17,20,51,11,11,0.0,M2019-04-28D,Race(5),,
2,0,0,2,2,8,1,2,11,3,0,1,4,11,1,5,17,21,21,0.0,M2019-04-28D,Race(5),,
3,0,0,2,2,0,0,0,0,0,0,0,0,0,0,2,2,19,19,0.0,M2019-04-28D,Race(5),,
4,4,2,0,6,4,4,2,10,4,6,1,11,12,12,3,27,8,8,0.0,M2019-04-28D,Race(5),,
5,0,0,0,0,2,1,1,4,2,1,0,3,4,2,1,7,21,21,0.0,M2019-04-28D,Race(5),,
6,0,0,5,5,0,0,0,0,0,0,2,2,0,0,7,7,26,26,0.0,M2019-04-28D,Race(5),,
7,0,0,0,0,0,3,1,4,1,6,2,9,1,9,3,13,13,13,2.0,M2019-04-28D,Race(5),,
8,11,4,6,21,11,4,2,17,7,4,7,18,29,12,15,56,2.5,2.5,0.0,M2019-04-28D,Race(5),,
9,2,0,0,2,0,0,3,3,1,2,3,6,3,2,6,11,8.5,8.5,0.0,M2019-04-28D,Race(5),,
10,0,0,0,0,0,0,0,0,0,0,0,0,0,0,0,0,31,31,3.0,M2019-04-28D,Race(5),,
11,0,0,0,0,0,0,0,0,0,0,0,0,0,0,0,0,81,81,0.0,M2019-04-28D,Race(5),,
12,2,0,0,2,0,0,0,0,0,0,0,0,2,0,0,2,17,17,0.0,M2019-04-28D,Race(5),,
13,3,5,5,13,1,8,4,13,1,1,1,3,5,14,10,29,12,13,1.0,M2019-04-28D,Race(5),,
14,3,11,5,19,1,2,8,11,1,4,1,6,5,17,14,36,9.5,10,0.0,M2019-04-28D,Race(5),,
1,7,9,12,28,6,9,6,21,5,2,9,16,18,20,27,65,2,1.75,0.0,M2019-04-28D,Race(6),,
3,15,13,2,30,7,9,7,23,7,15,4,26,29,37,13,79,4.4,6,0.0,M2019-04-28D,Race(6),,
4,2,0,2,4,0,0,0,0,0,1,0,1,2,1,2,5,21,21,1.0,M2019-04-28D,Race(6),,
5,6,8,14,28,8,4,6,18,2,3,5,10,16,15,25,56,9,10,3.0,M2019-04-28D,Race(6),,
6,0,0,0,0,0,0,0,0,0,0,0,0,0,0,0,0,21,21,2.0,M2019-04-28D,Race(6),,
7,0,0,0,0,0,0,0,0,0,0,0,0,0,0,0,0,81,67,0.0,M2019-04-28D,Race(6),,
8,0,0,0,0,0,0,0,0,0,0,0,0,0,0,0,0,34,26,0.0,M2019-04-28D,Race(6),,
9,0,0,0,0,0,0,0,0,0,0,0,0,0,0,0,0,11,12,0.0,M2019-04-28D,Race(6),,
10,0,0,0,0,0,0,0,0,0,0,0,0,0,0,0,0,26,21,0.0,M2019-04-28D,Race(6),,
1,30,0,0,30,30,0,0,30,26,0,0,26,86,0,0,86,1.1,1.15,1.0,M2019-04-28D,Race(7),,
2,0,11,11,22,0,15,10,25,0,14,4,18,0,40,25,65,9,8,0.0,M2019-04-28D,Race(7),,
3,0,2,3,5,0,0,5,5,0,0,2,2,0,2,10,12,26,21,0.0,M2019-04-28D,Race(7),,
4,0,6,2,8,0,8,1,9,0,3,4,7,0,17,7,24,16,15,3.0,M2019-04-28D,Race(7),,
5,0,9,14,23,0,5,9,14,0,7,9,16,0,21,32,53,21,21,2.0,M2019-04-28D,Race(7),,
6,0,2,0,2,0,2,5,7,0,2,7,9,0,6,12,18,26,26,0.0,M2019-04-28D,Race(7),,
7,0,0,0,0,0,0,0,0,0,0,0,0,0,0,0,0,101,101,0.0,M2019-04-28D,Race(7),,
1,18,6,4,28,17,3,3,23,20,6,0,26,55,15,7,77,3.8,3.5,2.0,M2019-04-28D,Race(8),,
2,0,0,0,0,0,0,0,0,0,2,0,2,0,2,0,2,31,26,0.0,M2019-04-28D,Race(8),,
3,2,12,0,14,3,7,8,18,4,3,2,9,9,22,10,41,18,15,0.0,M2019-04-28D,Race(8),,
4,0,2,0,2,0,2,0,2,0,2,1,3,0,6,1,7,15,14,1.0,M2019-04-28D,Race(8),,
5,0,0,4,4,0,2,2,4,1,0,2,3,1,2,8,11,13,15,0.0,M2019-04-28D,Race(8),,
6,3,0,0,3,0,0,4,4,0,0,7,7,3,0,11,14,11,15,0.0,M2019-04-28D,Race(8),,
7,0,0,0,0,0,0,0,0,0,0,0,0,0,0,0,0,21,34,0.0,M2019-04-28D,Race(8),,
8,0,3,6,9,0,3,7,10,0,6,6,12,0,12,19,31,8.5,9,0.0,M2019-04-28D,Race(8),,
9,2,0,5,7,0,8,2,10,0,1,3,4,2,9,10,21,7.5,5,0.0,M2019-04-28D,Race(8),,
10,0,0,0,0,0,0,0,0,0,0,0,0,0,0,0,0,51,51,0.0,M2019-04-28D,Race(8),,
11,0,0,2,2,8,2,0,10,0,0,0,0,8,2,2,12,6.5,9,0.0,M2019-04-28D,Race(8),,
12,5,5,3,13,2,2,2,6,1,6,2,9,8,13,7,28,10,10,3.0,M2019-04-28D,Race(8),,
13,0,2,6,8,0,1,2,3,0,0,3,3,0,3,11,14,7,8,0.0,M2019-04-28D,Race(8),,
1,0,2,2,4,3,1,0,4,2,2,0,4,5,5,2,12,16,16,0.0,M2019-04-28D,Race(9),,
2,2,0,0,2,0,2,0,2,1,0,0,1,3,2,0,5,13,13,0.0,M2019-04-28D,Race(9),,
3,0,0,0,0,0,0,0,0,0,0,1,1,0,0,1,1,81,81,0.0,M2019-04-28D,Race(9),,
4,0,0,0,0,0,0,0,0,1,0,0,1,1,0,0,1,41,41,0.0,M2019-04-28D,Race(9),,
5,2,0,0,2,0,0,0,0,0,0,0,0,2,0,0,2,21,21,0.0,M2019-04-28D,Race(9),,
6,9,14,0,23,6,7,5,18,7,8,4,19,22,29,9,60,2.7,2.7,0.0,M2019-04-28D,Race(9),,
7,3,0,2,5,8,2,2,12,0,3,2,5,11,5,6,22,13,13,0.0,M2019-04-28D,Race(9),,
8,0,0,0,0,1,0,0,1,0,0,1,1,1,0,1,2,26,26,0.0,M2019-04-28D,Race(9),,
9,5,3,8,16,5,3,3,11,10,5,4,19,20,11,15,46,4,4.5,3.0,M2019-04-28D,Race(9),,
10,0,0,7,7,1,8,5,14,1,0,6,7,2,8,18,28,12,13,1.0,M2019-04-28D,Race(9),,
11,4,6,3,13,5,4,6,15,3,5,6,14,12,15,15,42,12,12,2.0,M2019-04-28D,Race(9),,
12,0,0,2,2,0,0,0,0,0,0,0,0,0,0,2,2,21,21,0.0,M2019-04-28D,Race(9),,
13,5,3,3,11,1,3,1,5,1,3,2,6,7,9,6,22,9.5,11,0.0,M2019-04-28D,Race(9),,
14,0,2,3,5,0,0,8,8,0,0,0,0,0,2,11,13,21,21,0.0,M2019-04-28D,Race(9),,
1,0,0,2,2,0,0,1,1,0,0,1,1,0,0,4,4,41,41,0.0,M2019-05-01D,Race(1),,
2,0,0,0,0,0,0,0,0,0,0,0,0,0,0,0,0,51,51,0.0,M2019-05-01D,Race(1),,
3,2,0,0,2,0,0,1,1,0,0,1,1,2,0,2,4,17,17,0.0,M2019-05-01D,Race(1),,
4,2,7,6,15,4,3,2,9,3,3,0,6,9,13,8,30,4.4,4.5,1.0,M2019-05-01D,Race(1),,
5,0,0,0,0,0,0,0,0,0,0,0,0,0,0,0,0,41,41,0.0,M2019-05-01D,Race(1),,
6,10,7,3,20,2,2,6,10,1,3,6,10,13,12,15,40,6,6,3.0,M2019-05-01D,Race(1),,
7,0,13,7,20,1,13,3,17,4,12,4,20,5,38,14,57,5.5,5,0.0,M2019-05-01D,Race(1),,
8,16,0,10,26,15,1,2,18,7,3,3,13,38,4,15,57,2.4,2.4,0.0,M2019-05-01D,Race(1),,
9,0,3,0,3,0,0,1,1,0,1,1,2,0,4,2,6,17,17,2.0,M2019-05-01D,Race(1),,
10,0,0,2,2,0,0,0,0,0,0,0,0,0,0,2,2,26,26,0.0,M2019-05-01D,Race(1),,
11,0,0,0,0,0,0,0,0,0,0,1,1,0,0,1,1,21,21,0.0,M2019-05-01D,Race(1),,
12,0,0,0,0,0,0,0,0,0,0,0,0,0,0,0,0,61,61,0.0,M2019-05-01D,Race(1),,
1,8,2,2,12,12,8,11,31,4,3,3,10,24,13,16,53,5.5,5,2.0,M2019-05-01D,Race(2),,
2,2,0,0,2,1,0,0,1,1,0,0,1,4,0,0,4,17,17,0.0,M2019-05-01D,Race(2),,
3,5,3,5,13,0,3,4,7,1,1,1,3,6,7,10,23,5,5,0.0,M2019-05-01D,Race(2),,
4,7,0,2,9,1,2,0,3,2,1,0,3,10,3,2,15,13,13,0.0,M2019-05-01D,Race(2),,
5,0,0,0,0,0,0,0,0,0,0,0,0,0,0,0,0,19,19,0.0,M2019-05-01D,Race(2),,
6,0,11,0,11,2,1,1,4,3,3,3,9,5,15,4,24,17,17,0.0,M2019-05-01D,Race(2),,
7,2,4,12,18,0,1,2,3,2,3,3,8,4,8,17,29,8,8,0.0,M2019-05-01D,Race(2),,
8,3,2,3,8,3,2,3,8,2,3,3,8,8,7,9,24,8,8,3.0,M2019-05-01D,Race(2),,
9,3,8,6,17,6,6,1,13,5,4,8,17,14,18,15,47,3.6,3.6,1.0,M2019-05-01D,Race(2),,
10,0,0,0,0,0,0,0,0,0,0,0,0,0,0,0,0,41,41,0.0,M2019-05-01D,Race(2),,
11,0,0,0,0,0,0,0,0,0,0,0,0,0,0,0,0,21,21,0.0,M2019-05-01D,Race(2),,
12,0,0,0,0,0,0,0,0,0,0,0,0,0,0,0,0,14,14,0.0,M2019-05-01D,Race(2),,
1,10,12,0,22,2,6,6,14,5,8,6,19,17,26,12,55,6.5,6,1.0,M2019-05-01D,Race(3),,
2,0,2,5,7,0,0,1,1,0,0,0,0,0,2,6,8,18,18,0.0,M2019-05-01D,Race(3),,
3,5,0,0,5,0,2,1,3,0,1,2,3,5,3,3,11,21,21,0.0,M2019-05-01D,Race(3),,
4,0,0,10,10,1,0,1,2,1,1,3,5,2,1,14,17,7.5,7,0.0,M2019-05-01D,Race(3),,
5,0,0,0,0,0,0,0,0,0,0,0,0,0,0,0,0,41,41,0.0,M2019-05-01D,Race(3),,
6,2,10,5,17,11,9,9,29,2,4,5,11,15,23,19,57,6.5,6,0.0,M2019-05-01D,Race(3),,
7,0,3,0,3,5,7,7,19,6,6,5,17,11,16,12,39,4.8,4.8,2.0,M2019-05-01D,Race(3),,
8,0,0,0,0,0,0,0,0,0,0,0,0,0,0,0,0,21,21,0.0,M2019-05-01D,Race(3),,
9,10,3,7,20,11,4,5,20,12,5,5,22,33,12,17,62,3.4,3.4,3.0,M2019-05-01D,Race(3),,
10,3,0,0,3,0,2,0,2,0,1,0,1,3,3,0,6,34,34,0.0,M2019-05-01D,Race(3),,
11,0,0,3,3,0,0,0,0,0,0,0,0,0,0,3,3,10,10,0.0,M2019-05-01D,Race(3),,
12,0,0,0,0,0,0,0,0,0,0,0,0,0,0,0,0,31,31,0.0,M2019-05-01D,Race(3),,
1,4,12,0,16,3,5,5,13,5,8,6,19,12,25,11,48,8,8,3.0,M2019-05-01D,Race(4),,
2,0,0,0,0,1,0,0,1,0,0,0,0,1,0,0,1,34,35,0.0,M2019-05-01D,Race(4),,
3,3,4,2,9,3,5,6,14,4,4,7,15,10,13,15,38,5,5,0.0,M2019-05-01D,Race(4),,
4,21,2,7,30,14,6,2,22,14,6,5,25,49,14,14,77,2.5,2.5,2.0,M2019-05-01D,Race(4),,
5,0,6,0,6,0,0,0,0,0,1,1,2,0,7,1,8,11,11,0.0,M2019-05-01D,Race(4),,
6,0,0,0,0,2,1,2,5,2,1,0,3,4,2,2,8,17,17,0.0,M2019-05-01D,Race(4),,
7,0,0,13,13,7,8,7,22,0,1,1,2,7,9,21,37,15,15,0.0,M2019-05-01D,Race(4),,
8,0,0,0,0,0,2,0,2,1,2,1,4,1,4,1,6,15,15,0.0,M2019-05-01D,Race(4),,
9,0,0,0,0,0,0,3,3,0,0,3,3,0,0,6,6,16,16,0.0,M2019-05-01D,Race(4),,
10,0,3,8,11,1,2,3,6,0,2,2,4,1,7,13,21,8,8,0.0,M2019-05-01D,Race(4),,
11,2,3,0,5,0,1,1,2,0,1,0,1,2,5,1,8,26,26,1.0,M2019-05-01D,Race(4),,
12,0,0,0,0,0,0,1,1,0,0,0,0,0,0,1,1,61,61,0.0,M2019-05-01D,Race(4),,
1,0,0,0,0,2,1,3,6,2,1,4,7,4,2,7,13,14,14,0.0,M2019-05-01D,Race(5),,
2,0,0,0,0,0,0,1,1,0,1,0,1,0,1,1,2,34,34,0.0,M2019-05-01D,Race(5),,
3,0,0,8,8,8,8,9,25,3,3,4,10,11,11,21,43,11,11,1.0,M2019-05-01D,Race(5),,
4,19,6,0,25,10,7,3,20,13,8,2,23,42,21,5,68,3,3,3.0,M2019-05-01D,Race(5),,
5,9,10,3,22,7,3,5,15,5,3,2,10,21,16,10,47,5,5,2.0,M2019-05-01D,Race(5),,
6,0,0,0,0,0,1,0,1,0,0,0,0,0,1,0,1,12,12,0.0,M2019-05-01D,Race(5),,
7,0,0,0,0,0,0,0,0,0,0,0,0,0,0,0,0,71,67,0.0,M2019-05-01D,Race(5),,
8,2,0,6,8,0,2,1,3,0,4,4,8,2,6,11,19,9,9,0.0,M2019-05-01D,Race(5),,
9,0,0,3,3,0,1,0,1,0,0,0,0,0,1,3,4,34,34,0.0,M2019-05-01D,Race(5),,
10,0,14,10,24,3,6,8,17,3,6,9,18,6,26,27,59,4.8,4.8,0.0,M2019-05-01D,Race(5),,
11,0,0,0,0,0,1,0,1,0,0,1,1,0,1,1,2,13,13,0.0,M2019-05-01D,Race(5),,
12,0,0,0,0,0,0,0,0,0,0,0,0,0,0,0,0,34,34,0.0,M2019-05-01D,Race(5),,
1,5,6,2,13,6,1,3,10,8,4,3,15,19,11,8,38,4,4,1.0,M2019-05-01D,Race(6),,
2,0,0,0,0,1,0,1,2,2,0,0,2,3,0,1,4,21,21,0.0,M2019-05-01D,Race(6),,
3,12,3,3,18,8,4,9,21,10,5,6,21,30,12,18,60,6.5,6.5,0.0,M2019-05-01D,Race(6),,
4,0,5,10,15,8,15,10,33,2,3,6,11,10,23,26,59,5.5,5.5,0.0,M2019-05-01D,Race(6),,
5,6,7,2,15,5,1,3,9,2,3,2,7,13,11,7,31,7,7,3.0,M2019-05-01D,Race(6),,
6,5,7,11,23,2,3,3,8,2,4,5,11,9,14,19,42,4.4,4.5,2.0,M2019-05-01D,Race(6),,
7,0,0,0,0,0,0,0,0,0,0,0,0,0,0,0,0,61,61,0.0,M2019-05-01D,Race(6),,
8,0,0,0,0,0,0,0,0,0,0,0,0,0,0,0,0,34,35,0.0,M2019-05-01D,Race(6),,
9,0,0,2,2,0,0,0,0,0,0,3,3,0,0,5,5,11,11,0.0,M2019-05-01D,Race(6),,
10,0,0,0,0,0,0,0,0,0,0,0,0,0,0,0,0,34,35,0.0,M2019-05-01D,Race(6),,
11,0,0,0,0,0,0,0,0,0,0,0,0,0,0,0,0,41,41,0.0,M2019-05-01D,Race(6),,
12,2,2,0,4,0,6,1,7,0,7,1,8,2,15,2,19,11,11,0.0,M2019-05-01D,Race(6),,
1,0,0,0,0,0,0,0,0,0,0,0,0,0,0,0,0,34,34,0.0,M2019-05-01D,Race(7),,
2,15,7,3,25,11,3,3,17,11,7,1,19,37,17,7,61,4,4,1.0,M2019-05-01D,Race(7),,
3,4,6,15,25,9,13,11,33,3,7,5,15,16,26,31,73,3.5,3.5,3.0,M2019-05-01D,Race(7),,
4,3,0,0,3,0,0,2,2,0,0,2,2,3,0,4,7,15,15,0.0,M2019-05-01D,Race(7),,
5,0,0,0,0,7,6,5,18,0,0,0,0,7,6,5,18,0,0,0.0,M2019-05-01D,Race(7),,
6,0,3,2,5,0,0,2,2,0,1,1,2,0,4,5,9,12,12,0.0,M2019-05-01D,Race(7),,
7,0,0,0,0,1,1,3,5,0,0,0,0,1,1,3,5,0,0,0.0,M2019-05-01D,Race(7),,
8,5,6,3,14,1,2,0,3,0,1,3,4,6,9,6,21,5.5,5.5,0.0,M2019-05-01D,Race(7),,
9,0,3,0,3,0,3,3,6,1,2,3,6,1,8,6,15,12,12,0.0,M2019-05-01D,Race(7),,
10,3,5,7,15,1,2,1,4,0,1,3,4,4,8,11,23,5,5,0.0,M2019-05-01D,Race(7),,
11,0,0,0,0,0,0,0,0,0,0,0,0,0,0,0,0,26,26,0.0,M2019-05-01D,Race(7),,
12,0,0,0,0,0,0,0,0,0,0,0,0,0,0,0,0,17,17,2.0,M2019-05-01D,Race(7),,
1,0,0,0,0,1,0,2,3,0,0,0,0,1,0,2,3,14,14,0.0,M2019-05-01D,Race(8),,
2,6,8,7,21,1,5,5,11,1,6,4,11,8,19,16,43,6,6,0.0,M2019-05-01D,Race(8),,
3,12,3,5,20,9,6,3,18,13,7,2,22,34,16,10,60,4.2,4.2,1.0,M2019-05-01D,Race(8),,
4,3,0,0,3,7,7,7,21,1,0,0,1,11,7,7,25,17,17,0.0,M2019-05-01D,Race(8),,
5,0,5,2,7,3,1,5,9,4,1,4,9,7,7,11,25,15,15,0.0,M2019-05-01D,Race(8),,
6,2,0,3,5,0,1,0,1,0,1,0,1,2,2,3,7,26,26,3.0,M2019-05-01D,Race(8),,
7,0,3,6,9,1,1,3,5,0,2,3,5,1,6,12,19,8,8,0.0,M2019-05-01D,Race(8),,
8,2,8,4,14,4,5,1,10,3,5,6,14,9,18,11,38,4,4,0.0,M2019-05-01D,Race(8),,
9,5,0,0,5,3,2,3,8,3,2,3,8,11,4,6,21,12,12,0.0,M2019-05-01D,Race(8),,
10,0,3,0,3,1,1,0,2,1,1,1,3,2,5,1,8,17,17,2.0,M2019-05-01D,Race(8),,
11,0,0,3,3,0,1,1,2,0,1,3,4,0,2,7,9,11,11,0.0,M2019-05-01D,Race(8),,
12,0,0,0,0,0,0,0,0,0,0,0,0,0,0,0,0,31,31,0.0,M2019-05-01D,Race(8),,
1,0,0,11,11,0,0,5,5,1,2,7,10,1,2,23,26,17,15,0.0,M2019-05-05D,Race(1),,
2,0,15,6,21,0,12,5,17,0,12,4,16,0,39,15,54,9,8,0.0,M2019-05-05D,Race(1),,
3,0,0,0,0,0,0,2,2,0,0,4,4,0,0,6,6,51,51,0.0,M2019-05-05D,Race(1),,
4,0,0,0,0,0,1,0,1,0,3,0,3,0,4,0,4,41,41,0.0,M2019-05-05D,Race(1),,
5,0,0,2,2,0,1,1,2,0,0,1,1,0,1,4,5,18,18,3.0,M2019-05-05D,Race(1),,
6,3,10,3,16,1,5,6,12,3,2,4,9,7,17,13,37,7,7,0.0,M2019-05-05D,Race(1),,
7,0,5,5,10,0,3,4,7,0,3,6,9,0,11,15,26,10,9,2.0,M2019-05-05D,Race(1),,
8,27,0,3,30,29,8,7,44,22,4,0,26,78,12,10,100,1.34,1.4,1.0,M2019-05-05D,Race(1),,
1,0,6,5,11,6,5,4,15,9,4,2,15,15,15,11,41,6,6,3.0,M2019-05-05D,Race(10),,
2,0,6,5,11,1,2,1,4,0,3,0,3,1,11,6,18,7,7,0.0,M2019-05-05D,Race(10),,
3,14,8,3,25,14,13,12,39,4,6,6,16,32,27,21,80,4.2,4.2,1.0,M2019-05-05D,Race(10),,
4,0,0,0,0,2,3,0,5,4,5,0,9,6,8,0,14,11,11,2.0,M2019-05-05D,Race(10),,
5,0,3,6,9,1,1,0,2,2,1,1,4,3,5,7,15,8.5,8.5,0.0,M2019-05-05D,Race(10),,
6,0,2,0,2,0,2,1,3,0,0,1,1,0,4,2,6,26,26,0.0,M2019-05-05D,Race(10),,
7,0,0,3,3,0,0,0,0,0,0,0,0,0,0,3,3,26,26,0.0,M2019-05-05D,Race(10),,
8,0,0,0,0,0,1,2,3,0,2,2,4,0,3,4,7,20,21,0.0,M2019-05-05D,Race(10),,
9,3,3,0,6,0,1,4,5,0,2,5,7,3,6,9,18,11,11,0.0,M2019-05-05D,Race(10),,
10,13,2,8,23,6,2,6,14,7,3,9,19,26,7,23,56,3.7,3.7,0.0,M2019-05-05D,Race(10),,
11,0,0,0,0,0,0,0,0,0,0,0,0,0,0,0,0,26,26,0.0,M2019-05-05D,Race(10),,
1,10,15,0,25,14,4,4,22,13,8,3,24,37,27,7,71,2,2.9,0.0,M2019-05-05D,Race(11),,
2,15,13,0,28,5,9,6,20,8,10,3,21,28,32,9,69,3.2,3.1,1.0,M2019-05-05D,Race(11),,
3,5,0,4,9,0,0,0,0,0,0,0,0,5,0,4,9,9.5,9,0.0,M2019-05-05D,Race(11),,
4,0,0,0,0,0,0,0,0,0,0,0,0,0,0,0,0,18,11,0.0,M2019-05-05D,Race(11),,
5,0,2,0,2,0,0,0,0,0,0,0,0,0,2,0,2,31,27,0.0,M2019-05-05D,Race(11),,
6,0,0,0,0,0,0,0,0,0,0,1,1,0,0,1,1,91,101,0.0,M2019-05-05D,Race(11),,
7,0,0,0,0,0,0,0,0,0,0,0,0,0,0,0,0,91,101,0.0,M2019-05-05D,Race(11),,
8,0,0,0,0,0,0,0,0,0,0,0,0,0,0,0,0,101,81,0.0,M2019-05-05D,Race(11),,
9,0,0,22,22,0,5,5,10,0,2,7,9,0,7,34,41,6.5,6,2.0,M2019-05-05D,Race(11),,
10,0,0,0,0,0,0,0,0,0,0,0,0,0,0,0,0,23,23,3.0,M2019-05-05D,Race(11),,
11,0,0,2,2,0,3,0,3,2,4,1,7,2,7,3,12,17,17,0.0,M2019-05-05D,Race(11),,
12,0,0,2,2,1,1,1,3,0,2,2,4,1,3,5,9,31,27,0.0,M2019-05-05D,Race(11),,
13,0,0,0,0,0,0,0,0,0,0,0,0,0,0,0,0,126,126,0.0,M2019-05-05D,Race(11),,
14,0,0,0,0,0,0,0,0,0,0,0,0,0,0,0,0,41,41,0.0,M2019-05-05D,Race(11),,
1,11,12,0,23,19,14,9,42,10,8,0,18,40,34,9,83,3.2,3.2,3.0,M2019-05-05D,Race(2),,
2,10,3,2,15,2,4,4,10,3,4,4,11,15,11,10,36,7.5,7.5,0.0,M2019-05-05D,Race(2),,
3,0,0,0,0,0,0,1,1,2,0,0,2,2,0,1,3,21,21,0.0,M2019-05-05D,Race(2),,
4,0,0,0,0,1,1,0,2,1,1,0,2,2,2,0,4,34,34,0.0,M2019-05-05D,Race(2),,
5,2,0,2,4,0,0,0,0,0,0,0,0,2,0,2,4,26,26,0.0,M2019-05-05D,Race(2),,
6,0,0,8,8,1,2,2,5,0,1,1,2,1,3,11,15,13,13,0.0,M2019-05-05D,Race(2),,
7,2,8,8,18,6,8,6,20,6,10,5,21,14,26,19,59,7,7,0.0,M2019-05-05D,Race(2),,
8,0,0,2,2,0,1,2,3,2,1,2,5,2,2,6,10,14,14,0.0,M2019-05-05D,Race(2),,
9,0,3,0,3,0,0,0,0,0,0,1,1,0,3,1,4,11,11,1.0,M2019-05-05D,Race(2),,
10,0,0,2,2,0,0,4,4,0,0,5,5,0,0,11,11,8.5,8.5,0.0,M2019-05-05D,Race(2),,
11,0,0,6,6,0,0,0,0,0,0,1,1,0,0,7,7,26,26,0.0,M2019-05-05D,Race(2),,
12,2,2,0,4,0,0,1,1,1,1,3,5,3,3,4,10,8,9,2.0,M2019-05-05D,Race(2),,
13,3,2,0,5,1,0,1,2,1,0,4,5,5,2,5,12,15,15,0.0,M2019-05-05D,Race(2),,
1,0,5,4,9,4,4,3,11,4,7,4,15,8,16,11,35,8.5,8.5,0.0,M2019-05-05D,Race(3),,
2,17,5,6,28,9,7,0,16,9,5,0,14,35,17,6,58,2.3,2.7,1.0,M2019-05-05D,Race(3),,
3,5,13,0,18,10,11,13,34,2,3,5,10,17,27,18,62,4.8,4.8,0.0,M2019-05-05D,Race(3),,
4,0,3,0,3,1,1,2,4,1,1,5,7,2,5,7,14,14,13,0.0,M2019-05-05D,Race(3),,
5,0,0,14,14,3,1,5,9,4,3,3,10,7,4,22,33,6.5,6,3.0,M2019-05-05D,Race(3),,
6,0,0,0,0,0,0,0,0,0,0,0,0,0,0,0,0,101,101,0.0,M2019-05-05D,Race(3),,
7,0,2,0,2,0,0,0,0,0,0,0,0,0,2,0,2,19,19,0.0,M2019-05-05D,Race(3),,
8,6,2,4,12,3,6,5,14,6,5,4,15,15,13,13,41,5.5,5.5,2.0,M2019-05-05D,Race(3),,
9,0,0,0,0,0,0,0,0,0,1,0,1,0,1,0,1,41,41,0.0,M2019-05-05D,Race(3),,
10,0,0,0,0,0,0,0,0,0,1,0,1,0,1,0,1,26,26,0.0,M2019-05-05D,Race(3),,
11,2,0,2,4,0,0,2,2,0,0,5,5,2,0,9,11,34,34,0.0,M2019-05-05D,Race(3),,
1,0,0,0,0,1,0,0,1,0,0,0,0,1,0,0,1,61,61,0.0,M2019-05-05D,Race(4),,
2,0,0,0,0,0,0,0,0,0,1,0,1,0,1,0,1,81,81,0.0,M2019-05-05D,Race(4),,
3,5,2,0,7,1,3,3,7,0,3,4,7,6,8,7,21,7.5,7.5,2.0,M2019-05-05D,Race(4),,
4,0,0,0,0,0,0,0,0,0,0,0,0,0,0,0,0,151,151,0.0,M2019-05-05D,Race(4),,
5,3,5,7,15,0,2,1,3,1,5,3,9,4,12,11,27,7.5,7.5,1.0,M2019-05-05D,Race(4),,
6,3,5,5,13,3,5,8,16,4,5,6,15,10,15,19,44,4.4,4.5,0.0,M2019-05-05D,Race(4),,
7,2,3,2,7,0,0,3,3,0,1,2,3,2,4,7,13,13,13,0.0,M2019-05-05D,Race(4),,
8,12,5,3,20,9,11,11,31,2,4,6,12,23,20,20,63,5.5,6.5,0.0,M2019-05-05D,Race(4),,
9,5,7,8,20,15,6,1,22,17,4,1,22,37,17,10,64,2.8,2.8,0.0,M2019-05-05D,Race(4),,
10,0,0,3,3,0,1,0,1,1,0,1,2,1,1,4,6,21,26,0.0,M2019-05-05D,Race(4),,
11,0,0,0,0,0,0,0,0,0,0,0,0,0,0,0,0,41,41,0.0,M2019-05-05D,Race(4),,
12,0,0,0,0,0,0,0,0,0,0,0,0,0,0,0,0,51,51,0.0,M2019-05-05D,Race(4),,
13,0,3,2,5,1,2,3,6,1,3,3,7,2,8,8,18,14,14,3.0,M2019-05-05D,Race(4),,
14,0,0,0,0,0,0,0,0,0,0,0,0,0,0,0,0,81,81,0.0,M2019-05-05D,Race(4),,
1,0,0,0,0,0,0,0,0,0,0,0,0,0,0,0,0,81,67,0.0,M2019-05-05D,Race(5),,
2,2,0,4,6,2,4,6,12,1,5,6,12,5,9,16,30,21,17,0.0,M2019-05-05D,Race(5),,
3,5,12,9,26,10,14,12,36,2,2,7,11,17,28,28,73,5,5,0.0,M2019-05-05D,Race(5),,
4,4,0,2,6,1,1,1,3,0,0,2,2,5,1,5,11,6,6,0.0,M2019-05-05D,Race(5),,
5,0,0,3,3,0,0,0,0,3,0,2,5,3,0,5,8,31,31,3.0,M2019-05-05D,Race(5),,
6,0,0,0,0,2,1,1,4,2,0,0,2,4,1,1,6,9.5,8.5,0.0,M2019-05-05D,Race(5),,
7,16,8,2,26,14,5,3,22,14,8,0,22,44,21,5,70,2.3,2.4,1.0,M2019-05-05D,Race(5),,
8,0,0,0,0,0,0,1,1,1,1,1,3,1,1,2,4,34,41,0.0,M2019-05-05D,Race(5),,
9,0,0,0,0,0,0,0,0,0,0,0,0,0,0,0,0,51,41,0.0,M2019-05-05D,Race(5),,
10,0,0,0,0,0,0,0,0,0,0,1,1,0,0,1,1,151,151,0.0,M2019-05-05D,Race(5),,
11,0,0,0,0,0,0,0,0,0,0,1,1,0,0,1,1,151,151,0.0,M2019-05-05D,Race(5),,
12,3,10,10,23,1,5,6,12,3,10,6,19,7,25,22,54,4.4,4.8,2.0,M2019-05-05D,Race(5),,
1,3,5,3,11,1,2,4,7,1,2,4,7,5,9,11,25,15,15,0.0,M2019-05-05D,Race(6),,
2,0,0,0,0,0,0,0,0,0,0,0,0,0,0,0,0,101,101,0.0,M2019-05-05D,Race(6),,
3,0,0,0,0,0,0,0,0,0,0,0,0,0,0,0,0,51,51,0.0,M2019-05-05D,Race(6),,
4,3,2,0,5,0,2,1,3,0,2,1,3,3,6,2,11,26,26,0.0,M2019-05-05D,Race(6),,
5,0,0,6,6,1,1,0,2,1,1,0,2,2,2,6,10,13,13,0.0,M2019-05-05D,Race(6),,
6,3,2,7,12,16,9,12,37,14,3,2,19,33,14,21,68,8,8,0.0,M2019-05-05D,Race(6),,
7,5,4,3,12,0,5,4,9,2,4,1,7,7,13,8,28,3.2,3.6,1.0,M2019-05-05D,Race(6),,
8,10,3,5,18,9,4,3,16,3,6,7,16,22,13,15,50,4.6,4.6,0.0,M2019-05-05D,Race(6),,
9,4,3,4,11,2,2,1,5,3,3,6,12,9,8,11,28,7.5,7.5,3.0,M2019-05-05D,Race(6),,
10,0,0,0,0,0,0,0,0,0,0,0,0,0,0,0,0,71,67,0.0,M2019-05-05D,Race(6),,
11,0,8,2,10,1,5,4,10,2,5,4,11,3,18,10,31,9,9,2.0,M2019-05-05D,Race(6),,
12,0,3,0,3,0,0,0,0,0,0,0,0,0,3,0,3,15,15,0.0,M2019-05-05D,Race(6),,
13,0,0,0,0,0,0,1,1,0,0,1,1,0,0,2,2,12,12,0.0,M2019-05-05D,Race(6),,
14,2,0,0,2,0,0,0,0,0,0,0,0,2,0,0,2,26,26,0.0,M2019-05-05D,Race(6),,
1,2,11,3,16,9,15,12,36,1,5,6,12,12,31,21,64,8,8,0.0,M2019-05-05D,Race(7),,
2,2,6,9,17,6,4,2,12,7,6,2,15,15,16,13,44,6,6,0.0,M2019-05-05D,Race(7),,
3,0,0,0,0,0,0,3,3,0,0,0,0,0,0,3,3,0,0,0.0,M2019-05-05D,Race(7),,
4,21,4,5,30,9,6,5,20,11,6,4,21,41,16,14,71,2.8,2.8,1.0,M2019-05-05D,Race(7),,
5,0,0,0,0,0,0,0,0,0,1,0,1,0,1,0,1,34,35,0.0,M2019-05-05D,Race(7),,
6,5,0,3,8,2,3,3,8,2,1,2,5,9,4,8,21,7.5,7.5,3.0,M2019-05-05D,Race(7),,
7,0,5,8,13,2,1,2,5,2,1,4,7,4,7,14,25,6,6,0.0,M2019-05-05D,Race(7),,
8,0,0,0,0,0,0,0,0,0,0,0,0,0,0,0,0,21,17,0.0,M2019-05-05D,Race(7),,
9,0,4,0,4,2,1,2,5,3,5,2,10,5,10,4,19,6,6.5,2.0,M2019-05-05D,Race(7),,
10,0,0,2,2,0,0,1,1,0,0,2,2,0,0,5,5,12,12,0.0,M2019-05-05D,Race(7),,
1,0,0,0,0,0,0,0,0,0,0,0,0,0,0,0,0,41,41,0.0,M2019-05-05D,Race(8),,
2,3,10,2,15,10,10,12,32,3,4,8,15,16,24,22,62,4.8,4.8,3.0,M2019-05-05D,Race(8),,
3,0,0,0,0,0,0,0,0,0,0,0,0,0,0,0,0,151,151,0.0,M2019-05-05D,Race(8),,
4,0,0,0,0,0,0,0,0,0,1,1,2,0,1,1,2,51,51,0.0,M2019-05-05D,Race(8),,
5,0,0,0,0,0,0,0,0,1,0,0,1,1,0,0,1,21,31,0.0,M2019-05-05D,Race(8),,
6,0,0,2,2,0,3,1,4,0,2,2,4,0,5,5,10,14,14,0.0,M2019-05-05D,Race(8),,
7,0,6,0,6,0,0,1,1,0,0,1,1,0,6,2,8,51,51,0.0,M2019-05-05D,Race(8),,
8,0,0,0,0,0,0,0,0,0,0,0,0,0,0,0,0,151,151,0.0,M2019-05-05D,Race(8),,
9,2,2,15,19,8,4,8,20,8,5,7,20,18,11,30,59,5.5,5.5,1.0,M2019-05-05D,Race(8),,
10,0,0,3,3,0,0,0,0,2,0,0,2,2,0,3,5,14,12,0.0,M2019-05-05D,Race(8),,
11,5,5,8,18,3,7,5,15,2,7,5,14,10,19,18,47,4.4,4.4,0.0,M2019-05-05D,Race(8),,
12,2,2,0,4,0,0,0,0,0,0,1,1,2,2,1,5,31,31,2.0,M2019-05-05D,Race(8),,
13,18,5,0,23,7,6,3,16,8,7,1,16,33,18,4,55,3,3,0.0,M2019-05-05D,Race(8),,
14,0,0,0,0,2,0,0,2,2,0,0,2,4,0,0,4,34,34,0.0,M2019-05-05D,Race(8),,
1,7,8,4,19,11,11,13,35,3,4,7,14,21,23,24,68,6,6,3.0,M2019-05-05D,Race(9),,
2,0,0,3,3,0,1,0,1,0,1,0,1,0,2,3,5,23,23,0.0,M2019-05-05D,Race(9),,
3,0,0,0,0,0,0,0,0,0,0,0,0,0,0,0,0,51,51,0.0,M2019-05-05D,Race(9),,
4,13,3,2,18,10,2,6,18,16,3,2,21,39,8,10,57,4,4,0.0,M2019-05-05D,Race(9),,
5,2,0,2,4,0,2,0,2,0,1,0,1,2,3,2,7,10,10,0.0,M2019-05-05D,Race(9),,
6,0,0,0,0,0,0,0,0,0,0,0,0,0,0,0,0,31,31,0.0,M2019-05-05D,Race(9),,
7,5,5,10,20,4,3,3,10,4,6,5,15,13,14,18,45,5.5,5.5,0.0,M2019-05-05D,Race(9),,
8,0,0,0,0,0,0,0,0,0,0,0,0,0,0,0,0,26,26,0.0,M2019-05-05D,Race(9),,
9,3,2,6,11,1,4,3,8,0,5,5,10,4,11,14,29,6.5,6.5,0.0,M2019-05-05D,Race(9),,
10,0,5,0,5,2,6,3,11,1,5,2,8,3,16,5,24,13,13,0.0,M2019-05-05D,Race(9),,
11,0,2,0,2,0,0,0,0,0,0,0,0,0,2,0,2,41,51,2.0,M2019-05-05D,Race(9),,
12,0,2,3,5,2,1,5,8,2,1,5,8,4,4,13,21,7,7,1.0,M2019-05-05D,Race(9),,
13,0,0,0,0,0,0,0,0,0,0,0,0,0,0,0,0,26,31,0.0,M2019-05-05D,Race(9),,
14,0,3,0,3,0,0,0,0,0,0,0,0,0,3,0,3,51,51,0.0,M2019-05-05D,Race(9),,
1,2,0,0,2,4,1,2,7,3,1,2,6,9,2,4,15,8.5,8.5,0.0,M2019-05-11D,Race(1),,
2,5,11,3,19,6,9,1,16,8,5,2,15,19,25,6,50,5,5,0.0,M2019-05-11D,Race(1),,
3,0,4,0,4,0,0,0,0,0,1,0,1,0,5,0,5,26,26,0.0,M2019-05-11D,Race(1),,
4,0,2,3,5,3,0,3,6,3,0,4,7,6,2,10,18,21,21,0.0,M2019-05-11D,Race(1),,
5,0,5,6,11,0,3,1,4,1,3,0,4,1,11,7,19,26,26,0.0,M2019-05-11D,Race(1),,
6,19,3,0,22,14,13,13,40,4,10,7,21,37,26,20,83,4.6,4.6,1.0,M2019-05-11D,Race(1),,
7,0,0,8,8,0,2,1,3,3,1,2,6,3,3,11,17,10,10,0.0,M2019-05-11D,Race(1),,
8,2,0,0,2,0,1,1,2,0,2,1,3,2,3,2,7,17,17,3.0,M2019-05-11D,Race(1),,
9,2,5,6,13,3,1,7,11,4,2,6,12,9,8,19,36,3.5,3.5,2.0,M2019-05-11D,Race(1),,
10,0,0,0,0,0,0,0,0,0,0,0,0,0,0,0,0,34,34,0.0,M2019-05-11D,Race(1),,
11,0,0,4,4,0,0,0,0,0,1,1,2,0,1,5,6,26,26,0.0,M2019-05-11D,Race(1),,
12,0,0,0,0,0,0,0,0,0,0,0,0,0,0,0,0,19,19,0.0,M2019-05-11D,Race(1),,
13,0,0,0,0,0,0,1,1,0,0,1,1,0,0,2,2,21,21,0.0,M2019-05-11D,Race(1),,
14,0,0,0,0,0,0,0,0,0,0,0,0,0,0,0,0,151,151,0.0,M2019-05-11D,Race(1),,
1,0,0,0,0,1,2,2,5,0,3,1,4,1,5,3,9,34,34,0.0,M2019-05-11D,Race(10),,
2,2,8,6,16,9,10,15,34,6,2,6,14,17,20,27,64,13,13,0.0,M2019-05-11D,Race(10),,
3,0,0,0,0,0,0,0,0,1,0,0,1,1,0,0,1,71,67,0.0,M2019-05-11D,Race(10),,
4,0,0,0,0,0,0,0,0,0,2,1,3,0,2,1,3,31,31,0.0,M2019-05-11D,Race(10),,
5,0,0,0,0,0,0,1,1,0,0,0,0,0,0,1,1,71,67,0.0,M2019-05-11D,Race(10),,
6,0,2,0,2,0,0,0,0,0,0,0,0,0,2,0,2,12,12,1.0,M2019-05-11D,Race(10),,
7,0,0,0,0,0,0,0,0,0,0,1,1,0,0,1,1,71,67,0.0,M2019-05-11D,Race(10),,
8,7,0,8,15,0,6,4,10,0,7,5,12,7,13,17,37,5,5,3.0,M2019-05-11D,Race(10),,
9,0,0,0,0,0,0,0,0,0,0,0,0,0,0,0,0,101,101,0.0,M2019-05-11D,Race(10),,
10,2,0,0,2,1,0,2,3,1,0,1,2,4,0,3,7,16,16,0.0,M2019-05-11D,Race(10),,
11,3,6,10,19,1,2,2,5,0,3,8,11,4,11,20,35,8.5,8.5,0.0,M2019-05-11D,Race(10),,
12,16,12,2,30,15,6,1,22,17,6,0,23,48,24,3,75,1.85,1.85,2.0,M2019-05-11D,Race(10),,
13,0,2,4,6,3,3,0,6,1,3,0,4,4,8,4,16,15,15,0.0,M2019-05-11D,Race(10),,
14,0,0,0,0,0,1,0,1,0,0,0,0,0,1,0,1,81,81,0.0,M2019-05-11D,Race(10),,
1,11,3,0,14,2,4,2,8,3,5,0,8,16,12,2,30,4.4,4.4,3.0,M2019-05-11D,Race(2),,
2,5,6,10,21,3,2,2,7,3,2,4,9,11,10,16,37,5.5,5.5,0.0,M2019-05-11D,Race(2),,
3,0,2,2,4,1,2,3,6,2,2,3,7,3,6,8,17,17,17,0.0,M2019-05-11D,Race(2),,
4,0,5,0,5,3,2,1,6,6,2,0,8,9,9,1,19,19,19,0.0,M2019-05-11D,Race(2),,
5,0,0,0,0,0,1,1,2,0,0,1,1,0,1,2,3,51,51,0.0,M2019-05-11D,Race(2),,
6,0,0,0,0,0,0,0,0,0,0,0,0,0,0,0,0,71,67,0.0,M2019-05-11D,Race(2),,
7,5,4,0,9,0,0,1,1,1,0,2,3,6,4,3,13,8.5,8.5,0.0,M2019-05-11D,Race(2),,
8,2,3,10,15,12,14,13,39,3,10,5,18,17,27,28,72,5,5,1.0,M2019-05-11D,Race(2),,
9,0,0,0,0,0,0,0,0,1,1,0,2,1,1,0,2,61,61,0.0,M2019-05-11D,Race(2),,
10,0,0,0,0,0,0,0,0,0,0,0,0,0,0,0,0,41,41,2.0,M2019-05-11D,Race(2),,
11,0,0,0,0,0,0,1,1,0,1,3,4,0,1,4,5,19,19,0.0,M2019-05-11D,Race(2),,
12,2,5,0,7,0,0,0,0,0,2,1,3,2,7,1,10,41,41,0.0,M2019-05-11D,Race(2),,
13,0,0,0,0,0,0,0,0,0,0,0,0,0,0,0,0,41,41,0.0,M2019-05-11D,Race(2),,
14,5,2,8,15,7,3,5,15,7,1,7,15,19,6,20,45,3.8,3.8,0.0,M2019-05-11D,Race(2),,
1,3,3,13,19,1,4,7,12,2,6,4,12,6,13,24,43,6,6,0.0,M2019-05-11D,Race(3),,
2,25,5,0,30,22,14,7,43,15,8,2,25,62,27,9,98,2.5,2.5,0.0,M2019-05-11D,Race(3),,
3,0,0,0,0,0,0,0,0,0,1,0,1,0,1,0,1,41,61,0.0,M2019-05-11D,Race(3),,
4,0,3,5,8,0,2,0,2,0,2,2,4,0,7,7,14,61,31,0.0,M2019-05-11D,Race(3),,
5,0,5,3,8,1,1,2,4,1,0,5,6,2,6,10,18,6.5,6.5,2.0,M2019-05-11D,Race(3),,
6,0,0,0,0,0,0,0,0,0,0,0,0,0,0,0,0,11,10,0.0,M2019-05-11D,Race(3),,
7,0,0,0,0,0,0,0,0,0,0,0,0,0,0,0,0,126,126,0.0,M2019-05-11D,Race(3),,
8,0,0,0,0,0,0,0,0,0,0,0,0,0,0,0,0,81,81,0.0,M2019-05-11D,Race(3),,
9,0,0,0,0,0,0,0,0,0,0,0,0,0,0,0,0,61,67,0.0,M2019-05-11D,Race(3),,
10,0,0,0,0,0,0,0,0,0,0,0,0,0,0,0,0,41,41,0.0,M2019-05-11D,Race(3),,
11,0,12,6,18,3,5,7,15,4,6,6,16,7,23,19,49,4.4,4.5,0.0,M2019-05-11D,Race(3),,
12,0,0,0,0,0,0,1,1,0,0,2,2,0,0,3,3,34,34,0.0,M2019-05-11D,Race(3),,
13,2,2,3,7,1,1,0,2,0,0,1,1,3,3,4,10,11,15,3.0,M2019-05-11D,Race(3),,
14,0,0,0,0,0,0,0,0,0,0,0,0,0,0,0,0,34,34,1.0,M2019-05-11D,Race(3),,
1,5,9,16,30,10,18,13,41,2,10,6,18,17,37,35,89,5,5,1.0,M2019-05-11D,Race(4),,
2,21,5,4,30,18,3,1,22,21,4,0,25,60,12,5,77,1.8,1.85,2.0,M2019-05-11D,Race(4),,
3,0,0,0,0,0,0,0,0,0,0,1,1,0,0,1,1,126,126,0.0,M2019-05-11D,Race(4),,
4,2,3,2,7,2,0,6,8,1,3,4,8,5,6,12,23,16,16,0.0,M2019-05-11D,Race(4),,
5,0,6,8,14,0,1,3,4,1,4,4,9,1,11,15,27,7.5,7.5,0.0,M2019-05-11D,Race(4),,
6,0,0,0,0,0,0,0,0,1,0,0,1,1,0,0,1,81,81,3.0,M2019-05-11D,Race(4),,
7,0,0,0,0,0,0,0,0,0,0,1,1,0,0,1,1,31,35,0.0,M2019-05-11D,Race(4),,
8,0,0,0,0,0,1,0,1,0,0,1,1,0,1,1,2,126,126,0.0,M2019-05-11D,Race(4),,
9,2,7,0,9,0,4,1,5,0,1,4,5,2,12,5,19,8.5,8.5,0.0,M2019-05-11D,Race(4),,
10,0,0,0,0,0,1,1,2,0,1,0,1,0,2,1,3,17,17,0.0,M2019-05-11D,Race(4),,
11,0,0,0,0,0,0,2,2,0,0,3,3,0,0,5,5,17,17,0.0,M2019-05-11D,Race(4),,
12,0,0,0,0,0,2,3,5,0,3,2,5,0,5,5,10,19,19,0.0,M2019-05-11D,Race(4),,
1,12,8,0,20,17,12,11,40,9,6,3,18,38,26,14,78,4.2,4.5,0.0,M2019-05-11D,Race(5),,
2,0,0,2,2,0,0,1,1,1,0,1,2,1,0,4,5,15,15,3.0,M2019-05-11D,Race(5),,
3,13,9,6,28,4,9,5,18,5,11,4,20,22,29,15,66,3.1,3.1,1.0,M2019-05-11D,Race(5),,
4,0,0,2,2,0,0,0,0,0,0,0,0,0,0,2,2,13,14,0.0,M2019-05-11D,Race(5),,
5,0,0,0,0,0,0,0,0,0,0,0,0,0,0,0,0,61,61,0.0,M2019-05-11D,Race(5),,
6,0,0,0,0,0,0,0,0,2,0,1,3,2,0,1,3,34,34,0.0,M2019-05-11D,Race(5),,
7,0,0,0,0,0,0,0,0,0,0,0,0,0,0,0,0,101,101,0.0,M2019-05-11D,Race(5),,
8,0,0,0,0,0,0,0,0,0,0,0,0,0,0,0,0,41,41,0.0,M2019-05-11D,Race(5),,
9,0,3,4,7,3,1,2,6,1,1,2,4,4,5,8,17,10,10,0.0,M2019-05-11D,Race(5),,
10,0,0,0,0,0,0,0,0,0,0,0,0,0,0,0,0,41,41,0.0,M2019-05-11D,Race(5),,
11,5,0,11,16,5,1,4,10,6,1,5,12,16,2,20,38,5.5,5.5,2.0,M2019-05-11D,Race(5),,
12,0,10,2,12,0,0,0,0,1,0,0,1,1,10,2,13,10,10,0.0,M2019-05-11D,Race(5),,
13,0,0,3,3,0,0,2,2,0,0,3,3,0,0,8,8,12,12,0.0,M2019-05-11D,Race(5),,
14,0,0,0,0,0,0,0,0,0,0,0,0,0,0,0,0,41,41,0.0,M2019-05-11D,Race(5),,
1,2,3,2,7,4,5,5,14,6,5,5,16,12,13,12,37,7.5,7.5,0.0,M2019-05-11D,Race(6),,
2,0,2,0,2,0,0,0,0,0,1,0,1,0,3,0,3,26,26,0.0,M2019-05-11D,Race(6),,
3,0,0,0,0,0,0,1,1,1,0,2,3,1,0,3,4,26,26,0.0,M2019-05-11D,Race(6),,
4,2,0,8,10,10,13,11,34,4,1,9,14,16,14,28,58,10,10,0.0,M2019-05-11D,Race(6),,
5,0,0,6,6,0,0,0,0,0,0,0,0,0,0,6,6,17,17,3.0,M2019-05-11D,Race(6),,
6,12,3,2,17,3,1,2,6,3,2,1,6,18,6,5,29,10,10,2.0,M2019-05-11D,Race(6),,
7,14,5,9,28,12,4,5,21,12,7,6,25,38,16,20,74,1.8,1.8,1.0,M2019-05-11D,Race(6),,
8,0,0,0,0,0,0,0,0,0,0,0,0,0,0,0,0,101,101,0.0,M2019-05-11D,Race(6),,
9,0,0,0,0,0,0,0,0,0,1,0,1,0,1,0,1,81,81,0.0,M2019-05-11D,Race(6),,
10,0,6,3,9,0,2,0,2,0,2,0,2,0,10,3,13,13,13,0.0,M2019-05-11D,Race(6),,
11,0,11,0,11,1,5,6,12,0,7,3,10,1,23,9,33,7,7,0.0,M2019-05-11D,Race(6),,
12,0,0,0,0,0,0,0,0,0,0,0,0,0,0,0,0,81,81,0.0,M2019-05-11D,Race(6),,
1,0,2,3,5,1,1,1,3,1,1,1,3,2,4,5,11,20,20,0.0,M2019-05-11D,Race(7),,
2,0,0,0,0,0,0,0,0,0,0,0,0,0,0,0,0,51,41,0.0,M2019-05-11D,Race(7),,
3,0,0,0,0,0,0,0,0,0,0,0,0,0,0,0,0,31,31,0.0,M2019-05-11D,Race(7),,
4,0,3,2,5,0,0,0,0,0,1,0,1,0,4,2,6,19,18,0.0,M2019-05-11D,Race(7),,
5,9,11,2,22,18,11,9,38,10,3,2,15,37,25,13,75,6.5,7,2.0,M2019-05-11D,Race(7),,
6,3,0,0,3,1,4,5,10,4,6,2,12,8,10,7,25,8.5,8.5,0.0,M2019-05-11D,Race(7),,
7,5,3,6,14,1,1,1,3,1,0,1,2,7,4,8,19,11,10,0.0,M2019-05-11D,Race(7),,
8,13,7,5,25,8,9,4,21,7,11,6,24,28,27,15,70,2.65,2.8,1.0,M2019-05-11D,Race(7),,
9,0,0,0,0,0,0,0,0,0,0,1,1,0,0,1,1,34,31,0.0,M2019-05-11D,Race(7),,
10,0,0,0,0,0,0,1,1,0,1,0,1,0,1,1,2,13,13,0.0,M2019-05-11D,Race(7),,
11,0,2,9,11,0,3,9,12,2,1,11,14,2,6,29,37,7.5,7.5,3.0,M2019-05-11D,Race(7),,
12,0,2,3,5,1,1,0,2,1,2,1,4,2,5,4,11,8.5,8.5,0.0,M2019-05-11D,Race(7),,
13,0,0,0,0,0,0,0,0,0,0,0,0,0,0,0,0,71,61,0.0,M2019-05-11D,Race(7),,
14,0,0,0,0,0,0,0,0,0,0,1,1,0,0,1,1,61,61,0.0,M2019-05-11D,Race(7),,
1,4,3,2,9,11,14,11,36,4,7,3,14,19,24,16,59,8.5,9,1.0,M2019-05-11D,Race(8),,
2,3,2,0,5,0,4,5,9,0,2,6,8,3,8,11,22,7,7,0.0,M2019-05-11D,Race(8),,
3,0,0,0,0,0,0,0,0,1,0,1,2,1,0,1,2,71,71,0.0,M2019-05-11D,Race(8),,
4,3,2,7,12,1,2,2,5,4,2,2,8,8,6,11,25,5,4.8,0.0,M2019-05-11D,Race(8),,
5,4,2,0,6,1,2,1,4,1,2,1,4,6,6,2,14,10,11,0.0,M2019-05-11D,Race(8),,
6,0,0,0,0,0,0,0,0,0,1,0,1,0,1,0,1,41,41,0.0,M2019-05-11D,Race(8),,
7,11,3,0,14,0,1,2,3,1,3,3,7,12,7,5,24,7,7.5,0.0,M2019-05-11D,Race(8),,
8,5,9,5,19,8,1,6,15,6,4,6,16,19,14,17,50,5,5.5,0.0,M2019-05-11D,Race(8),,
9,0,0,6,6,5,1,1,7,3,1,1,5,8,2,8,18,7,6.5,3.0,M2019-05-11D,Race(8),,
10,0,2,0,2,0,0,0,0,1,0,0,1,1,2,0,3,21,21,0.0,M2019-05-11D,Race(8),,
11,0,7,10,17,4,5,2,11,5,4,3,12,9,16,15,40,7.5,7,2.0,M2019-05-11D,Race(8),,
12,0,0,0,0,0,0,0,0,0,0,0,0,0,0,0,0,41,35,0.0,M2019-05-11D,Race(8),,
1,3,3,0,6,1,0,1,2,0,0,1,1,4,3,2,9,15,16,0.0,M2019-05-11D,Race(9),,
2,0,0,0,0,0,1,1,2,0,3,0,3,0,4,1,5,18,19,3.0,M2019-05-11D,Race(9),,
3,7,5,3,15,12,11,10,33,3,7,4,14,22,23,17,62,5,5,0.0,M2019-05-11D,Race(9),,
4,2,5,9,16,1,8,7,16,2,9,5,16,5,22,21,48,8,8,0.0,M2019-05-11D,Race(9),,
5,12,10,6,28,14,7,1,22,18,4,2,24,44,21,9,74,2.6,2.7,2.0,M2019-05-11D,Race(9),,
6,3,3,2,8,1,0,2,3,2,0,3,5,6,3,7,16,10,9,0.0,M2019-05-11D,Race(9),,
7,0,0,3,3,0,0,1,1,0,1,2,3,0,1,6,7,21,21,0.0,M2019-05-11D,Race(9),,
8,0,0,0,0,0,0,0,0,0,0,0,0,0,0,0,0,41,41,0.0,M2019-05-11D,Race(9),,
9,0,0,0,0,0,1,1,2,0,1,1,2,0,2,2,4,17,16,0.0,M2019-05-11D,Race(9),,
10,3,2,3,8,1,1,1,3,1,0,1,2,5,3,5,13,12,13,0.0,M2019-05-11D,Race(9),,
11,0,2,4,6,0,0,5,5,0,0,7,7,0,2,16,18,16,16,1.0,M2019-05-11D,Race(9),,
12,0,0,0,0,0,0,0,0,0,0,0,0,0,0,0,0,61,46,0.0,M2019-05-11D,Race(9),,
13,0,0,0,0,0,0,0,0,0,0,0,0,0,0,0,0,26,26,0.0,M2019-05-11D,Race(9),,
14,0,0,0,0,0,0,0,0,0,0,0,0,0,0,0,0,51,51,0.0,M2019-05-11D,Race(9),,
1,0,5,4,9,1,3,9,13,0,1,10,11,1,9,23,33,7.5,7.5,0.0,M2019-05-15D,Race(1),,
2,2,3,2,7,1,4,1,6,1,4,2,7,4,11,5,20,13,13,3.0,M2019-05-15D,Race(1),,
3,0,0,0,0,0,0,0,0,1,0,0,1,1,0,0,1,51,51,0.0,M2019-05-15D,Race(1),,
4,19,6,5,30,2,7,6,15,6,14,2,22,27,27,13,67,3.1,3.1,0.0,M2019-05-15D,Race(1),,
5,9,11,8,28,24,9,9,42,17,5,3,25,50,25,20,95,2.1,2.1,2.0,M2019-05-15D,Race(1),,
6,0,5,11,16,2,4,4,10,1,1,7,9,3,10,22,35,8,8,1.0,M2019-05-15D,Race(1),,
7,0,0,0,0,0,1,1,2,0,0,1,1,0,1,2,3,41,41,0.0,M2019-05-15D,Race(1),,
8,0,0,0,0,0,0,0,0,0,0,0,0,0,0,0,0,81,81,0.0,M2019-05-15D,Race(1),,
9,0,0,0,0,0,2,0,2,0,1,1,2,0,3,1,4,34,35,0.0,M2019-05-15D,Race(1),,
10,0,0,0,0,0,0,0,0,0,0,0,0,0,0,0,0,34,35,0.0,M2019-05-15D,Race(1),,
11,0,0,0,0,0,0,0,0,0,0,0,0,0,0,0,0,71,67,0.0,M2019-05-15D,Race(1),,
12,0,0,0,0,0,0,0,0,0,0,0,0,0,0,0,0,71,67,0.0,M2019-05-15D,Race(1),,
1,0,2,4,6,10,10,9,29,1,2,3,6,11,14,16,41,18,18,3.0,M2019-05-15D,Race(2),,
2,2,0,0,2,1,3,2,6,5,0,3,8,8,3,5,16,13,13,0.0,M2019-05-15D,Race(2),,
3,3,2,2,7,0,0,0,0,0,0,0,0,3,2,2,7,15,15,0.0,M2019-05-15D,Race(2),,
4,0,0,0,0,0,0,0,0,0,0,0,0,0,0,0,0,81,81,0.0,M2019-05-15D,Race(2),,
5,5,5,2,12,5,4,5,14,5,6,6,17,15,15,13,43,6.5,6.5,0.0,M2019-05-15D,Race(2),,
6,15,11,2,28,8,6,5,19,13,5,5,23,36,22,12,70,2.4,2.4,1.0,M2019-05-15D,Race(2),,
7,0,0,0,0,0,0,0,0,0,0,0,0,0,0,0,0,126,126,0.0,M2019-05-15D,Race(2),,
8,0,4,3,7,3,4,3,10,2,6,0,8,5,14,6,25,9,9,0.0,M2019-05-15D,Race(2),,
9,2,6,8,16,2,3,4,9,0,5,5,10,4,14,17,35,5,5,2.0,M2019-05-15D,Race(2),,
10,0,0,6,6,0,0,1,1,0,1,2,3,0,1,9,10,13,13,0.0,M2019-05-15D,Race(2),,
11,0,0,0,0,0,0,0,0,0,0,0,0,0,0,0,0,41,41,0.0,M2019-05-15D,Race(2),,
12,3,0,3,6,1,0,1,2,0,1,2,3,4,1,6,11,13,13,0.0,M2019-05-15D,Race(2),,
1,9,6,5,20,17,12,9,38,6,8,2,16,32,26,16,74,3.7,3.7,0.0,M2019-05-15D,Race(3),,
2,0,0,0,0,0,1,0,1,0,0,3,3,0,1,3,4,26,26,0.0,M2019-05-15D,Race(3),,
3,0,0,0,0,0,1,0,1,0,0,1,1,0,1,1,2,23,23,1.0,M2019-05-15D,Race(3),,
4,0,0,0,0,0,0,0,0,0,0,0,0,0,0,0,0,0,0,0.0,M2019-05-15D,Race(3),,
5,2,0,2,4,0,5,4,9,3,5,1,9,5,10,7,22,11,11,0.0,M2019-05-15D,Race(3),,
6,0,0,0,0,0,0,0,0,0,0,0,0,0,0,0,0,12,12,2.0,M2019-05-15D,Race(3),,
7,0,2,0,2,1,2,3,6,1,2,1,4,2,6,4,12,16,16,0.0,M2019-05-15D,Race(3),,
8,0,2,9,11,1,0,1,2,0,2,2,4,1,4,12,17,13,13,0.0,M2019-05-15D,Race(3),,
9,10,14,3,27,11,5,5,21,16,6,1,23,37,25,9,71,3.6,3.6,0.0,M2019-05-15D,Race(3),,
10,0,0,0,0,0,0,0,0,0,0,0,0,0,0,0,0,41,41,0.0,M2019-05-15D,Race(3),,
11,0,0,6,6,0,2,5,7,0,3,8,11,0,5,19,24,7,7,3.0,M2019-05-15D,Race(3),,
12,9,6,5,20,0,1,2,3,0,0,6,6,9,7,13,29,6,6,0.0,M2019-05-15D,Race(3),,
1,0,2,0,2,1,1,1,3,2,3,0,5,3,6,1,10,20,20,0.0,M2019-05-15D,Race(4),,
2,0,0,2,2,1,1,1,3,1,0,0,1,2,1,3,6,17,17,0.0,M2019-05-15D,Race(4),,
3,14,5,2,21,8,12,13,33,5,2,6,13,27,19,21,67,5,5,0.0,M2019-05-15D,Race(4),,
4,0,0,0,0,0,0,0,0,0,0,0,0,0,0,0,0,41,41,0.0,M2019-05-15D,Race(4),,
5,4,2,3,9,2,1,1,4,3,0,0,3,9,3,4,16,12,12,0.0,M2019-05-15D,Race(4),,
6,0,2,0,2,0,2,2,4,0,2,4,6,0,6,6,12,6,6,0.0,M2019-05-15D,Race(4),,
7,0,0,0,0,0,0,0,0,1,2,0,3,1,2,0,3,51,51,0.0,M2019-05-15D,Race(4),,
8,2,8,6,16,3,3,4,10,5,2,4,11,10,13,14,37,10,10,3.0,M2019-05-15D,Race(4),,
9,0,0,5,5,0,1,0,1,1,1,2,4,1,2,7,10,14,14,0.0,M2019-05-15D,Race(4),,
10,3,11,4,18,4,4,2,10,3,3,2,8,10,18,8,36,5,5,1.0,M2019-05-15D,Race(4),,
11,0,0,0,0,0,0,0,0,0,0,2,2,0,0,2,2,15,15,0.0,M2019-05-15D,Race(4),,
12,7,0,8,15,7,4,6,17,5,11,6,22,19,15,20,54,4.2,4.2,2.0,M2019-05-15D,Race(4),,
1,0,0,0,0,0,0,0,0,1,1,0,2,1,1,0,2,126,126,0.0,M2019-05-15D,Race(5),,
2,0,0,0,0,0,0,0,0,0,1,0,1,0,1,0,1,126,126,0.0,M2019-05-15D,Race(5),,
3,0,0,0,0,0,0,0,0,1,0,0,1,1,0,0,1,51,51,0.0,M2019-05-15D,Race(5),,
4,15,5,5,25,18,12,11,41,11,5,4,20,44,22,20,86,2.2,2.2,3.0,M2019-05-15D,Race(5),,
5,0,0,0,0,0,0,0,0,1,0,1,2,1,0,1,2,126,126,0.0,M2019-05-15D,Race(5),,
6,3,2,0,5,0,0,1,1,1,3,2,6,4,5,3,12,11,11,1.0,M2019-05-15D,Race(5),,
7,10,10,3,23,9,10,1,20,7,8,3,18,26,28,7,61,3.5,3.5,2.0,M2019-05-15D,Race(5),,
8,0,7,10,17,2,3,8,13,2,7,5,14,4,17,23,44,8.5,8.5,0.0,M2019-05-15D,Race(5),,
9,0,0,0,0,0,2,1,3,0,0,3,3,0,2,4,6,18,18,0.0,M2019-05-15D,Race(5),,
10,0,0,0,0,0,0,0,0,0,0,0,0,0,0,0,0,51,51,0.0,M2019-05-15D,Race(5),,
11,0,0,2,2,1,2,3,6,2,1,4,7,3,3,9,15,15,15,0.0,M2019-05-15D,Race(5),,
12,2,6,10,18,0,1,5,6,0,0,4,4,2,7,19,28,7,7,0.0,M2019-05-15D,Race(5),,
1,5,3,0,8,0,1,3,4,0,1,6,7,5,5,9,19,10,10,2.0,M2019-05-15D,Race(6),,
2,0,0,7,7,0,2,3,5,0,1,5,6,0,3,15,18,23,23,0.0,M2019-05-15D,Race(6),,
3,5,5,11,21,2,1,3,6,4,3,4,11,11,9,18,38,6,6,0.0,M2019-05-15D,Race(6),,
4,8,13,2,23,20,10,9,39,15,5,2,22,43,28,13,84,2.8,2.8,1.0,M2019-05-15D,Race(6),,
5,2,0,3,5,2,3,4,9,1,5,0,6,5,8,7,20,10,10,0.0,M2019-05-15D,Race(6),,
6,5,6,5,16,4,9,5,18,5,9,4,18,14,24,14,52,6,6,0.0,M2019-05-15D,Race(6),,
7,0,0,0,0,0,0,0,0,1,0,0,1,1,0,0,1,71,67,0.0,M2019-05-15D,Race(6),,
8,0,0,0,0,0,0,0,0,0,0,0,0,0,0,0,0,17,17,0.0,M2019-05-15D,Race(6),,
9,0,0,0,0,2,2,0,4,0,0,2,2,2,2,2,6,13,13,3.0,M2019-05-15D,Race(6),,
10,0,0,0,0,0,0,0,0,0,0,0,0,0,0,0,0,34,34,0.0,M2019-05-15D,Race(6),,
11,5,3,2,10,0,1,1,2,0,1,3,4,5,5,6,16,10,10,0.0,M2019-05-15D,Race(6),,
12,0,0,0,0,0,1,2,3,0,1,0,1,0,2,2,4,17,17,0.0,M2019-05-15D,Race(6),,
1,11,5,7,23,11,6,4,21,9,8,2,19,31,19,13,63,3.7,3.7,1.0,M2019-05-15D,Race(7),,
2,2,7,2,11,9,11,11,31,4,1,4,9,15,19,17,51,9,9,0.0,M2019-05-15D,Race(7),,
3,0,0,0,0,0,0,0,0,0,1,0,1,0,1,0,1,61,61,0.0,M2019-05-15D,Race(7),,
4,10,6,3,19,4,4,6,14,7,5,7,19,21,15,16,52,4.2,4.2,3.0,M2019-05-15D,Race(7),,
5,0,5,3,8,4,5,2,11,3,5,3,11,7,15,8,30,10,10,2.0,M2019-05-15D,Race(7),,
6,5,3,10,18,0,2,3,5,1,2,4,7,6,7,17,30,7.5,7.5,0.0,M2019-05-15D,Race(7),,
7,0,0,0,0,1,0,0,1,0,0,1,1,1,0,1,2,31,31,0.0,M2019-05-15D,Race(7),,
8,0,0,0,0,0,1,1,2,0,0,1,1,0,1,2,3,18,18,0.0,M2019-05-15D,Race(7),,
9,0,0,0,0,0,0,0,0,0,0,0,0,0,0,0,0,41,41,0.0,M2019-05-15D,Race(7),,
10,0,0,0,0,0,0,0,0,0,0,0,0,0,0,0,0,17,17,0.0,M2019-05-15D,Race(7),,
11,0,0,0,0,0,0,0,0,1,0,0,1,1,0,0,1,14,14,0.0,M2019-05-15D,Race(7),,
12,2,4,5,11,1,1,3,5,0,4,4,8,3,9,12,24,6,6,0.0,M2019-05-15D,Race(7),,
1,0,0,2,2,0,0,4,4,0,0,4,4,0,0,10,10,19,19,3.0,M2019-05-15D,Race(8),,
2,0,0,0,0,0,0,2,2,2,0,0,2,2,0,2,4,17,17,1.0,M2019-05-15D,Race(8),,
3,2,0,2,4,1,2,0,3,0,0,0,0,3,2,2,7,12,12,0.0,M2019-05-15D,Race(8),,
4,0,2,0,2,1,0,0,1,2,0,0,2,3,2,0,5,13,13,0.0,M2019-05-15D,Race(8),,
5,0,0,0,0,0,0,0,0,0,0,0,0,0,0,0,0,17,17,0.0,M2019-05-15D,Race(8),,
6,0,0,0,0,0,0,1,1,0,1,1,2,0,1,2,3,31,31,0.0,M2019-05-15D,Race(8),,
7,0,0,0,0,0,0,0,0,0,0,0,0,0,0,0,0,34,34,0.0,M2019-05-15D,Race(8),,
8,3,5,14,22,13,9,11,33,8,8,3,19,24,22,28,74,4.8,4.8,0.0,M2019-05-15D,Race(8),,
9,7,13,8,28,5,6,7,18,6,2,10,18,18,21,25,64,5.5,5.5,0.0,M2019-05-15D,Race(8),,
10,13,10,2,25,10,8,4,22,8,6,6,20,31,24,12,67,3.2,3.2,2.0,M2019-05-15D,Race(8),,
11,3,0,0,3,0,2,1,3,0,5,2,7,3,7,3,13,10,10,0.0,M2019-05-15D,Race(8),,
12,2,0,2,4,0,3,0,3,0,4,0,4,2,7,2,11,12,12,0.0,M2019-05-15D,Race(8),,
1,2,2,2,6,1,1,0,2,0,0,0,0,3,3,2,8,15,15,0.0,M2019-05-18D,Race(1),,
2,2,0,2,4,0,0,0,0,0,0,0,0,2,0,2,4,10,10,0.0,M2019-05-18D,Race(1),,
3,0,0,0,0,0,0,0,0,1,0,0,1,1,0,0,1,41,41,0.0,M2019-05-18D,Race(1),,
4,0,0,0,0,0,0,1,1,0,0,0,0,0,0,1,1,14,14,2.0,M2019-05-18D,Race(1),,
5,16,5,5,26,18,10,10,38,8,4,8,20,42,19,23,84,5,5,0.0,M2019-05-18D,Race(1),,
6,2,8,0,10,1,3,0,4,1,5,1,7,4,16,1,21,13,13,0.0,M2019-05-18D,Race(1),,
7,6,3,5,14,3,2,5,10,1,5,4,10,10,10,14,34,4.6,4.5,1.0,M2019-05-18D,Race(1),,
8,0,7,2,9,3,6,5,14,6,3,5,14,9,16,12,37,12,12,0.0,M2019-05-18D,Race(1),,
9,0,0,9,9,0,0,1,1,0,0,0,0,0,0,10,10,10,10,3.0,M2019-05-18D,Race(1),,
10,2,3,2,7,0,2,0,2,0,1,1,2,2,6,3,11,8.5,8.5,0.0,M2019-05-18D,Race(1),,
11,0,2,3,5,2,2,2,6,3,3,3,9,5,7,8,20,5,5,0.0,M2019-05-18D,Race(1),,
12,0,0,0,0,0,0,0,0,0,0,0,0,0,0,0,0,61,61,0.0,M2019-05-18D,Race(1),,
1,2,5,0,7,0,2,2,4,0,2,2,4,2,9,4,15,19,19,0.0,M2019-05-18D,Race(10),,
2,19,5,6,30,25,12,7,44,21,4,1,26,65,21,14,100,1.7,1.7,2.0,M2019-05-18D,Race(10),,
3,0,0,0,0,0,0,1,1,0,0,3,3,0,0,4,4,31,27,1.0,M2019-05-18D,Race(10),,
4,0,0,0,0,0,0,0,0,0,0,0,0,0,0,0,0,41,41,0.0,M2019-05-18D,Race(10),,
5,3,0,0,3,0,2,5,7,0,3,4,7,3,5,9,17,12,12,0.0,M2019-05-18D,Race(10),,
6,6,5,12,23,4,3,9,16,4,5,8,17,14,13,29,56,8.5,9,0.0,M2019-05-18D,Race(10),,
7,0,0,0,0,0,0,0,0,0,0,0,0,0,0,0,0,91,81,0.0,M2019-05-18D,Race(10),,
8,0,0,0,0,0,2,1,3,0,1,1,2,0,3,2,5,34,34,0.0,M2019-05-18D,Race(10),,
9,0,0,0,0,0,0,0,0,0,0,0,0,0,0,0,0,34,31,0.0,M2019-05-18D,Race(10),,
10,0,0,2,2,1,0,1,2,0,0,1,1,1,0,4,5,31,27,0.0,M2019-05-18D,Race(10),,
11,0,0,3,3,0,0,0,0,0,1,1,2,0,1,4,5,26,23,3.0,M2019-05-18D,Race(10),,
12,0,0,0,0,0,0,0,0,0,0,0,0,0,0,0,0,34,34,0.0,M2019-05-18D,Race(10),,
13,0,15,7,22,0,9,4,13,1,10,5,16,1,34,16,51,5,5,0.0,M2019-05-18D,Race(10),,
14,0,0,0,0,0,0,0,0,0,0,0,0,0,0,0,0,151,151,0.0,M2019-05-18D,Race(10),,
1,20,8,2,30,23,12,8,43,17,5,1,23,60,25,11,96,2.3,2.4,3.0,M2019-05-18D,Race(2),,
2,0,8,7,15,3,10,6,19,5,9,6,20,8,27,19,54,5,6,2.0,M2019-05-18D,Race(2),,
3,2,5,3,10,1,2,3,6,0,3,4,7,3,10,10,23,6.5,6.5,0.0,M2019-05-18D,Race(2),,
4,0,3,0,3,1,1,1,3,0,2,1,3,1,6,2,9,18,18,0.0,M2019-05-18D,Race(2),,
5,2,2,0,4,0,1,2,3,0,0,2,2,2,3,4,9,15,15,0.0,M2019-05-18D,Race(2),,
6,0,0,0,0,0,1,0,1,0,0,1,1,0,1,1,2,26,26,0.0,M2019-05-18D,Race(2),,
7,6,2,12,20,2,2,8,12,4,5,8,17,12,9,28,49,4,4,1.0,M2019-05-18D,Race(2),,
8,0,0,3,3,0,0,1,1,0,0,1,1,0,0,5,5,101,101,0.0,M2019-05-18D,Race(2),,
9,0,0,0,0,0,0,0,0,0,0,0,0,0,0,0,0,61,67,0.0,M2019-05-18D,Race(2),,
10,0,0,0,0,0,0,0,0,0,0,0,0,0,0,0,0,81,81,0.0,M2019-05-18D,Race(2),,
11,0,2,3,5,0,1,1,2,0,2,1,3,0,5,5,10,19,19,0.0,M2019-05-18D,Race(2),,
12,0,0,0,0,0,0,0,0,0,0,1,1,0,0,1,1,41,61,0.0,M2019-05-18D,Race(2),,
13,0,0,0,0,0,0,0,0,0,0,0,0,0,0,0,0,61,61,0.0,M2019-05-18D,Race(2),,
14,0,0,0,0,0,0,0,0,0,0,0,0,0,0,0,0,101,101,0.0,M2019-05-18D,Race(2),,
1,0,7,8,15,10,9,9,28,2,1,0,3,12,17,17,46,13,13,0.0,M2019-05-18D,Race(3),,
2,6,5,2,13,2,6,9,17,3,8,8,19,11,19,19,49,6,6,0.0,M2019-05-18D,Race(3),,
3,19,0,5,24,15,6,1,22,12,10,0,22,46,16,6,68,2.7,2.7,1.0,M2019-05-18D,Race(3),,
4,0,0,0,0,0,0,0,0,0,0,0,0,0,0,0,0,81,81,0.0,M2019-05-18D,Race(3),,
5,0,0,0,0,0,0,0,0,0,2,0,2,0,2,0,2,21,21,0.0,M2019-05-18D,Race(3),,
6,0,0,4,4,0,2,2,4,0,0,7,7,0,2,13,15,7.5,7.5,0.0,M2019-05-18D,Race(3),,
7,0,0,0,0,0,0,0,0,2,0,0,2,2,0,0,2,26,26,0.0,M2019-05-18D,Race(3),,
8,0,0,0,0,0,2,0,2,0,2,1,3,0,4,1,5,18,18,0.0,M2019-05-18D,Race(3),,
9,0,0,0,0,0,0,0,0,0,0,0,0,0,0,0,0,61,61,0.0,M2019-05-18D,Race(3),,
10,0,3,0,3,0,1,3,4,0,0,2,2,0,4,5,9,20,26,0.0,M2019-05-18D,Race(3),,
11,3,12,6,21,3,3,5,11,7,3,6,16,13,18,17,48,5.5,6,2.0,M2019-05-18D,Race(3),,
12,2,3,5,10,0,1,1,2,0,0,2,2,2,4,8,14,5.5,5.5,3.0,M2019-05-18D,Race(3),,
1,0,0,0,0,1,2,9,12,0,0,0,0,1,2,9,12,0,0,0.0,M2019-05-18D,Race(4),,
2,0,6,7,13,0,1,2,3,1,1,1,3,1,8,10,19,16,16,0.0,M2019-05-18D,Race(4),,
3,0,2,7,9,0,3,2,5,0,1,2,3,0,6,11,17,11,11,0.0,M2019-05-18D,Race(4),,
4,0,0,0,0,0,0,0,0,0,1,1,2,0,1,1,2,61,61,0.0,M2019-05-18D,Race(4),,
5,0,0,0,0,0,0,0,0,0,0,0,0,0,0,0,0,51,51,0.0,M2019-05-18D,Race(4),,
6,18,10,2,30,17,17,10,44,14,8,4,26,49,35,16,100,1.7,1.7,1.0,M2019-05-18D,Race(4),,
7,0,0,3,3,0,0,1,1,0,0,1,1,0,0,5,5,21,21,2.0,M2019-05-18D,Race(4),,
8,0,2,6,8,0,0,2,2,0,1,2,3,0,3,10,13,14,14,0.0,M2019-05-18D,Race(4),,
9,0,0,0,0,0,0,1,1,0,0,2,2,0,0,3,3,26,26,0.0,M2019-05-18D,Race(4),,
10,12,10,5,27,12,7,3,22,10,10,4,24,34,27,12,73,2.9,2.9,3.0,M2019-05-18D,Race(4),,
1,3,0,3,6,0,1,1,2,2,0,1,3,5,1,5,11,12,12,0.0,M2019-05-18D,Race(5),,
2,2,5,5,12,8,13,12,33,1,5,4,10,11,23,21,55,6.5,6.5,0.0,M2019-05-18D,Race(5),,
3,0,2,0,2,0,1,0,1,1,2,1,4,1,5,1,7,19,19,0.0,M2019-05-18D,Race(5),,
4,2,0,5,7,0,4,1,5,1,4,0,5,3,8,6,17,8.5,8.5,3.0,M2019-05-18D,Race(5),,
5,0,0,2,2,0,0,1,1,0,0,0,0,0,0,3,3,34,34,0.0,M2019-05-18D,Race(5),,
6,0,0,0,0,0,0,0,0,0,0,2,2,0,0,2,2,26,26,0.0,M2019-05-18D,Race(5),,
7,0,5,0,5,0,0,0,0,0,0,0,0,0,5,0,5,21,21,0.0,M2019-05-18D,Race(5),,
8,15,5,10,30,17,3,2,22,17,6,0,23,49,14,12,75,3.1,3.1,1.0,M2019-05-18D,Race(5),,
9,0,0,0,0,1,0,1,2,1,2,2,5,2,2,3,7,19,19,2.0,M2019-05-18D,Race(5),,
10,2,0,3,5,0,0,0,0,0,0,0,0,2,0,3,5,15,15,0.0,M2019-05-18D,Race(5),,
11,0,0,0,0,0,0,0,0,0,0,0,0,0,0,0,0,126,126,0.0,M2019-05-18D,Race(5),,
12,0,0,2,2,3,8,5,16,2,7,9,18,5,15,16,36,8.5,8.5,0.0,M2019-05-18D,Race(5),,
13,0,0,0,0,0,0,0,0,0,0,0,0,0,0,0,0,151,151,0.0,M2019-05-18D,Race(5),,
14,6,13,0,19,1,0,7,8,1,0,7,8,8,13,14,35,5.5,5.5,0.0,M2019-05-18D,Race(5),,
1,10,3,6,19,18,4,0,22,14,6,1,21,42,13,7,62,3.2,3.2,0.0,M2019-05-18D,Race(6),,
2,0,2,0,2,0,3,0,3,2,4,0,6,2,9,0,11,14,14,2.0,M2019-05-18D,Race(6),,
3,0,3,0,3,1,0,1,2,1,0,1,2,2,3,2,7,12,12,0.0,M2019-05-18D,Race(6),,
4,8,5,11,24,9,10,17,36,3,5,5,13,20,20,33,73,4.6,4.6,3.0,M2019-05-18D,Race(6),,
5,0,0,0,0,1,0,1,2,1,0,1,2,2,0,2,4,19,19,0.0,M2019-05-18D,Race(6),,
6,2,2,5,9,1,2,3,6,2,3,6,11,5,7,14,26,9,9,0.0,M2019-05-18D,Race(6),,
7,10,5,5,20,0,9,4,13,2,6,7,15,12,20,16,48,6,6,0.0,M2019-05-18D,Race(6),,
8,0,0,0,0,0,0,0,0,0,0,0,0,0,0,0,0,51,71,0.0,M2019-05-18D,Race(6),,
9,0,10,3,13,0,2,4,6,1,2,4,7,1,14,11,26,7,7,0.0,M2019-05-18D,Race(6),,
10,0,0,0,0,0,0,0,0,0,0,0,0,0,0,0,0,151,201,0.0,M2019-05-18D,Race(6),,
11,0,0,0,0,0,0,0,0,0,0,0,0,0,0,0,0,126,126,0.0,M2019-05-18D,Race(6),,
12,0,0,0,0,0,0,0,0,0,0,0,0,0,0,0,0,19,19,1.0,M2019-05-18D,Race(6),,
13,0,0,0,0,0,0,0,0,0,0,1,1,0,0,1,1,51,51,0.0,M2019-05-18D,Race(6),,
14,0,0,0,0,0,0,0,0,0,0,0,0,0,0,0,0,51,51,0.0,M2019-05-18D,Race(6),,
1,0,0,0,0,0,3,0,3,1,3,0,4,1,6,0,7,14,14,0.0,M2019-05-18D,Race(7),,
2,16,4,5,25,23,12,8,43,13,9,3,25,52,25,16,93,2.45,2.45,0.0,M2019-05-18D,Race(7),,
3,0,12,0,12,0,2,7,9,1,2,7,10,1,16,14,31,7,7,1.0,M2019-05-18D,Race(7),,
4,0,0,0,0,0,0,0,0,0,1,1,2,0,1,1,2,31,31,0.0,M2019-05-18D,Race(7),,
5,0,0,2,2,1,0,1,2,1,1,2,4,2,1,5,8,21,21,0.0,M2019-05-18D,Race(7),,
6,0,0,0,0,0,0,0,0,0,0,0,0,0,0,0,0,51,51,0.0,M2019-05-18D,Race(7),,
7,7,11,5,23,6,11,2,19,8,9,3,20,21,31,10,62,3.6,3.6,2.0,M2019-05-18D,Race(7),,
8,0,0,5,5,0,0,2,2,0,0,2,2,0,0,9,9,13,13,3.0,M2019-05-18D,Race(7),,
9,0,0,0,0,0,0,0,0,0,0,0,0,0,0,0,0,61,61,0.0,M2019-05-18D,Race(7),,
10,7,3,13,23,0,2,10,12,2,1,8,11,9,6,31,46,7,7,0.0,M2019-05-18D,Race(7),,
11,0,0,0,0,0,0,0,0,0,0,0,0,0,0,0,0,26,26,0.0,M2019-05-18D,Race(7),,
1,3,5,4,12,8,7,3,18,5,10,2,17,16,22,9,47,8,8,0.0,M2019-05-18D,Race(8),,
2,0,0,0,0,0,0,0,0,0,1,0,1,0,1,0,1,151,151,0.0,M2019-05-18D,Race(8),,
3,10,8,2,20,7,9,13,29,2,1,11,14,19,18,26,63,4.2,4.2,0.0,M2019-05-18D,Race(8),,
4,0,0,0,0,0,0,0,0,0,2,0,2,0,2,0,2,126,126,0.0,M2019-05-18D,Race(8),,
5,0,2,2,4,0,1,3,4,0,1,3,4,0,4,8,12,14,14,0.0,M2019-05-18D,Race(8),,
6,13,13,0,26,15,4,4,23,17,3,5,25,45,20,9,74,2.5,2.5,2.0,M2019-05-18D,Race(8),,
7,0,0,0,0,0,0,0,0,0,0,0,0,0,0,0,0,51,51,0.0,M2019-05-18D,Race(8),,
8,2,0,8,10,0,4,3,7,0,4,3,7,2,8,14,24,8.5,8.5,1.0,M2019-05-18D,Race(8),,
9,2,0,3,5,0,2,1,3,1,1,0,2,3,3,4,10,9.5,9.5,0.0,M2019-05-18D,Race(8),,
10,0,0,6,6,0,0,1,1,0,0,0,0,0,0,7,7,21,21,0.0,M2019-05-18D,Race(8),,
11,0,2,2,4,0,1,0,1,1,0,0,1,1,3,2,6,13,13,3.0,M2019-05-18D,Race(8),,
12,0,0,3,3,0,2,2,4,0,3,2,5,0,5,7,12,16,16,0.0,M2019-05-18D,Race(8),,
1,0,0,0,0,2,0,0,2,0,1,0,1,2,1,0,3,26,26,0.0,M2019-05-18D,Race(9),,
2,5,5,3,13,2,6,3,11,1,3,5,9,8,14,11,33,10,10,0.0,M2019-05-18D,Race(9),,
3,0,0,0,0,0,0,0,0,0,0,0,0,0,0,0,0,71,71,0.0,M2019-05-18D,Race(9),,
4,7,13,10,30,15,15,12,42,10,11,4,25,32,39,26,97,3.2,3.2,2.0,M2019-05-18D,Race(9),,
5,15,3,5,23,9,6,6,21,13,7,2,22,37,16,13,66,2.25,2.25,1.0,M2019-05-18D,Race(9),,
6,0,0,0,0,0,0,0,0,0,0,0,0,0,0,0,0,61,61,0.0,M2019-05-18D,Race(9),,
7,0,2,2,4,0,0,1,1,0,0,0,0,0,2,3,5,26,26,0.0,M2019-05-18D,Race(9),,
8,0,0,3,3,0,0,0,0,0,0,0,0,0,0,3,3,26,26,0.0,M2019-05-18D,Race(9),,
9,0,2,0,2,1,1,1,3,0,3,2,5,1,6,3,10,21,21,0.0,M2019-05-18D,Race(9),,
10,0,0,0,0,0,0,0,0,0,0,0,0,0,0,0,0,71,67,0.0,M2019-05-18D,Race(9),,
11,0,0,0,0,0,0,1,1,0,0,2,2,0,0,3,3,13,13,0.0,M2019-05-18D,Race(9),,
12,0,0,0,0,0,0,0,0,0,0,0,0,0,0,0,0,151,151,0.0,M2019-05-18D,Race(9),,
13,3,5,7,15,1,2,6,9,2,1,11,14,6,8,24,38,9,9,3.0,M2019-05-18D,Race(9),,
14,0,0,0,0,0,0,0,0,0,0,0,0,0,0,0,0,51,51,0.0,M2019-05-18D,Race(9),,
1,2,6,0,8,5,5,5,15,6,1,5,12,13,12,10,35,6,6,0.0,M2019-05-22D,Race(1),,
2,0,0,3,3,0,0,1,1,0,0,4,4,0,0,8,8,16,16,0.0,M2019-05-22D,Race(1),,
3,0,0,0,0,0,0,8,8,0,0,1,1,0,0,9,9,16,16,3.0,M2019-05-22D,Race(1),,
4,5,0,4,9,1,3,4,8,1,5,3,9,7,8,11,26,10,10,0.0,M2019-05-22D,Race(1),,
5,0,3,2,5,1,4,3,8,0,6,2,8,1,13,7,21,13,13,0.0,M2019-05-22D,Race(1),,
6,0,0,2,2,8,1,2,11,4,3,0,7,12,4,4,20,14,14,0.0,M2019-05-22D,Race(1),,
7,0,0,0,0,0,8,0,8,0,0,0,0,0,8,0,8,21,21,0.0,M2019-05-22D,Race(1),,
8,2,5,0,7,0,1,0,1,1,2,0,3,3,8,0,11,21,21,0.0,M2019-05-22D,Race(1),,
9,0,2,3,5,0,0,0,0,1,2,1,4,1,4,4,9,12,12,0.0,M2019-05-22D,Race(1),,
10,16,4,5,25,15,4,3,22,13,3,5,21,44,11,13,68,3.8,3.8,2.0,M2019-05-22D,Race(1),,
11,2,5,5,12,0,3,0,3,0,3,0,3,2,11,5,18,6.5,6.5,1.0,M2019-05-22D,Race(1),,
12,3,5,6,14,0,1,4,5,0,1,5,6,3,7,15,25,7,7,0.0,M2019-05-22D,Race(1),,
1,7,5,8,20,0,1,2,3,1,3,2,6,8,9,12,29,9,9,0.0,M2019-05-22D,Race(2),,
2,0,0,0,0,0,0,0,0,0,0,0,0,0,0,0,0,26,26,0.0,M2019-05-22D,Race(2),,
3,0,0,3,3,0,1,4,5,0,1,2,3,0,2,9,11,21,21,0.0,M2019-05-22D,Race(2),,
4,3,9,10,22,2,10,3,15,5,6,4,15,10,25,17,52,5,5,0.0,M2019-05-22D,Race(2),,
5,14,9,7,30,20,3,0,23,20,6,0,26,54,18,7,79,2,2,3.0,M2019-05-22D,Race(2),,
6,0,0,0,0,0,0,0,0,0,0,0,0,0,0,0,0,41,41,0.0,M2019-05-22D,Race(2),,
7,0,0,0,0,0,0,0,0,0,0,0,0,0,0,0,0,126,126,0.0,M2019-05-22D,Race(2),,
8,6,2,2,10,8,4,9,21,0,8,11,19,14,14,22,50,5.5,5.5,1.0,M2019-05-22D,Race(2),,
9,0,3,0,3,0,2,3,5,0,1,5,6,0,6,8,14,26,26,0.0,M2019-05-22D,Race(2),,
10,0,0,0,0,0,0,8,8,0,0,1,1,0,0,9,9,26,26,0.0,M2019-05-22D,Race(2),,
11,0,2,0,2,0,1,1,2,0,0,1,1,0,3,2,5,19,19,2.0,M2019-05-22D,Race(2),,
12,0,0,0,0,0,8,0,8,0,1,0,1,0,9,0,9,26,26,0.0,M2019-05-22D,Race(2),,
1,0,2,0,2,1,2,2,5,2,2,2,6,3,6,4,13,13,13,0.0,M2019-05-22D,Race(3),,
2,5,7,2,14,7,5,10,22,6,7,8,21,18,19,20,57,5,5,0.0,M2019-05-22D,Race(3),,
3,0,0,0,0,0,0,0,0,0,1,0,1,0,1,0,1,41,41,0.0,M2019-05-22D,Race(3),,
4,2,2,2,6,0,9,0,9,0,0,2,2,2,11,4,17,7.5,7.5,0.0,M2019-05-22D,Race(3),,
5,0,0,2,2,1,1,8,10,2,1,0,3,3,2,10,15,19,19,2.0,M2019-05-22D,Race(3),,
6,0,3,3,6,0,0,2,2,0,3,6,9,0,6,11,17,17,17,0.0,M2019-05-22D,Race(3),,
7,0,9,3,12,8,3,1,12,2,3,1,6,10,15,5,30,10,10,0.0,M2019-05-22D,Race(3),,
8,14,2,7,23,9,4,4,17,14,2,4,20,37,8,15,60,3.2,3.2,0.0,M2019-05-22D,Race(3),,
9,0,0,0,0,0,2,0,2,0,1,0,1,0,3,0,3,15,15,3.0,M2019-05-22D,Race(3),,
10,9,5,11,25,4,4,3,11,0,6,3,9,13,15,17,45,5.5,5.5,1.0,M2019-05-22D,Race(3),,
11,0,0,0,0,0,0,0,0,0,0,0,0,0,0,0,0,31,31,0.0,M2019-05-22D,Race(3),,
12,0,0,0,0,0,0,0,0,0,0,0,0,0,0,0,0,26,26,0.0,M2019-05-22D,Race(3),,
1,17,9,2,28,11,8,2,21,13,6,3,22,41,23,7,71,2.8,2.8,1.0,M2019-05-22D,Race(4),,
2,3,11,2,16,3,2,7,12,3,2,6,11,9,15,15,39,6.5,6.5,0.0,M2019-05-22D,Race(4),,
3,0,0,3,3,1,8,3,12,0,1,3,4,1,9,9,19,15,15,0.0,M2019-05-22D,Race(4),,
4,2,3,6,11,4,6,7,17,7,7,6,20,13,16,19,48,11,11,0.0,M2019-05-22D,Race(4),,
5,0,0,0,0,0,0,0,0,0,0,0,0,0,0,0,0,81,81,0.0,M2019-05-22D,Race(4),,
6,4,3,12,19,2,2,1,5,0,3,3,6,6,8,16,30,6.5,6.5,0.0,M2019-05-22D,Race(4),,
7,0,0,0,0,0,0,0,0,0,1,0,1,0,1,0,1,31,31,0.0,M2019-05-22D,Race(4),,
8,0,0,2,2,8,0,2,10,0,0,0,0,8,0,4,12,10,10,2.0,M2019-05-22D,Race(4),,
9,0,0,3,3,0,0,0,0,0,0,1,1,0,0,4,4,21,21,3.0,M2019-05-22D,Race(4),,
10,0,0,0,0,0,0,0,0,0,0,0,0,0,0,0,0,21,21,0.0,M2019-05-22D,Race(4),,
11,0,0,0,0,0,0,0,0,1,0,1,2,1,0,1,2,21,21,0.0,M2019-05-22D,Race(4),,
12,4,4,0,8,1,4,8,13,2,6,3,11,7,14,11,32,6,6,0.0,M2019-05-22D,Race(4),,
1,14,12,0,26,15,5,3,23,19,2,2,23,48,19,5,72,2.6,2.6,0.0,M2019-05-22D,Race(5),,
2,0,0,8,8,1,8,1,10,0,2,3,5,1,10,12,23,17,17,2.0,M2019-05-22D,Race(5),,
3,0,3,2,5,0,4,8,12,1,3,11,15,1,10,21,32,9,9,1.0,M2019-05-22D,Race(5),,
4,0,2,0,2,0,2,2,4,2,2,0,4,2,6,2,10,7,7,0.0,M2019-05-22D,Race(5),,
5,2,0,2,4,2,3,1,6,1,1,2,4,5,4,5,14,16,16,0.0,M2019-05-22D,Race(5),,
6,0,2,0,2,0,0,0,0,0,0,0,0,0,2,0,2,21,21,0.0,M2019-05-22D,Race(5),,
7,0,0,0,0,0,1,0,1,0,0,0,0,0,1,0,1,17,17,0.0,M2019-05-22D,Race(5),,
8,9,3,8,20,4,4,3,11,2,12,2,16,15,19,13,47,0,0,0.0,M2019-05-22D,Race(5),,
9,0,3,6,9,0,2,1,3,0,4,1,5,0,9,8,17,10,10,0.0,M2019-05-22D,Race(5),,
10,0,0,0,0,0,0,2,2,0,0,2,2,0,0,4,4,17,17,0.0,M2019-05-22D,Race(5),,
11,2,3,2,7,8,1,1,10,1,0,2,3,11,4,5,20,6,6,0.0,M2019-05-22D,Race(5),,
12,3,2,2,7,0,0,8,8,0,0,1,1,3,2,11,16,12,12,3.0,M2019-05-22D,Race(5),,
1,2,0,5,7,8,1,0,9,0,0,1,1,10,1,6,17,15,15,0.0,M2019-05-22D,Race(6),,
2,5,2,8,15,6,2,5,13,6,2,3,11,17,6,16,39,8,8,0.0,M2019-05-22D,Race(6),,
3,0,0,0,0,0,0,0,0,0,0,0,0,0,0,0,0,19,19,0.0,M2019-05-22D,Race(6),,
4,4,3,9,16,4,3,6,13,3,3,5,11,11,9,20,40,6,6,2.0,M2019-05-22D,Race(6),,
5,0,0,2,2,0,0,0,0,0,0,0,0,0,0,2,2,26,26,0.0,M2019-05-22D,Race(6),,
6,6,14,2,22,7,8,3,18,10,7,4,21,23,29,9,61,2.8,2.8,1.0,M2019-05-22D,Race(6),,
7,8,8,0,16,5,8,7,20,5,14,5,24,18,30,12,60,3.5,3.5,3.0,M2019-05-22D,Race(6),,
8,0,0,0,0,0,0,0,0,0,0,1,1,0,0,1,1,26,26,0.0,M2019-05-22D,Race(6),,
9,0,0,2,2,0,0,8,8,0,0,0,0,0,0,10,10,19,19,0.0,M2019-05-22D,Race(6),,
10,0,0,0,0,0,0,0,0,0,0,0,0,0,0,0,0,101,101,0.0,M2019-05-22D,Race(6),,
11,3,0,2,5,0,0,1,1,0,0,3,3,3,0,6,9,19,19,0.0,M2019-05-22D,Race(6),,
12,0,0,0,0,0,8,0,8,0,0,1,1,0,8,1,9,26,26,0.0,M2019-05-22D,Race(6),,
1,2,10,3,15,6,3,2,11,11,5,1,17,19,18,6,43,3.8,3.8,0.0,M2019-05-22D,Race(7),,
2,0,0,0,0,1,0,0,1,0,0,0,0,1,0,0,1,34,34,0.0,M2019-05-22D,Race(7),,
3,0,3,9,12,2,6,5,13,3,5,4,12,5,14,18,37,8.5,8.5,0.0,M2019-05-22D,Race(7),,
4,3,2,3,8,1,1,3,5,0,0,3,3,4,3,9,16,7,7,0.0,M2019-05-22D,Race(7),,
5,14,6,5,25,5,6,5,16,7,6,4,17,26,18,14,58,3.8,3.8,3.0,M2019-05-22D,Race(7),,
6,6,0,5,11,0,1,1,2,0,2,2,4,6,3,8,17,10,10,0.0,M2019-05-22D,Race(7),,
7,0,0,0,0,0,0,8,8,0,2,0,2,0,2,8,10,51,51,0.0,M2019-05-22D,Race(7),,
8,0,2,3,5,0,8,3,11,0,0,6,6,0,10,12,22,14,14,2.0,M2019-05-22D,Race(7),,
9,0,0,0,0,8,4,3,15,2,3,2,7,10,7,5,22,7.5,7.5,1.0,M2019-05-22D,Race(7),,
10,0,7,0,7,2,1,0,3,1,2,4,7,3,10,4,17,16,16,0.0,M2019-05-22D,Race(7),,
11,5,0,2,7,5,0,0,5,2,1,0,3,12,1,2,15,18,18,0.0,M2019-05-22D,Race(7),,
12,0,0,0,0,0,0,0,0,0,0,0,0,0,0,0,0,51,51,0.0,M2019-05-22D,Race(7),,
1,2,0,8,10,2,1,4,7,5,1,6,12,9,2,18,29,13,13,0.0,M2019-05-22D,Race(8),,
2,0,0,0,0,8,1,1,10,1,0,1,2,9,1,2,12,15,14,0.0,M2019-05-22D,Race(8),,
3,0,3,3,6,1,8,1,10,0,1,1,2,1,12,5,18,15,15,0.0,M2019-05-22D,Race(8),,
4,0,0,0,0,0,0,1,1,0,0,1,1,0,0,2,2,41,41,0.0,M2019-05-22D,Race(8),,
5,5,9,8,22,11,5,2,18,8,7,2,17,24,21,12,57,4,4,3.0,M2019-05-22D,Race(8),,
6,17,5,5,27,5,5,7,17,9,6,6,21,31,16,18,65,2.9,2.8,1.0,M2019-05-22D,Race(8),,
7,0,0,0,0,0,0,0,0,0,0,0,0,0,0,0,0,34,34,0.0,M2019-05-22D,Race(8),,
8,0,0,0,0,0,2,0,2,0,0,0,0,0,2,0,2,41,41,0.0,M2019-05-22D,Race(8),,
9,0,0,2,2,0,0,8,8,0,0,3,3,0,0,13,13,26,26,0.0,M2019-05-22D,Race(8),,
10,0,0,0,0,0,0,0,0,0,0,0,0,0,0,0,0,26,26,0.0,M2019-05-22D,Race(8),,
11,6,13,4,23,3,7,6,16,3,11,6,20,12,31,16,59,3,3.8,2.0,M2019-05-22D,Race(8),,
12,0,0,0,0,0,1,0,1,0,0,0,0,0,1,0,1,26,26,0.0,M2019-05-22D,Race(8),,
1,0,0,0,0,0,0,0,0,0,0,1,1,0,0,1,1,31,31,0.0,M2019-05-26D,Race(1),,
2,0,0,0,0,0,0,0,0,0,0,0,0,0,0,0,0,81,81,2.0,M2019-05-26D,Race(1),,
3,0,0,5,5,0,0,0,0,0,0,1,1,0,0,6,6,31,31,0.0,M2019-05-26D,Race(1),,
4,0,0,3,3,0,8,10,18,2,3,4,9,2,11,17,30,26,26,0.0,M2019-05-26D,Race(1),,
5,0,0,8,8,0,0,7,7,1,1,5,7,1,1,20,22,41,41,0.0,M2019-05-26D,Race(1),,
6,0,0,3,3,0,0,0,0,0,0,2,2,0,0,5,5,101,101,0.0,M2019-05-26D,Race(1),,
7,30,0,0,30,30,0,0,30,22,2,1,25,82,2,1,85,1.16,1.16,1.0,M2019-05-26D,Race(1),,
8,0,2,7,9,0,3,10,13,0,1,9,10,0,6,26,32,18,18,0.0,M2019-05-26D,Race(1),,
9,0,26,4,30,0,19,3,22,1,19,2,22,1,64,9,74,6,6,3.0,M2019-05-26D,Race(1),,
10,0,2,0,2,0,0,0,0,0,0,1,1,0,2,1,3,26,26,0.0,M2019-05-26D,Race(1),,
1,4,3,12,19,11,7,4,22,3,2,4,9,18,12,20,50,9.5,9,0.0,M2019-05-26D,Race(10),,
2,6,0,2,8,0,0,4,4,0,0,2,2,6,0,8,14,11,12,0.0,M2019-05-26D,Race(10),,
3,0,2,3,5,0,1,1,2,0,0,0,0,0,3,4,7,14,15,0.0,M2019-05-26D,Race(10),,
4,0,0,0,0,0,0,0,0,1,1,0,2,1,1,0,2,26,27,0.0,M2019-05-26D,Race(10),,
5,0,3,0,3,0,1,1,2,0,3,1,4,0,7,2,9,17,17,0.0,M2019-05-26D,Race(10),,
6,10,10,10,30,12,12,5,29,15,5,5,25,37,27,20,84,3.3,3.2,3.0,M2019-05-26D,Race(10),,
7,10,8,0,18,2,3,7,12,2,6,3,11,14,17,10,41,4,4,1.0,M2019-05-26D,Race(10),,
8,0,0,0,0,0,0,0,0,0,0,1,1,0,0,1,1,26,26,0.0,M2019-05-26D,Race(10),,
9,0,0,3,3,1,0,1,2,1,2,5,8,2,2,9,13,10,11,0.0,M2019-05-26D,Race(10),,
10,0,0,0,0,2,1,3,6,1,2,2,5,3,3,5,11,18,17,0.0,M2019-05-26D,Race(10),,
11,0,2,0,2,2,4,3,9,3,5,2,10,5,11,5,21,9,9.5,0.0,M2019-05-26D,Race(10),,
12,0,0,0,0,0,0,0,0,0,0,0,0,0,0,0,0,151,151,0.0,M2019-05-26D,Race(10),,
13,0,2,0,2,0,1,1,2,0,0,1,1,0,3,2,5,21,20,2.0,M2019-05-26D,Race(10),,
14,0,0,0,0,0,0,0,0,0,0,0,0,0,0,0,0,71,71,0.0,M2019-05-26D,Race(10),,
1,7,2,6,15,8,11,4,23,9,5,2,16,24,18,12,54,8,8,0.0,M2019-05-26D,Race(11),,
2,2,3,2,7,0,0,0,0,1,2,0,3,3,5,2,10,13,13,3.0,M2019-05-26D,Race(11),,
3,5,0,0,5,0,1,2,3,0,1,2,3,5,2,4,11,15,15,0.0,M2019-05-26D,Race(11),,
4,0,0,16,16,5,6,13,24,6,3,5,14,11,9,34,54,3.5,3.5,1.0,M2019-05-26D,Race(11),,
5,0,3,0,3,0,0,2,2,0,0,3,3,0,3,5,8,11,11,0.0,M2019-05-26D,Race(11),,
6,5,9,4,18,9,3,5,17,2,2,2,6,16,14,11,41,8,8,2.0,M2019-05-26D,Race(11),,
7,0,2,0,2,1,1,1,3,1,2,3,6,2,5,4,11,17,17,0.0,M2019-05-26D,Race(11),,
8,0,7,2,9,1,2,2,5,3,1,3,7,4,10,7,21,10,10,0.0,M2019-05-26D,Race(11),,
9,0,0,0,0,0,0,0,0,0,0,1,1,0,0,1,1,16,16,0.0,M2019-05-26D,Race(11),,
10,0,0,0,0,0,0,0,0,1,2,0,3,1,2,0,3,26,26,0.0,M2019-05-26D,Race(11),,
11,0,0,0,0,0,0,0,0,0,1,0,1,0,1,0,1,21,21,0.0,M2019-05-26D,Race(11),,
12,0,0,0,0,0,0,0,0,0,0,0,0,0,0,0,0,21,21,0.0,M2019-05-26D,Race(11),,
13,0,0,0,0,0,0,0,0,0,0,0,0,0,0,0,0,101,101,0.0,M2019-05-26D,Race(11),,
14,11,4,0,15,6,6,1,13,3,7,5,15,20,17,6,43,7,7,0.0,M2019-05-26D,Race(11),,
1,0,0,0,0,1,0,1,2,0,1,1,2,1,1,2,4,19,19,0.0,M2019-05-26D,Race(2),,
2,5,5,8,18,13,7,4,24,8,3,6,17,26,15,18,59,4,4,0.0,M2019-05-26D,Race(2),,
3,6,5,9,20,1,9,2,12,1,4,3,8,8,18,14,40,8.5,8.5,0.0,M2019-05-26D,Race(2),,
4,0,0,0,0,0,0,0,0,0,0,0,0,0,0,0,0,41,41,0.0,M2019-05-26D,Race(2),,
5,0,0,0,0,0,0,0,0,0,0,0,0,0,0,0,0,126,126,0.0,M2019-05-26D,Race(2),,
6,0,0,0,0,0,0,0,0,0,0,0,0,0,0,0,0,71,67,0.0,M2019-05-26D,Race(2),,
7,0,2,2,4,1,5,10,16,2,6,5,13,3,13,17,33,14,14,3.0,M2019-05-26D,Race(2),,
8,6,12,4,22,6,3,8,17,5,8,6,19,17,23,18,58,4.6,4.6,2.0,M2019-05-26D,Race(2),,
9,0,0,0,0,0,0,0,0,0,0,0,0,0,0,0,0,151,151,0.0,M2019-05-26D,Race(2),,
10,11,6,5,22,8,6,4,18,8,3,3,14,27,15,12,54,2.4,2.4,1.0,M2019-05-26D,Race(2),,
11,0,0,0,0,0,0,0,0,1,0,0,1,1,0,0,1,61,61,0.0,M2019-05-26D,Race(2),,
12,2,0,2,4,0,0,1,1,1,1,2,4,3,1,5,9,21,21,0.0,M2019-05-26D,Race(2),,
13,0,0,0,0,0,0,0,0,0,0,0,0,0,0,0,0,61,61,0.0,M2019-05-26D,Race(2),,
14,0,0,0,0,0,0,0,0,0,0,0,0,0,0,0,0,51,51,0.0,M2019-05-26D,Race(2),,
1,4,11,3,18,14,9,4,27,5,5,10,20,23,25,17,65,7.5,7.5,0.0,M2019-05-26D,Race(3),,
2,0,0,0,0,0,0,0,0,0,0,0,0,0,0,0,0,41,41,0.0,M2019-05-26D,Race(3),,
3,0,3,0,3,0,0,0,0,1,0,0,1,1,3,0,4,10,10,2.0,M2019-05-26D,Race(3),,
4,6,2,5,13,4,9,6,19,7,5,2,14,17,16,13,46,7.5,8.5,0.0,M2019-05-26D,Race(3),,
5,3,8,8,19,2,3,11,16,3,4,5,12,8,15,24,47,7,7,3.0,M2019-05-26D,Race(3),,
6,0,0,0,0,0,0,0,0,0,0,0,0,0,0,0,0,51,51,0.0,M2019-05-26D,Race(3),,
7,4,0,5,9,1,3,2,6,2,7,1,10,7,10,8,25,5.5,5.5,0.0,M2019-05-26D,Race(3),,
8,0,0,0,0,0,0,0,0,0,0,0,0,0,0,0,0,26,31,0.0,M2019-05-26D,Race(3),,
9,8,2,4,14,7,4,5,16,6,3,5,14,21,9,14,44,3.2,3.2,1.0,M2019-05-26D,Race(3),,
10,0,0,0,0,0,0,0,0,0,0,0,0,0,0,0,0,101,101,0.0,M2019-05-26D,Race(3),,
11,0,2,3,5,0,0,0,0,0,0,0,0,0,2,3,5,34,35,0.0,M2019-05-26D,Race(3),,
12,3,2,2,7,2,2,1,5,2,2,1,5,7,6,4,17,8.5,9,0.0,M2019-05-26D,Race(3),,
13,2,0,0,2,0,0,1,1,0,0,2,2,2,0,3,5,19,19,0.0,M2019-05-26D,Race(3),,
14,0,0,0,0,0,0,0,0,0,0,0,0,0,0,0,0,81,81,0.0,M2019-05-26D,Race(3),,
1,30,0,0,30,29,1,0,30,25,1,0,26,84,2,0,86,1.36,1.36,2.0,M2019-05-26D,Race(4),,
2,0,0,0,0,0,0,0,0,0,0,1,1,0,0,1,1,81,81,0.0,M2019-05-26D,Race(4),,
3,0,0,0,0,0,0,0,0,0,0,0,0,0,0,0,0,81,81,0.0,M2019-05-26D,Race(4),,
4,0,0,0,0,0,0,1,1,0,0,1,1,0,0,2,2,51,51,0.0,M2019-05-26D,Race(4),,
5,0,0,0,0,0,0,0,0,0,0,0,0,0,0,0,0,51,51,0.0,M2019-05-26D,Race(4),,
6,0,0,0,0,0,0,0,0,0,1,1,2,0,1,1,2,151,151,0.0,M2019-05-26D,Race(4),,
7,0,6,7,13,0,12,8,20,0,5,6,11,0,23,21,44,9,9,0.0,M2019-05-26D,Race(4),,
8,0,0,0,0,0,0,0,0,0,1,2,3,0,1,2,3,34,35,0.0,M2019-05-26D,Race(4),,
9,0,10,10,20,1,10,13,24,0,7,9,16,1,27,32,60,17,17,0.0,M2019-05-26D,Race(4),,
10,0,0,0,0,0,0,0,0,0,0,0,0,0,0,0,0,81,81,0.0,M2019-05-26D,Race(4),,
11,0,5,8,13,0,5,4,9,1,7,4,12,1,17,16,34,7,7,1.0,M2019-05-26D,Race(4),,
12,0,9,5,14,0,2,4,6,0,4,2,6,0,15,11,26,9,9,3.0,M2019-05-26D,Race(4),,
1,15,0,7,22,17,6,5,28,10,9,3,22,42,15,15,72,4,4,1.0,M2019-05-26D,Race(5),,
2,3,6,9,18,7,9,6,22,5,1,5,11,15,16,20,51,4.4,4.4,2.0,M2019-05-26D,Race(5),,
3,0,0,0,0,0,0,0,0,0,0,0,0,0,0,0,0,51,51,0.0,M2019-05-26D,Race(5),,
4,0,5,3,8,0,1,2,3,2,1,2,5,2,7,7,16,10,10,0.0,M2019-05-26D,Race(5),,
5,2,5,4,11,1,0,0,1,1,1,1,3,4,6,5,15,16,16,0.0,M2019-05-26D,Race(5),,
6,0,0,0,0,0,0,0,0,0,0,0,0,0,0,0,0,126,126,0.0,M2019-05-26D,Race(5),,
7,5,12,7,24,4,10,14,28,5,10,5,20,14,32,26,72,3.2,3.2,0.0,M2019-05-26D,Race(5),,
8,5,2,0,7,1,1,3,5,0,4,8,12,6,7,11,24,8.5,8.5,3.0,M2019-05-26D,Race(5),,
9,0,0,0,0,0,0,0,0,0,0,0,0,0,0,0,0,31,31,0.0,M2019-05-26D,Race(5),,
10,0,0,0,0,0,0,0,0,0,0,0,0,0,0,0,0,26,26,0.0,M2019-05-26D,Race(5),,
11,0,0,0,0,0,0,0,0,0,0,0,0,0,0,0,0,61,61,0.0,M2019-05-26D,Race(5),,
12,0,0,0,0,0,2,0,2,2,0,1,3,2,2,1,5,21,21,0.0,M2019-05-26D,Race(5),,
13,0,0,0,0,0,1,0,1,1,0,1,2,1,1,1,3,31,31,0.0,M2019-05-26D,Race(5),,
14,0,0,0,0,0,0,0,0,0,0,0,0,0,0,0,0,81,81,0.0,M2019-05-26D,Race(5),,
1,10,15,2,27,15,8,3,26,9,9,4,22,34,32,9,75,3.9,4,1.0,M2019-05-26D,Race(6),,
2,4,5,9,18,4,14,6,24,6,7,6,19,14,26,21,61,4.6,4.6,3.0,M2019-05-26D,Race(6),,
3,0,0,0,0,0,0,1,1,0,0,0,0,0,0,1,1,18,18,0.0,M2019-05-26D,Race(6),,
4,0,2,10,12,0,0,3,3,0,0,7,7,0,2,20,22,10,10,0.0,M2019-05-26D,Race(6),,
5,0,2,3,5,0,2,5,7,0,0,6,6,0,4,14,18,12,12,0.0,M2019-05-26D,Race(6),,
6,0,0,0,0,0,0,0,0,0,0,0,0,0,0,0,0,0,0,0.0,M2019-05-26D,Race(6),,
7,16,6,4,26,10,6,12,28,11,10,3,24,37,22,19,78,1.95,1.95,0.0,M2019-05-26D,Race(6),,
8,0,0,2,2,0,0,0,0,0,0,0,0,0,0,2,2,31,27,2.0,M2019-05-26D,Race(6),,
9,0,0,0,0,1,0,0,1,0,0,0,0,1,0,0,1,51,51,0.0,M2019-05-26D,Race(6),,
10,0,0,0,0,0,0,0,0,0,0,0,0,0,0,0,0,91,91,0.0,M2019-05-26D,Race(6),,
1,6,11,5,22,17,4,5,26,12,2,3,17,35,17,13,65,3.2,3.2,0.0,M2019-05-26D,Race(7),,
2,15,3,5,23,5,19,4,28,7,13,3,23,27,35,12,74,4.8,4.8,2.0,M2019-05-26D,Race(7),,
3,3,3,2,8,1,0,3,4,1,0,2,3,5,3,7,15,8,8,0.0,M2019-05-26D,Race(7),,
4,0,0,0,0,0,0,0,0,0,1,0,1,0,1,0,1,31,31,0.0,M2019-05-26D,Race(7),,
5,2,0,0,2,0,2,2,4,0,1,2,3,2,3,4,9,18,18,0.0,M2019-05-26D,Race(7),,
6,0,0,0,0,0,0,0,0,0,0,0,0,0,0,0,0,151,151,0.0,M2019-05-26D,Race(7),,
7,0,0,0,0,0,0,0,0,1,0,1,2,1,0,1,2,26,26,0.0,M2019-05-26D,Race(7),,
8,0,0,0,0,0,0,0,0,0,0,0,0,0,0,0,0,15,15,3.0,M2019-05-26D,Race(7),,
9,0,8,8,16,3,3,10,16,3,6,8,17,6,17,26,49,4.2,4.2,1.0,M2019-05-26D,Race(7),,
10,0,0,0,0,0,0,0,0,0,0,0,0,0,0,0,0,34,35,0.0,M2019-05-26D,Race(7),,
11,4,5,10,19,4,2,6,12,2,3,7,12,10,10,23,43,6,6,0.0,M2019-05-26D,Race(7),,
1,25,3,2,30,24,4,2,30,18,7,1,26,67,14,5,86,1.65,1.75,1.0,M2019-05-26D,Race(8),,
2,0,10,4,14,0,2,6,8,2,1,8,11,2,13,18,33,7.5,7,0.0,M2019-05-26D,Race(8),,
3,0,0,0,0,0,0,0,0,0,0,0,0,0,0,0,0,51,51,0.0,M2019-05-26D,Race(8),,
4,2,5,18,25,6,20,3,29,6,14,1,21,14,39,22,75,5,5,0.0,M2019-05-26D,Race(8),,
5,0,7,6,13,0,3,12,15,0,1,6,7,0,11,24,35,10,10,0.0,M2019-05-26D,Race(8),,
6,3,5,0,8,0,0,4,4,0,3,7,10,3,8,11,22,15,15,3.0,M2019-05-26D,Race(8),,
7,0,0,0,0,0,1,3,4,0,0,3,3,0,1,6,7,11,10,0.0,M2019-05-26D,Race(8),,
8,0,0,0,0,0,0,0,0,0,0,0,0,0,0,0,0,23,21,2.0,M2019-05-26D,Race(8),,
9,0,0,0,0,0,0,0,0,0,0,0,0,0,0,0,0,101,101,0.0,M2019-05-26D,Race(8),,
1,0,0,3,3,0,1,1,2,0,0,2,2,0,1,6,7,15,15,0.0,M2019-05-26D,Race(9),,
2,0,0,0,0,0,1,0,1,1,1,0,2,1,2,0,3,26,26,0.0,M2019-05-26D,Race(9),,
3,2,0,8,10,10,5,5,20,5,2,3,10,17,7,16,40,7,7,3.0,M2019-05-26D,Race(9),,
4,3,4,0,7,0,0,2,2,0,0,3,3,3,4,5,12,15,15,0.0,M2019-05-26D,Race(9),,
5,8,8,2,18,3,10,2,15,3,9,3,15,14,27,7,48,5,5,0.0,M2019-05-26D,Race(9),,
6,0,0,0,0,0,0,0,0,0,0,0,0,0,0,0,0,41,41,0.0,M2019-05-26D,Race(9),,
7,0,0,3,3,0,3,0,3,0,2,3,5,0,5,6,11,21,21,0.0,M2019-05-26D,Race(9),,
8,3,6,2,11,2,1,1,4,2,0,2,4,7,7,5,19,9,9,0.0,M2019-05-26D,Race(9),,
9,0,0,0,0,0,1,1,2,0,1,1,2,0,2,2,4,51,51,0.0,M2019-05-26D,Race(9),,
10,4,0,6,10,10,1,13,24,10,5,4,19,24,6,23,53,8.5,8.5,0.0,M2019-05-26D,Race(9),,
11,0,4,0,4,2,2,0,4,1,2,0,3,3,8,0,11,21,21,2.0,M2019-05-26D,Race(9),,
12,7,5,4,16,2,4,5,11,3,3,5,11,12,12,14,38,3.7,3.7,1.0,M2019-05-26D,Race(9),,
13,3,3,2,8,1,1,0,2,1,1,0,2,5,5,2,12,9,9,0.0,M2019-05-26D,Race(9),,
14,0,0,0,0,0,0,0,0,0,0,0,0,0,0,0,0,81,81,0.0,M2019-05-26D,Race(9),,
1,7,2,3,12,3,6,15,24,6,6,6,18,16,14,24,54,7.5,7.5,0.0,M2019-05-29D,Race(1),,
2,0,0,5,5,0,1,4,5,2,0,5,7,2,1,14,17,17,17,0.0,M2019-05-29D,Race(1),,
3,8,5,5,18,5,12,4,21,3,2,6,11,16,19,15,50,4.6,4.6,1.0,M2019-05-29D,Race(1),,
4,0,5,0,5,0,1,1,2,0,1,1,2,0,7,2,9,9,9,0.0,M2019-05-29D,Race(1),,
5,2,3,2,7,0,3,3,6,0,5,2,7,2,11,7,20,9,9,0.0,M2019-05-29D,Race(1),,
6,0,0,0,0,0,1,0,1,0,1,0,1,0,2,0,2,41,41,0.0,M2019-05-29D,Race(1),,
7,0,0,0,0,0,1,0,1,0,2,0,2,0,3,0,3,26,26,0.0,M2019-05-29D,Race(1),,
8,0,0,0,0,0,0,0,0,0,0,0,0,0,0,0,0,11,11,0.0,M2019-05-29D,Race(1),,
9,6,9,10,25,19,5,3,27,12,7,4,23,37,21,17,75,2.8,2.8,2.0,M2019-05-29D,Race(1),,
10,2,0,0,2,3,0,0,3,3,1,1,5,8,1,1,10,17,17,0.0,M2019-05-29D,Race(1),,
11,0,0,0,0,0,0,0,0,0,1,1,2,0,1,1,2,34,34,3.0,M2019-05-29D,Race(1),,
12,5,0,0,5,0,0,0,0,0,0,0,0,5,0,0,5,21,21,0.0,M2019-05-29D,Race(1),,
1,5,9,2,16,3,1,2,6,2,2,1,5,10,12,5,27,6,6,0.0,M2019-05-29D,Race(2),,
2,0,0,0,0,0,0,0,0,0,0,0,0,0,0,0,0,34,34,0.0,M2019-05-29D,Race(2),,
3,15,6,9,30,19,5,1,25,18,4,0,22,52,15,10,77,2.8,2.8,1.0,M2019-05-29D,Race(2),,
4,0,0,3,3,2,0,2,4,1,3,3,7,3,3,8,14,17,17,0.0,M2019-05-29D,Race(2),,
5,0,0,0,0,0,1,1,2,0,4,1,5,0,5,2,7,21,21,0.0,M2019-05-29D,Race(2),,
6,5,7,8,20,4,6,14,24,1,4,8,13,10,17,30,57,7,7,0.0,M2019-05-29D,Race(2),,
7,0,0,0,0,0,0,0,0,0,0,0,0,0,0,0,0,16,16,3.0,M2019-05-29D,Race(2),,
8,0,2,3,5,0,3,2,5,0,4,4,8,0,9,9,18,8,8,0.0,M2019-05-29D,Race(2),,
9,0,0,0,0,0,0,0,0,0,0,0,0,0,0,0,0,41,41,0.0,M2019-05-29D,Race(2),,
10,0,0,0,0,2,11,2,15,4,2,2,8,6,13,4,23,7,7,2.0,M2019-05-29D,Race(2),,
11,0,0,0,0,0,0,0,0,0,0,0,0,0,0,0,0,51,51,0.0,M2019-05-29D,Race(2),,
12,2,3,2,7,0,0,3,3,0,0,4,4,2,3,9,14,10,10,0.0,M2019-05-29D,Race(2),,
1,0,6,3,9,3,4,3,10,2,2,3,7,5,12,9,26,16,16,0.0,M2019-05-29D,Race(3),,
2,3,6,3,12,1,2,4,7,1,4,4,9,5,12,11,28,13,13,0.0,M2019-05-29D,Race(3),,
3,18,0,5,23,19,6,4,29,11,5,4,20,48,11,13,72,4,4,1.0,M2019-05-29D,Race(3),,
4,2,3,0,5,2,0,2,4,2,0,4,6,6,3,6,15,10,10,0.0,M2019-05-29D,Race(3),,
5,0,0,3,3,0,1,0,1,2,1,0,3,2,2,3,7,14,14,0.0,M2019-05-29D,Race(3),,
6,0,3,2,5,1,12,4,17,1,3,2,6,2,18,8,28,7,7,2.0,M2019-05-29D,Race(3),,
7,0,4,2,6,1,0,0,1,1,0,1,2,2,4,3,9,19,19,0.0,M2019-05-29D,Race(3),,
8,5,0,0,5,1,0,1,2,2,1,2,5,8,1,3,12,7.5,7.5,3.0,M2019-05-29D,Race(3),,
9,2,0,10,12,2,4,9,15,4,7,3,14,8,11,22,41,9,9,0.0,M2019-05-29D,Race(3),,
10,0,8,0,8,0,1,2,3,0,3,3,6,0,12,5,17,4.6,4.6,0.0,M2019-05-29D,Race(3),,
11,0,0,2,2,0,0,1,1,0,0,0,0,0,0,3,3,17,17,0.0,M2019-05-29D,Race(3),,
1,0,5,7,12,1,14,7,22,0,7,7,14,1,26,21,48,11,11,0.0,M2019-05-29D,Race(4),,
2,2,3,8,13,0,4,13,17,2,7,4,13,4,14,25,43,9.5,9.5,0.0,M2019-05-29D,Race(4),,
3,0,0,0,0,0,0,2,2,2,0,1,3,2,0,3,5,19,19,3.0,M2019-05-29D,Race(4),,
4,28,2,0,30,27,2,1,30,21,5,0,26,76,9,1,86,1.6,1.6,1.0,M2019-05-29D,Race(4),,
5,0,14,10,24,0,4,2,6,0,2,2,4,0,20,14,34,7.5,7.5,0.0,M2019-05-29D,Race(4),,
6,0,2,2,4,1,0,0,1,1,0,2,3,2,2,4,8,16,16,0.0,M2019-05-29D,Race(4),,
7,0,4,3,7,1,5,5,11,0,5,8,13,1,14,16,31,11,11,2.0,M2019-05-29D,Race(4),,
8,0,0,0,0,0,1,0,1,0,0,0,0,0,1,0,1,41,41,0.0,M2019-05-29D,Race(4),,
9,0,0,0,0,0,0,0,0,0,0,0,0,0,0,0,0,26,26,0.0,M2019-05-29D,Race(4),,
10,0,0,0,0,0,0,0,0,0,0,0,0,0,0,0,0,31,31,0.0,M2019-05-29D,Race(4),,
11,0,0,0,0,0,0,0,0,0,0,1,1,0,0,1,1,101,101,0.0,M2019-05-29D,Race(4),,
12,0,0,0,0,0,0,0,0,0,0,1,1,0,0,1,1,101,101,0.0,M2019-05-29D,Race(4),,
1,0,0,0,0,1,0,0,1,0,0,0,0,1,0,0,1,21,21,0.0,M2019-05-29D,Race(5),,
2,7,0,0,7,1,3,6,10,0,2,4,6,8,5,10,23,15,15,0.0,M2019-05-29D,Race(5),,
3,7,4,12,23,15,4,2,21,9,3,2,14,31,11,16,58,3.7,3.7,1.0,M2019-05-29D,Race(5),,
4,0,3,0,3,0,1,0,1,0,3,0,3,0,7,0,7,12,12,0.0,M2019-05-29D,Race(5),,
5,3,2,0,5,0,1,1,2,2,1,2,5,5,4,3,12,11,11,0.0,M2019-05-29D,Race(5),,
6,6,5,4,15,5,15,4,24,6,6,3,15,17,26,11,54,5,5,3.0,M2019-05-29D,Race(5),,
7,0,0,0,0,0,0,1,1,1,1,0,2,1,1,1,3,12,12,0.0,M2019-05-29D,Race(5),,
8,4,10,2,16,5,0,3,8,5,1,7,13,14,11,12,37,10,10,0.0,M2019-05-29D,Race(5),,
9,0,3,5,8,1,2,9,12,2,4,3,9,3,9,17,29,10,10,0.0,M2019-05-29D,Race(5),,
10,0,0,0,0,1,1,2,4,0,1,1,2,1,2,3,6,13,13,2.0,M2019-05-29D,Race(5),,
11,0,3,0,3,0,0,1,1,0,2,0,2,0,5,1,6,17,17,0.0,M2019-05-29D,Race(5),,
12,3,0,7,10,1,3,1,5,1,2,4,7,5,5,12,22,10,10,0.0,M2019-05-29D,Race(5),,
1,0,0,0,0,0,0,0,0,1,0,0,1,1,0,0,1,26,26,0.0,M2019-05-29D,Race(6),,
2,0,0,0,0,0,0,0,0,0,0,0,0,0,0,0,0,81,81,0.0,M2019-05-29D,Race(6),,
3,6,6,10,22,1,3,1,5,4,0,6,10,11,9,17,37,5.5,5.5,0.0,M2019-05-29D,Race(6),,
4,10,7,0,17,16,7,5,28,13,10,1,24,39,24,6,69,4.4,4.5,2.0,M2019-05-29D,Race(6),,
5,0,6,12,18,0,13,9,22,2,4,9,15,2,23,30,55,5,5,3.0,M2019-05-29D,Race(6),,
6,0,0,0,0,1,0,0,1,0,0,0,0,1,0,0,1,71,71,0.0,M2019-05-29D,Race(6),,
7,0,0,0,0,0,0,1,1,0,0,1,1,0,0,2,2,34,35,0.0,M2019-05-29D,Race(6),,
8,9,11,5,25,10,6,13,29,6,10,4,20,25,27,22,74,3.5,3.5,0.0,M2019-05-29D,Race(6),,
9,0,0,0,0,1,0,0,1,0,0,0,0,1,0,0,1,17,17,1.0,M2019-05-29D,Race(6),,
10,5,0,0,5,1,1,1,3,0,2,5,7,6,3,6,15,6.5,6.5,0.0,M2019-05-29D,Race(6),,
11,0,0,3,3,0,0,0,0,0,0,0,0,0,0,3,3,12,12,0.0,M2019-05-29D,Race(6),,
1,6,8,0,14,2,11,3,16,3,2,4,9,11,21,7,39,6,6,3.0,M2019-05-29D,Race(7),,
2,0,3,0,3,0,0,0,0,0,0,0,0,0,3,0,3,41,41,0.0,M2019-05-29D,Race(7),,
3,2,0,0,2,0,0,1,1,0,0,0,0,2,0,1,3,41,41,0.0,M2019-05-29D,Race(7),,
4,0,0,2,2,0,0,11,11,1,2,3,6,1,2,16,19,17,17,0.0,M2019-05-29D,Race(7),,
5,0,4,0,4,1,5,1,7,2,6,3,11,3,15,4,22,8.5,8.5,0.0,M2019-05-29D,Race(7),,
6,0,0,2,2,0,2,0,2,1,2,1,4,1,4,3,8,34,34,0.0,M2019-05-29D,Race(7),,
7,0,0,3,3,1,2,1,4,1,1,2,4,2,3,6,11,12,12,0.0,M2019-05-29D,Race(7),,
8,0,8,2,10,0,3,3,6,0,2,2,4,0,13,7,20,10,10,0.0,M2019-05-29D,Race(7),,
9,0,2,8,10,1,3,1,5,1,4,0,5,2,9,9,20,16,16,0.0,M2019-05-29D,Race(7),,
10,22,0,5,27,24,2,3,29,17,1,2,20,63,3,10,76,2,2,1.0,M2019-05-29D,Race(7),,
11,0,0,2,2,1,0,2,3,0,1,3,4,1,1,7,9,26,26,0.0,M2019-05-29D,Race(7),,
12,0,5,6,11,0,2,4,6,0,5,6,11,0,12,16,28,14,14,2.0,M2019-05-29D,Race(7),,
1,0,0,2,2,1,0,0,1,0,0,2,2,1,0,4,5,10,10,0.0,M2019-05-29D,Race(8),,
2,0,2,6,8,5,8,5,18,8,10,3,21,13,20,14,47,5.5,5.5,1.0,M2019-05-29D,Race(8),,
3,2,0,5,7,1,2,8,11,2,0,2,4,5,2,15,22,15,15,3.0,M2019-05-29D,Race(8),,
4,8,11,2,21,6,14,8,28,6,8,6,20,20,33,16,69,4.2,4.2,0.0,M2019-05-29D,Race(8),,
5,0,0,0,0,0,0,1,1,0,0,1,1,0,0,2,2,41,41,0.0,M2019-05-29D,Race(8),,
6,13,10,2,25,16,6,7,29,10,7,4,21,39,23,13,75,3.8,3.8,0.0,M2019-05-29D,Race(8),,
7,0,0,0,0,0,0,0,0,0,1,4,5,0,1,4,5,21,21,0.0,M2019-05-29D,Race(8),,
8,0,0,0,0,0,0,0,0,0,0,0,0,0,0,0,0,81,81,0.0,M2019-05-29D,Race(8),,
9,2,3,5,10,0,0,1,1,0,0,4,4,2,3,10,15,16,16,0.0,M2019-05-29D,Race(8),,
10,5,2,6,13,1,0,0,1,0,0,0,0,6,2,6,14,4.6,4.6,2.0,M2019-05-29D,Race(8),,
11,0,0,0,0,0,0,0,0,0,0,0,0,0,0,0,0,51,51,0.0,M2019-05-29D,Race(8),,
12,0,2,2,4,0,0,0,0,0,0,0,0,0,2,2,4,23,23,0.0,M2019-05-29D,Race(8),,
1,0,0,2,2,0,1,2,3,0,0,3,3,0,1,7,8,15,15,0.0,M2019-06-02D,Race(1),,
2,0,5,5,10,1,3,10,14,2,2,3,7,3,10,18,31,15,14,2.0,M2019-06-02D,Race(1),,
3,3,10,10,23,0,2,3,5,2,2,2,6,5,14,15,34,7.5,7.5,0.0,M2019-06-02D,Race(1),,
4,0,0,0,0,0,0,0,0,2,3,1,6,2,3,1,6,41,41,0.0,M2019-06-02D,Race(1),,
5,0,0,2,2,0,0,0,0,0,1,0,1,0,1,2,3,71,67,0.0,M2019-06-02D,Race(1),,
6,22,8,0,30,26,3,1,30,14,8,2,24,62,19,3,84,1.8,1.8,1.0,M2019-06-02D,Race(1),,
7,3,5,3,11,3,18,4,25,4,8,2,14,10,31,9,50,5,5,0.0,M2019-06-02D,Race(1),,
8,0,0,5,5,0,2,6,8,1,0,8,9,1,2,19,22,15,15,0.0,M2019-06-02D,Race(1),,
9,0,2,0,2,0,1,0,1,0,2,1,3,0,5,1,6,15,15,3.0,M2019-06-02D,Race(1),,
10,0,0,3,3,0,0,4,4,0,0,4,4,0,0,11,11,15,15,0.0,M2019-06-02D,Race(1),,
11,2,0,0,2,0,0,0,0,1,0,0,1,3,0,0,3,81,81,0.0,M2019-06-02D,Race(1),,
1,0,0,0,0,0,0,1,1,0,0,0,0,0,0,1,1,31,31,0.0,M2019-06-02D,Race(10),,
2,0,0,0,0,0,1,4,5,1,3,4,8,1,4,8,13,14,14,0.0,M2019-06-02D,Race(10),,
3,0,0,0,0,0,0,0,0,0,0,1,1,0,0,1,1,151,201,0.0,M2019-06-02D,Race(10),,
4,0,0,0,0,0,0,0,0,0,0,0,0,0,0,0,0,101,101,0.0,M2019-06-02D,Race(10),,
5,5,2,2,9,1,0,0,1,1,0,0,1,7,2,2,11,12,12,2.0,M2019-06-02D,Race(10),,
6,0,0,0,0,1,1,0,2,1,0,0,1,2,1,0,3,16,16,0.0,M2019-06-02D,Race(10),,
7,14,5,2,21,23,2,3,28,17,5,2,24,54,12,7,73,2.6,2.6,0.0,M2019-06-02D,Race(10),,
8,0,5,0,5,0,1,1,2,0,2,3,5,0,8,4,12,15,15,0.0,M2019-06-02D,Race(10),,
9,9,11,8,28,3,19,3,25,3,12,4,19,15,42,15,72,3.7,3.7,0.0,M2019-06-02D,Race(10),,
10,0,0,0,0,0,0,0,0,0,0,0,0,0,0,0,0,81,81,0.0,M2019-06-02D,Race(10),,
11,2,5,10,17,1,5,17,23,2,4,8,14,5,14,35,54,8.5,8.5,3.0,M2019-06-02D,Race(10),,
12,0,0,5,5,0,1,0,1,0,0,1,1,0,1,6,7,16,16,0.0,M2019-06-02D,Race(10),,
13,0,0,0,0,0,0,0,0,0,0,0,0,0,0,0,0,41,41,1.0,M2019-06-02D,Race(10),,
14,0,2,3,5,1,0,1,2,1,0,3,4,2,2,7,11,13,13,0.0,M2019-06-02D,Race(10),,
1,3,2,0,5,0,0,2,2,0,0,2,2,3,2,4,9,16,17,2.0,M2019-06-02D,Race(11),,
2,0,0,0,0,0,0,0,0,1,0,0,1,1,0,0,1,21,23,0.0,M2019-06-02D,Race(11),,
3,2,10,4,16,5,14,5,24,11,7,2,20,18,31,11,60,5,5,0.0,M2019-06-02D,Race(11),,
4,0,2,5,7,0,0,0,0,0,1,1,2,0,3,6,9,8.5,7,0.0,M2019-06-02D,Race(11),,
5,12,3,2,17,18,9,3,30,12,8,3,23,42,20,8,70,3.7,3.8,3.0,M2019-06-02D,Race(11),,
6,0,0,2,2,0,0,4,4,0,0,5,5,0,0,11,11,19,20,0.0,M2019-06-02D,Race(11),,
7,3,8,8,19,5,1,10,16,1,5,5,11,9,14,23,46,7,7.5,1.0,M2019-06-02D,Race(11),,
8,6,0,6,12,0,2,1,3,0,2,4,6,6,4,11,21,7,8,0.0,M2019-06-02D,Race(11),,
9,0,0,0,0,0,0,0,0,0,0,0,0,0,0,0,0,41,41,0.0,M2019-06-02D,Race(11),,
10,0,2,3,5,1,1,0,2,0,1,1,2,1,4,4,9,21,18,0.0,M2019-06-02D,Race(11),,
11,2,0,0,2,0,0,0,0,0,0,0,0,2,0,0,2,26,27,0.0,M2019-06-02D,Race(11),,
12,0,0,0,0,0,0,0,0,0,0,0,0,0,0,0,0,91,71,0.0,M2019-06-02D,Race(11),,
13,0,0,0,0,0,0,0,0,0,0,0,0,0,0,0,0,51,46,0.0,M2019-06-02D,Race(11),,
14,2,3,0,5,1,3,5,9,1,2,3,6,4,8,8,20,8,8.5,0.0,M2019-06-02D,Race(11),,
1,5,10,8,23,18,4,5,27,14,4,3,21,37,18,16,71,4.2,4.2,0.0,M2019-06-02D,Race(2),,
2,6,5,10,21,4,15,6,25,5,8,6,19,15,28,22,65,6.5,6.5,3.0,M2019-06-02D,Race(2),,
3,0,7,4,11,0,3,0,3,0,2,2,4,0,12,6,18,7.5,7.5,0.0,M2019-06-02D,Race(2),,
4,19,3,5,27,6,5,15,26,3,4,7,14,28,12,27,67,1.95,1.95,1.0,M2019-06-02D,Race(2),,
5,0,0,0,0,0,0,0,0,0,1,0,1,0,1,0,1,126,126,0.0,M2019-06-02D,Race(2),,
6,0,0,0,0,0,0,0,0,0,0,1,1,0,0,1,1,31,31,0.0,M2019-06-02D,Race(2),,
7,0,0,0,0,0,0,0,0,0,0,1,1,0,0,1,1,81,81,0.0,M2019-06-02D,Race(2),,
8,0,0,0,0,0,0,0,0,0,0,0,0,0,0,0,0,81,81,0.0,M2019-06-02D,Race(2),,
9,0,0,0,0,0,0,0,0,0,0,0,0,0,0,0,0,151,151,0.0,M2019-06-02D,Race(2),,
10,0,3,0,3,2,2,4,8,4,7,5,16,6,12,9,27,11,11,2.0,M2019-06-02D,Race(2),,
11,0,2,0,2,0,1,0,1,0,0,1,1,0,3,1,4,26,26,0.0,M2019-06-02D,Race(2),,
12,0,0,3,3,0,0,0,0,0,0,0,0,0,0,3,3,51,51,0.0,M2019-06-02D,Race(2),,
13,0,0,0,0,0,0,0,0,0,0,0,0,0,0,0,0,151,201,0.0,M2019-06-02D,Race(2),,
14,0,0,0,0,0,0,0,0,0,0,0,0,0,0,0,0,81,81,0.0,M2019-06-02D,Race(2),,
1,10,13,5,28,21,4,3,28,15,3,2,20,46,20,10,76,1.95,2.3,1.0,M2019-06-02D,Race(3),,
2,3,2,4,9,3,2,3,8,3,4,2,9,9,8,9,26,7.5,7.5,0.0,M2019-06-02D,Race(3),,
3,0,5,11,16,1,6,15,22,2,10,6,18,3,21,32,56,6.5,6,0.0,M2019-06-02D,Race(3),,
4,13,5,5,23,5,15,6,26,5,5,8,18,23,25,19,67,5,4.8,3.0,M2019-06-02D,Race(3),,
5,4,2,5,11,0,2,1,3,1,3,1,5,5,7,7,19,9,9,0.0,M2019-06-02D,Race(3),,
6,0,0,0,0,0,0,0,0,0,0,0,0,0,0,0,0,151,201,0.0,M2019-06-02D,Race(3),,
7,0,0,0,0,0,0,0,0,0,0,0,0,0,0,0,0,151,201,0.0,M2019-06-02D,Race(3),,
8,0,0,0,0,0,0,0,0,0,0,1,1,0,0,1,1,151,201,0.0,M2019-06-02D,Race(3),,
9,0,0,0,0,0,0,0,0,0,0,1,1,0,0,1,1,71,101,0.0,M2019-06-02D,Race(3),,
10,0,0,0,0,0,0,0,0,0,0,0,0,0,0,0,0,41,41,0.0,M2019-06-02D,Race(3),,
11,0,0,0,0,0,0,0,0,0,0,0,0,0,0,0,0,34,31,0.0,M2019-06-02D,Race(3),,
12,0,3,0,3,0,1,0,1,0,1,2,3,0,5,2,7,12,12,2.0,M2019-06-02D,Race(3),,
13,0,0,0,0,0,0,2,2,0,0,3,3,0,0,5,5,41,41,0.0,M2019-06-02D,Race(3),,
14,0,0,0,0,0,0,0,0,0,0,0,0,0,0,0,0,34,31,0.0,M2019-06-02D,Race(3),,
1,3,10,5,18,5,14,3,22,5,6,2,13,13,30,10,53,5,5,0.0,M2019-06-02D,Race(4),,
2,0,2,3,5,0,0,1,1,0,0,1,1,0,2,5,7,16,16,0.0,M2019-06-02D,Race(4),,
3,4,0,0,4,1,5,4,10,1,4,7,12,6,9,11,26,9,9,2.0,M2019-06-02D,Race(4),,
4,0,2,0,2,2,2,1,5,2,0,3,5,4,4,4,12,16,16,0.0,M2019-06-02D,Race(4),,
5,0,0,0,0,0,0,0,0,0,0,1,1,0,0,1,1,61,61,0.0,M2019-06-02D,Race(4),,
6,0,0,0,0,0,0,0,0,0,0,0,0,0,0,0,0,151,151,0.0,M2019-06-02D,Race(4),,
7,3,5,3,11,1,2,12,15,2,3,5,10,6,10,20,36,8,8,1.0,M2019-06-02D,Race(4),,
8,18,5,7,30,21,4,3,28,14,8,1,23,53,17,11,81,1.8,1.8,3.0,M2019-06-02D,Race(4),,
9,2,6,12,20,0,3,6,9,2,5,6,13,4,14,24,42,8,8,0.0,M2019-06-02D,Race(4),,
10,0,0,0,0,0,0,0,0,0,0,0,0,0,0,0,0,81,81,0.0,M2019-06-02D,Race(4),,
1,2,10,13,25,3,4,15,22,4,8,5,17,9,22,33,64,4,4,2.0,M2019-06-02D,Race(5),,
2,0,0,3,3,0,2,1,3,0,2,4,6,0,4,8,12,18,18,0.0,M2019-06-02D,Race(5),,
3,19,5,4,28,5,17,1,23,6,5,3,14,30,27,8,65,3,3,0.0,M2019-06-02D,Race(5),,
4,0,0,0,0,0,1,0,1,1,2,0,3,1,3,0,4,19,19,0.0,M2019-06-02D,Race(5),,
5,0,0,0,0,0,0,0,0,0,0,0,0,0,0,0,0,26,26,1.0,M2019-06-02D,Race(5),,
6,0,0,2,2,0,0,1,1,0,0,1,1,0,0,4,4,51,51,0.0,M2019-06-02D,Race(5),,
7,2,4,0,6,4,0,0,4,4,1,1,6,10,5,1,16,12,12,0.0,M2019-06-02D,Race(5),,
8,0,0,0,0,0,0,0,0,0,0,0,0,0,0,0,0,34,34,0.0,M2019-06-02D,Race(5),,
9,2,0,3,5,4,1,6,11,2,1,8,11,8,2,17,27,17,17,0.0,M2019-06-02D,Race(5),,
10,5,11,5,21,14,2,5,21,8,4,3,15,27,17,13,57,3.5,3.5,3.0,M2019-06-02D,Race(5),,
11,0,0,0,0,0,0,0,0,0,0,0,0,0,0,0,0,101,101,0.0,M2019-06-02D,Race(5),,
12,0,0,0,0,0,0,0,0,0,0,0,0,0,0,0,0,51,51,0.0,M2019-06-02D,Race(5),,
13,0,0,0,0,0,0,0,0,0,0,0,0,0,0,0,0,41,41,0.0,M2019-06-02D,Race(5),,
14,0,0,0,0,0,0,0,0,0,0,0,0,0,0,0,0,51,51,0.0,M2019-06-02D,Race(5),,
1,13,12,5,30,23,5,2,30,20,4,1,25,56,21,8,85,1.85,1.85,0.0,M2019-06-02D,Race(6),,
2,4,0,4,8,1,1,1,3,1,0,4,5,6,1,9,16,10,10,0.0,M2019-06-02D,Race(6),,
3,8,6,8,22,2,17,7,26,3,13,3,19,13,36,18,67,7,7,0.0,M2019-06-02D,Race(6),,
4,0,0,0,0,0,0,0,0,0,0,0,0,0,0,0,0,101,101,0.0,M2019-06-02D,Race(6),,
5,0,0,3,3,0,0,2,2,1,0,2,3,1,0,7,8,19,19,0.0,M2019-06-02D,Race(6),,
6,5,10,8,23,4,6,18,28,1,8,13,22,10,24,39,73,4.8,4.8,3.0,M2019-06-02D,Race(6),,
7,0,0,0,0,0,0,0,0,0,0,0,0,0,0,0,0,26,26,0.0,M2019-06-02D,Race(6),,
8,0,0,0,0,0,0,0,0,0,1,1,2,0,1,1,2,41,41,0.0,M2019-06-02D,Race(6),,
9,0,0,0,0,0,0,0,0,0,0,0,0,0,0,0,0,81,81,0.0,M2019-06-02D,Race(6),,
10,0,0,0,0,0,1,0,1,0,0,0,0,0,1,0,1,41,41,0.0,M2019-06-02D,Race(6),,
11,0,0,0,0,0,0,0,0,0,0,0,0,0,0,0,0,151,201,0.0,M2019-06-02D,Race(6),,
12,0,2,0,2,0,0,0,0,0,0,2,2,0,2,2,4,34,34,2.0,M2019-06-02D,Race(6),,
13,0,0,2,2,0,0,0,0,0,0,0,0,0,0,2,2,13,17,1.0,M2019-06-02D,Race(6),,
14,0,0,0,0,0,0,0,0,0,0,0,0,0,0,0,0,34,34,0.0,M2019-06-02D,Race(6),,
1,2,19,9,30,2,22,4,28,2,17,4,23,6,58,17,81,6,6,2.0,M2019-06-02D,Race(7),,
2,28,0,2,30,27,3,0,30,22,4,0,26,77,7,2,86,1.6,1.6,1.0,M2019-06-02D,Race(7),,
3,0,0,0,0,0,0,0,0,0,0,0,0,0,0,0,0,126,126,0.0,M2019-06-02D,Race(7),,
4,0,3,9,12,0,2,4,6,0,1,2,3,0,6,15,21,9,9,0.0,M2019-06-02D,Race(7),,
5,0,3,0,3,0,2,14,16,0,2,6,8,0,7,20,27,21,21,0.0,M2019-06-02D,Race(7),,
6,0,0,0,0,0,0,0,0,0,0,0,0,0,0,0,0,151,151,0.0,M2019-06-02D,Race(7),,
7,0,0,0,0,0,0,0,0,0,0,0,0,0,0,0,0,81,81,0.0,M2019-06-02D,Race(7),,
8,0,3,5,8,1,0,4,5,1,1,5,7,2,4,14,20,10,10,0.0,M2019-06-02D,Race(7),,
9,0,0,0,0,0,0,0,0,0,0,2,2,0,0,2,2,51,51,0.0,M2019-06-02D,Race(7),,
10,0,0,3,3,0,0,0,0,0,0,1,1,0,0,4,4,17,17,3.0,M2019-06-02D,Race(7),,
11,0,0,0,0,0,1,1,2,1,0,2,3,1,1,3,5,26,26,0.0,M2019-06-02D,Race(7),,
12,0,0,0,0,0,0,2,2,0,0,2,2,0,0,4,4,0,0,0.0,M2019-06-02D,Race(7),,
13,0,0,2,2,0,0,1,1,0,1,2,3,0,1,5,6,15,15,0.0,M2019-06-02D,Race(7),,
14,0,2,0,2,0,0,0,0,0,0,0,0,0,2,0,2,51,51,0.0,M2019-06-02D,Race(7),,
1,0,2,0,2,0,0,0,0,0,0,0,0,0,2,0,2,41,41,0.0,M2019-06-02D,Race(8),,
2,0,0,0,0,0,1,0,1,2,1,0,3,2,2,0,4,15,15,2.0,M2019-06-02D,Race(8),,
3,0,7,6,13,2,14,5,21,2,5,1,8,4,26,12,42,8,8,3.0,M2019-06-02D,Race(8),,
4,0,0,0,0,0,0,0,0,1,0,0,1,1,0,0,1,151,201,0.0,M2019-06-02D,Race(8),,
5,0,0,0,0,0,0,2,2,0,0,2,2,0,0,4,4,41,41,0.0,M2019-06-02D,Race(8),,
6,0,0,0,0,0,0,0,0,0,1,0,1,0,1,0,1,126,126,0.0,M2019-06-02D,Race(8),,
7,21,4,5,30,23,3,3,29,16,3,3,22,60,10,11,81,2.1,2.1,1.0,M2019-06-02D,Race(8),,
8,7,9,0,16,5,4,11,20,5,9,5,19,17,22,16,55,5,5,0.0,M2019-06-02D,Race(8),,
9,0,0,0,0,0,0,0,0,0,0,1,1,0,0,1,1,31,31,0.0,M2019-06-02D,Race(8),,
10,0,2,3,5,0,0,2,2,0,0,3,3,0,2,8,10,21,21,0.0,M2019-06-02D,Race(8),,
11,0,0,8,8,0,5,3,8,0,5,4,9,0,10,15,25,13,13,0.0,M2019-06-02D,Race(8),,
12,2,6,8,16,0,2,3,5,0,1,3,4,2,9,14,25,6,6,0.0,M2019-06-02D,Race(8),,
13,0,0,0,0,0,1,1,2,0,1,4,5,0,2,5,7,41,41,0.0,M2019-06-02D,Race(8),,
1,5,8,9,22,6,3,4,13,7,5,1,13,18,16,14,48,5,5,0.0,M2019-06-02D,Race(9),,
2,0,2,2,4,0,0,0,0,2,1,2,5,2,3,4,9,15,15,0.0,M2019-06-02D,Race(9),,
3,0,0,0,0,1,1,0,2,0,0,0,0,1,1,0,2,21,21,0.0,M2019-06-02D,Race(9),,
4,0,0,0,0,0,0,0,0,0,0,0,0,0,0,0,0,0,0,0.0,M2019-06-02D,Race(9),,
5,5,2,14,21,2,13,5,20,3,6,5,14,10,21,24,55,7.5,7.5,0.0,M2019-06-02D,Race(9),,
6,0,0,0,0,0,0,0,0,0,0,0,0,0,0,0,0,31,31,3.0,M2019-06-02D,Race(9),,
7,6,7,2,15,2,4,15,21,2,5,9,16,10,16,26,52,4.8,4.8,2.0,M2019-06-02D,Race(9),,
8,0,0,3,3,0,3,1,4,0,2,5,7,0,5,9,14,13,13,0.0,M2019-06-02D,Race(9),,
9,14,8,0,22,19,4,5,28,12,4,4,20,45,16,9,70,2.3,2.3,1.0,M2019-06-02D,Race(9),,
10,0,3,0,3,0,2,0,2,0,2,0,2,0,7,0,7,13,13,0.0,M2019-06-02D,Race(9),,
1,0,10,5,15,3,9,16,28,5,9,8,22,8,28,29,65,9.5,9.5,0.0,M2019-06-05D,Race(1),,
2,0,0,0,0,0,0,0,0,0,1,2,3,0,1,2,3,26,26,0.0,M2019-06-05D,Race(1),,
3,0,0,0,0,0,0,0,0,0,0,0,0,0,0,0,0,61,61,0.0,M2019-06-05D,Race(1),,
4,2,7,0,9,1,3,3,7,0,2,2,4,3,12,5,20,10,10,0.0,M2019-06-05D,Race(1),,
5,20,5,5,30,22,3,4,29,17,5,3,25,59,13,12,84,1.6,1.6,2.0,M2019-06-05D,Race(1),,
6,0,3,2,5,0,1,0,1,0,0,1,1,0,4,3,7,0,0,0.0,M2019-06-05D,Race(1),,
7,0,5,8,13,4,2,4,10,4,1,6,11,8,8,18,34,6.5,7,3.0,M2019-06-05D,Race(1),,
8,8,0,10,18,0,12,3,15,0,8,4,12,8,20,17,45,5,5,1.0,M2019-06-05D,Race(1),,
1,4,5,3,12,3,4,2,9,6,5,2,13,13,14,7,34,10,10,2.0,M2019-06-05D,Race(2),,
2,0,0,2,2,0,0,1,1,0,0,2,2,0,0,5,5,31,31,0.0,M2019-06-05D,Race(2),,
3,6,4,10,20,4,3,2,9,6,3,2,11,16,10,14,40,3.6,3.6,0.0,M2019-06-05D,Race(2),,
4,7,9,5,21,2,13,5,20,1,1,6,8,10,23,16,49,4.8,4.8,1.0,M2019-06-05D,Race(2),,
5,9,6,4,19,17,5,4,26,9,9,4,22,35,20,12,67,4.2,4.2,0.0,M2019-06-05D,Race(2),,
6,0,4,3,7,3,3,12,18,4,6,4,14,7,13,19,39,10,10,0.0,M2019-06-05D,Race(2),,
7,0,0,0,0,0,0,1,1,0,1,1,2,0,1,2,3,31,31,0.0,M2019-06-05D,Race(2),,
8,0,0,0,0,0,0,1,1,0,0,2,2,0,0,3,3,21,21,0.0,M2019-06-05D,Race(2),,
9,2,0,0,2,0,0,0,0,0,0,0,0,2,0,0,2,31,31,0.0,M2019-06-05D,Race(2),,
10,0,0,0,0,0,0,0,0,0,0,0,0,0,0,0,0,41,41,0.0,M2019-06-05D,Race(2),,
11,0,0,3,3,1,0,1,2,0,0,2,2,1,0,6,7,11,11,0.0,M2019-06-05D,Race(2),,
12,2,2,0,4,0,2,1,3,0,1,1,2,2,5,2,9,11,11,3.0,M2019-06-05D,Race(2),,
1,0,2,2,4,1,1,0,2,0,0,1,1,1,3,3,7,21,21,0.0,M2019-06-05D,Race(3),,
2,8,6,6,20,3,5,19,27,5,6,12,23,16,17,37,70,5.5,5.5,0.0,M2019-06-05D,Race(3),,
3,0,2,3,5,0,0,2,2,0,0,2,2,0,2,7,9,12,12,0.0,M2019-06-05D,Race(3),,
4,20,8,0,28,6,17,4,27,7,11,2,20,33,36,6,75,2.4,2.4,1.0,M2019-06-05D,Race(3),,
5,0,3,0,3,0,0,0,0,0,0,3,3,0,3,3,6,26,26,0.0,M2019-06-05D,Race(3),,
6,0,7,19,26,20,6,2,28,14,9,2,25,34,22,23,79,4.6,4.6,3.0,M2019-06-05D,Race(3),,
7,0,0,0,0,0,0,0,0,0,0,0,0,0,0,0,0,51,51,0.0,M2019-06-05D,Race(3),,
8,0,0,0,0,0,0,1,1,0,0,0,0,0,0,1,1,18,18,0.0,M2019-06-05D,Race(3),,
9,2,0,0,2,0,1,0,1,0,0,0,0,2,1,0,3,13,13,0.0,M2019-06-05D,Race(3),,
10,0,0,0,0,0,0,1,1,0,0,2,2,0,0,3,3,51,51,0.0,M2019-06-05D,Race(3),,
11,0,0,0,0,0,0,0,0,0,0,1,1,0,0,1,1,21,21,2.0,M2019-06-05D,Race(3),,
12,0,2,0,2,0,0,1,1,0,0,1,1,0,2,2,4,14,14,0.0,M2019-06-05D,Race(3),,
1,0,5,11,16,2,2,0,4,0,2,1,3,2,9,12,23,9.5,9.5,3.0,M2019-06-05D,Race(4),,
2,7,2,8,17,12,4,4,20,7,3,5,15,26,9,17,52,9.5,9.5,2.0,M2019-06-05D,Race(4),,
3,0,0,0,0,0,0,0,0,0,0,0,0,0,0,0,0,8,8,0.0,M2019-06-05D,Race(4),,
4,12,9,3,24,5,3,1,9,5,5,5,15,22,17,9,48,3.6,3.6,0.0,M2019-06-05D,Race(4),,
5,11,12,0,23,2,6,12,20,3,5,6,14,16,23,18,57,3.2,3.2,1.0,M2019-06-05D,Race(4),,
6,0,0,0,0,1,0,0,1,1,0,0,1,2,0,0,2,26,26,0.0,M2019-06-05D,Race(4),,
7,0,2,2,4,0,1,2,3,0,1,1,2,0,4,5,9,7.5,7.5,0.0,M2019-06-05D,Race(4),,
8,0,0,0,0,0,0,0,0,0,0,0,0,0,0,0,0,26,26,0.0,M2019-06-05D,Race(4),,
9,0,0,0,0,0,0,0,0,0,0,0,0,0,0,0,0,81,81,0.0,M2019-06-05D,Race(4),,
10,0,0,0,0,3,0,4,7,4,3,3,10,7,3,7,17,13,13,0.0,M2019-06-05D,Race(4),,
11,0,0,0,0,0,0,0,0,0,0,0,0,0,0,0,0,81,81,0.0,M2019-06-05D,Race(4),,
12,0,0,4,4,0,0,0,0,0,0,1,1,0,0,5,5,26,26,0.0,M2019-06-05D,Race(4),,
1,6,12,7,25,4,12,5,21,4,5,4,13,14,29,16,59,4.6,4.5,3.0,M2019-06-05D,Race(5),,
2,0,0,3,3,0,2,1,3,0,2,1,3,0,4,5,9,15,15,0.0,M2019-06-05D,Race(5),,
3,0,0,7,7,1,0,2,3,1,1,2,4,2,1,11,14,11,11,0.0,M2019-06-05D,Race(5),,
4,5,5,5,15,6,7,11,24,7,9,3,19,18,21,19,58,6,6,0.0,M2019-06-05D,Race(5),,
5,0,3,2,5,11,2,4,17,5,0,1,6,16,5,7,28,7,7,0.0,M2019-06-05D,Race(5),,
6,0,0,0,0,0,0,0,0,2,0,1,3,2,0,1,3,19,19,1.0,M2019-06-05D,Race(5),,
7,2,0,0,2,0,0,0,0,0,0,2,2,2,0,2,4,11,11,0.0,M2019-06-05D,Race(5),,
8,0,0,3,3,0,0,1,1,0,1,1,2,0,1,5,6,13,13,0.0,M2019-06-05D,Race(5),,
9,0,0,3,3,0,0,0,0,0,0,1,1,0,0,4,4,51,51,0.0,M2019-06-05D,Race(5),,
10,5,0,0,5,5,1,2,8,2,1,3,6,12,2,5,19,8,8,2.0,M2019-06-05D,Race(5),,
11,12,10,0,22,3,6,4,13,5,7,7,19,20,23,11,54,4.8,4.8,0.0,M2019-06-05D,Race(5),,
12,0,0,0,0,0,0,0,0,0,0,0,0,0,0,0,0,71,67,0.0,M2019-06-05D,Race(5),,
1,7,10,4,21,2,2,13,17,5,3,3,11,14,15,20,49,6.5,6.5,1.0,M2019-06-05D,Race(6),,
2,0,0,0,0,0,0,1,1,0,0,1,1,0,0,2,2,26,26,0.0,M2019-06-05D,Race(6),,
3,2,3,3,8,0,1,2,3,0,1,0,1,2,5,5,12,12,12,0.0,M2019-06-05D,Race(6),,
4,3,9,16,28,7,16,4,27,6,14,2,22,16,39,22,77,3.3,3.3,0.0,M2019-06-05D,Race(6),,
5,0,0,2,2,0,0,0,0,0,0,1,1,0,0,3,3,13,13,0.0,M2019-06-05D,Race(6),,
6,0,0,0,0,0,0,0,0,0,0,1,1,0,0,1,1,41,41,0.0,M2019-06-05D,Race(6),,
7,0,0,0,0,0,1,6,7,1,3,6,10,1,4,12,17,15,15,0.0,M2019-06-05D,Race(6),,
8,0,0,0,0,0,0,0,0,0,0,0,0,0,0,0,0,41,41,0.0,M2019-06-05D,Race(6),,
9,18,5,2,25,21,6,1,28,14,2,6,22,53,13,9,75,3.3,3.3,0.0,M2019-06-05D,Race(6),,
10,0,0,0,0,0,0,0,0,0,0,0,0,0,0,0,0,81,81,0.0,M2019-06-05D,Race(6),,
11,0,3,3,6,0,3,2,5,0,2,6,8,0,8,11,19,7.5,7.5,2.0,M2019-06-05D,Race(6),,
12,0,0,0,0,0,1,1,2,0,1,0,1,0,2,1,3,17,17,3.0,M2019-06-05D,Race(6),,
1,0,0,0,0,0,0,0,0,0,0,0,0,0,0,0,0,81,81,0.0,M2019-06-05D,Race(7),,
2,0,5,2,7,0,1,3,4,1,0,5,6,1,6,10,17,17,17,3.0,M2019-06-05D,Race(7),,
3,0,6,2,8,0,1,0,1,0,0,0,0,0,7,2,9,16,16,0.0,M2019-06-05D,Race(7),,
4,7,6,8,21,17,6,1,24,8,7,3,18,32,19,12,63,3,3,0.0,M2019-06-05D,Race(7),,
5,8,5,8,21,1,2,12,15,3,4,5,12,12,11,25,48,3.8,3.8,0.0,M2019-06-05D,Race(7),,
6,0,2,0,2,0,1,1,2,0,2,1,3,0,5,2,7,12,12,0.0,M2019-06-05D,Race(7),,
7,5,4,8,17,5,13,6,24,5,7,7,19,15,24,21,60,6,6,1.0,M2019-06-05D,Race(7),,
8,0,0,2,2,0,0,0,0,0,1,0,1,0,1,2,3,21,21,0.0,M2019-06-05D,Race(7),,
9,0,2,0,2,0,1,2,3,0,0,2,2,0,3,4,7,19,19,0.0,M2019-06-05D,Race(7),,
10,0,0,0,0,0,0,0,0,0,0,0,0,0,0,0,0,31,31,0.0,M2019-06-05D,Race(7),,
11,10,0,0,10,6,5,4,15,8,5,3,16,24,10,7,41,7,7,2.0,M2019-06-05D,Race(7),,
12,0,0,0,0,0,0,0,0,0,0,0,0,0,0,0,0,51,51,0.0,M2019-06-05D,Race(7),,
1,0,2,0,2,0,3,2,5,1,4,5,10,1,9,7,17,13,13,1.0,M2019-06-05D,Race(8),,
2,0,3,3,6,1,4,2,7,2,1,4,7,3,8,9,20,13,13,0.0,M2019-06-05D,Race(8),,
3,9,0,2,11,0,1,2,3,3,1,4,8,12,2,8,22,9,9,0.0,M2019-06-05D,Race(8),,
4,0,7,0,7,3,2,10,15,4,2,1,7,7,11,11,29,16,16,0.0,M2019-06-05D,Race(8),,
5,0,0,0,0,0,1,0,1,0,1,0,1,0,2,0,2,14,14,3.0,M2019-06-05D,Race(8),,
6,19,6,3,28,14,3,4,21,5,4,2,11,38,13,9,60,3.6,3.6,2.0,M2019-06-05D,Race(8),,
7,0,2,7,9,5,2,4,11,2,4,3,9,7,8,14,29,7,7,0.0,M2019-06-05D,Race(8),,
8,0,0,0,0,0,0,0,0,0,0,0,0,0,0,0,0,101,101,0.0,M2019-06-05D,Race(8),,
9,0,2,2,4,4,10,3,17,5,4,4,13,9,16,9,34,8,8,0.0,M2019-06-05D,Race(8),,
10,0,0,0,0,0,0,0,0,0,0,0,0,0,0,0,0,21,21,0.0,M2019-06-05D,Race(8),,
11,0,6,0,6,0,2,0,2,0,3,2,5,0,11,2,13,11,11,0.0,M2019-06-05D,Race(8),,
12,2,2,13,17,3,2,3,8,4,2,1,7,9,6,17,32,5.5,5.5,0.0,M2019-06-05D,Race(8),,
1,0,2,7,9,2,1,0,3,1,1,3,5,3,4,10,17,7.5,8,0.0,M2019-06-08D,Race(1),,
2,25,2,0,27,19,6,4,29,15,5,3,23,59,13,7,79,2.05,2.05,0.0,M2019-06-08D,Race(1),,
3,0,16,5,21,2,16,6,24,2,9,4,15,4,41,15,60,5,5,0.0,M2019-06-08D,Race(1),,
4,0,2,5,7,1,1,1,3,1,1,1,3,2,4,7,13,14,14,3.0,M2019-06-08D,Race(1),,
5,0,0,0,0,0,0,0,0,1,2,0,3,1,2,0,3,51,51,0.0,M2019-06-08D,Race(1),,
6,0,0,0,0,0,0,0,0,0,0,0,0,0,0,0,0,126,126,0.0,M2019-06-08D,Race(1),,
7,0,0,0,0,0,0,0,0,0,0,1,1,0,0,1,1,101,101,0.0,M2019-06-08D,Race(1),,
8,5,3,8,16,1,1,5,7,2,4,7,13,8,8,20,36,6.5,6.5,0.0,M2019-06-08D,Race(1),,
9,0,0,0,0,1,0,0,1,0,0,0,0,1,0,0,1,151,151,0.0,M2019-06-08D,Race(1),,
10,0,5,0,5,4,4,13,21,4,4,6,14,8,13,19,40,8.5,8.5,1.0,M2019-06-08D,Race(1),,
11,0,0,2,2,0,1,1,2,0,0,1,1,0,1,4,5,19,19,2.0,M2019-06-08D,Race(1),,
12,0,0,3,3,0,0,0,0,0,0,0,0,0,0,3,3,41,41,0.0,M2019-06-08D,Race(1),,
1,0,0,0,0,0,1,0,1,0,0,0,0,0,1,0,1,41,41,0.0,M2019-06-08D,Race(10),,
2,0,0,0,0,1,1,1,3,0,0,1,1,1,1,2,4,17,17,3.0,M2019-06-08D,Race(10),,
3,4,5,9,18,1,3,14,18,5,0,7,12,10,8,30,48,3.2,3.2,0.0,M2019-06-08D,Race(10),,
4,4,6,5,15,4,3,1,8,1,1,3,5,9,10,9,28,5.5,5.5,0.0,M2019-06-08D,Race(10),,
5,0,0,0,0,0,0,0,0,0,0,0,0,0,0,0,0,41,41,0.0,M2019-06-08D,Race(10),,
6,0,0,0,0,0,0,0,0,0,2,0,2,0,2,0,2,51,51,0.0,M2019-06-08D,Race(10),,
7,0,0,0,0,0,0,0,0,0,1,0,1,0,1,0,1,126,126,0.0,M2019-06-08D,Race(10),,
8,19,7,2,28,20,5,4,29,13,11,2,26,52,23,8,83,2.5,2.5,1.0,M2019-06-08D,Race(10),,
9,3,9,5,17,3,16,5,24,5,10,5,20,11,35,15,61,9,9,2.0,M2019-06-08D,Race(10),,
10,0,0,0,0,0,0,0,0,0,0,0,0,0,0,0,0,51,51,0.0,M2019-06-08D,Race(10),,
11,0,0,0,0,0,0,0,0,0,0,0,0,0,0,0,0,61,61,0.0,M2019-06-08D,Race(10),,
12,0,3,9,12,1,1,5,7,2,1,8,11,3,5,22,30,10,10,0.0,M2019-06-08D,Race(10),,
1,8,0,7,15,14,5,5,24,5,4,4,13,27,9,16,52,4.6,4.6,1.0,M2019-06-08D,Race(2),,
2,2,0,0,2,0,0,0,0,2,0,0,2,4,0,0,4,41,41,0.0,M2019-06-08D,Race(2),,
3,2,0,0,2,2,1,0,3,2,1,2,5,6,2,2,10,21,21,3.0,M2019-06-08D,Race(2),,
4,0,0,0,0,0,0,0,0,2,0,0,2,2,0,0,2,26,26,0.0,M2019-06-08D,Race(2),,
5,5,11,8,24,6,12,5,23,0,5,6,11,11,28,19,58,5,5,0.0,M2019-06-08D,Race(2),,
6,0,0,0,0,0,0,0,0,0,0,0,0,0,0,0,0,41,41,0.0,M2019-06-08D,Race(2),,
7,2,2,3,7,0,0,0,0,0,0,0,0,2,2,3,7,18,18,0.0,M2019-06-08D,Race(2),,
8,0,8,5,13,2,1,4,7,5,6,4,15,7,15,13,35,4.8,4.8,2.0,M2019-06-08D,Race(2),,
9,0,0,0,0,0,0,1,1,0,1,1,2,0,1,2,3,26,26,0.0,M2019-06-08D,Race(2),,
10,0,4,0,4,1,0,3,4,2,0,4,6,3,4,7,14,7.5,7.5,0.0,M2019-06-08D,Race(2),,
11,2,2,5,9,2,5,1,8,2,3,1,6,6,10,7,23,14,14,0.0,M2019-06-08D,Race(2),,
12,9,3,2,14,3,6,11,20,6,6,4,16,18,15,17,50,4.6,4.6,0.0,M2019-06-08D,Race(2),,
1,2,18,5,25,3,23,2,28,1,22,2,25,6,63,9,78,6.5,6.5,2.0,M2019-06-08D,Race(3),,
2,25,3,0,28,25,3,2,30,24,2,0,26,74,8,2,84,1.2,1.2,1.0,M2019-06-08D,Race(3),,
3,3,5,11,19,2,2,19,23,1,1,18,20,6,8,48,62,9,9,0.0,M2019-06-08D,Race(3),,
4,0,2,7,9,0,1,3,4,0,0,5,5,0,3,15,18,26,26,0.0,M2019-06-08D,Race(3),,
5,0,2,0,2,0,0,1,1,0,0,1,1,0,2,2,4,81,81,0.0,M2019-06-08D,Race(3),,
6,0,0,0,0,0,0,0,0,0,0,0,0,0,0,0,0,126,126,0.0,M2019-06-08D,Race(3),,
7,0,0,7,7,0,1,3,4,0,1,0,1,0,2,10,12,11,11,3.0,M2019-06-08D,Race(3),,
8,0,0,0,0,0,0,0,0,0,0,0,0,0,0,0,0,71,67,0.0,M2019-06-08D,Race(3),,
9,0,0,0,0,0,0,0,0,0,0,0,0,0,0,0,0,71,67,0.0,M2019-06-08D,Race(3),,
1,0,2,4,6,1,3,13,17,0,5,5,10,1,10,22,33,21,23,0.0,M2019-06-08D,Race(4),,
2,4,3,3,10,1,1,1,3,5,0,0,5,10,4,4,18,12,16,3.0,M2019-06-08D,Race(4),,
3,0,0,0,0,0,0,0,0,0,0,0,0,0,0,0,0,61,61,0.0,M2019-06-08D,Race(4),,
4,0,0,0,0,0,0,0,0,0,0,0,0,0,0,0,0,31,31,0.0,M2019-06-08D,Race(4),,
5,0,2,3,5,1,1,2,4,1,2,3,6,2,5,8,15,13,13,0.0,M2019-06-08D,Race(4),,
6,7,5,5,17,6,16,5,27,6,10,3,19,19,31,13,63,3.7,3.8,1.0,M2019-06-08D,Race(4),,
7,9,10,2,21,16,8,3,27,8,9,4,21,33,27,9,69,2.4,2.5,0.0,M2019-06-08D,Race(4),,
8,3,6,7,16,2,1,3,6,2,0,3,5,7,7,13,27,8,8.5,2.0,M2019-06-08D,Race(4),,
9,0,2,0,2,0,0,0,0,0,0,1,1,0,2,1,3,20,26,0.0,M2019-06-08D,Race(4),,
10,5,0,0,5,0,0,0,0,1,0,0,1,6,0,0,6,21,23,0.0,M2019-06-08D,Race(4),,
11,0,0,3,3,3,0,0,3,3,0,3,6,6,0,6,12,18,19,0.0,M2019-06-08D,Race(4),,
12,0,0,0,0,0,0,2,2,0,0,2,2,0,0,4,4,16,21,0.0,M2019-06-08D,Race(4),,
13,0,0,3,3,0,0,1,1,0,0,2,2,0,0,6,6,16,17,0.0,M2019-06-08D,Race(4),,
14,2,0,0,2,0,0,0,0,0,0,0,0,2,0,0,2,41,41,0.0,M2019-06-08D,Race(4),,
1,15,10,0,25,6,18,6,30,5,13,3,21,26,41,9,76,2.65,2.7,0.0,M2019-06-08D,Race(5),,
2,0,0,3,3,0,0,0,0,0,0,0,0,0,0,3,3,26,31,3.0,M2019-06-08D,Race(5),,
3,0,0,0,0,0,0,0,0,0,0,0,0,0,0,0,0,12,13,0.0,M2019-06-08D,Race(5),,
4,0,0,0,0,0,0,0,0,0,0,0,0,0,0,0,0,51,51,2.0,M2019-06-08D,Race(5),,
5,11,9,7,27,24,6,0,30,20,5,0,25,55,20,7,82,2.65,2.8,1.0,M2019-06-08D,Race(5),,
6,0,0,0,0,0,0,0,0,0,0,0,0,0,0,0,0,61,61,0.0,M2019-06-08D,Race(5),,
7,0,0,0,0,0,1,0,1,0,3,0,3,0,4,0,4,71,81,0.0,M2019-06-08D,Race(5),,
8,0,5,8,13,0,2,5,7,0,3,3,6,0,10,16,26,6,6.5,0.0,M2019-06-08D,Race(5),,
9,0,3,2,5,0,0,0,0,0,0,0,0,0,3,2,5,12,13,0.0,M2019-06-08D,Race(5),,
10,0,3,7,10,0,3,17,20,0,1,13,14,0,7,37,44,12,13,0.0,M2019-06-08D,Race(5),,
11,2,0,0,2,0,0,0,0,0,0,1,1,2,0,1,3,15,16,0.0,M2019-06-08D,Race(5),,
12,0,0,0,0,0,0,0,0,0,1,0,1,0,1,0,1,41,41,0.0,M2019-06-08D,Race(5),,
1,0,0,2,2,0,2,0,2,0,0,1,1,0,2,3,5,15,15,0.0,M2019-06-08D,Race(6),,
2,3,6,2,11,1,5,16,22,3,5,8,16,7,16,26,49,7,7,0.0,M2019-06-08D,Race(6),,
3,0,0,0,0,0,0,0,0,0,0,0,0,0,0,0,0,101,101,0.0,M2019-06-08D,Race(6),,
4,0,0,0,0,1,0,0,1,0,0,0,0,1,0,0,1,0,0,0.0,M2019-06-08D,Race(6),,
5,7,5,7,19,5,2,2,9,7,2,2,11,19,9,11,39,5.5,5.5,0.0,M2019-06-08D,Race(6),,
6,8,8,0,16,14,5,5,24,8,5,6,19,30,18,11,59,6.5,6.5,1.0,M2019-06-08D,Race(6),,
7,0,2,0,2,1,0,0,1,0,0,0,0,1,2,0,3,19,19,2.0,M2019-06-08D,Race(6),,
8,4,2,5,11,3,10,2,15,0,0,2,2,7,12,9,28,7.5,7.5,0.0,M2019-06-08D,Race(6),,
9,8,3,8,19,4,3,5,12,3,10,6,19,15,16,19,50,2.9,2.9,3.0,M2019-06-08D,Race(6),,
10,0,2,6,8,1,3,0,4,1,4,1,6,2,9,7,18,8.5,8.5,0.0,M2019-06-08D,Race(6),,
11,0,2,0,2,0,0,0,0,0,0,0,0,0,2,0,2,61,61,0.0,M2019-06-08D,Race(6),,
12,0,0,0,0,0,0,0,0,0,0,0,0,0,0,0,0,101,101,0.0,M2019-06-08D,Race(6),,
13,0,0,0,0,0,0,0,0,0,0,0,0,0,0,0,0,21,21,0.0,M2019-06-08D,Race(6),,
1,2,0,2,4,1,3,2,6,0,5,4,9,3,8,8,19,10,14,0.0,M2019-06-08D,Race(7),,
2,0,3,0,3,0,0,0,0,1,0,1,2,1,3,1,5,13,18,0.0,M2019-06-08D,Race(7),,
3,0,0,0,0,1,0,0,1,0,0,0,0,1,0,0,1,71,81,0.0,M2019-06-08D,Race(7),,
4,0,0,2,2,0,0,0,0,0,0,0,0,0,0,2,2,71,81,0.0,M2019-06-08D,Race(7),,
5,4,7,16,27,7,14,3,24,5,7,5,17,16,28,24,68,3.2,3.4,0.0,M2019-06-08D,Race(7),,
6,21,7,0,28,18,5,3,26,17,4,2,23,56,16,5,77,2.8,2.9,2.0,M2019-06-08D,Race(7),,
7,0,0,2,2,0,1,1,2,0,0,0,0,0,1,3,4,12,13,3.0,M2019-06-08D,Race(7),,
8,0,0,0,0,1,0,0,1,1,1,1,3,2,1,1,4,26,31,0.0,M2019-06-08D,Race(7),,
9,3,5,8,16,2,3,5,10,2,1,8,11,7,9,21,37,5.5,5.5,1.0,M2019-06-08D,Race(7),,
10,0,0,0,0,0,0,0,0,0,0,0,0,0,0,0,0,126,151,0.0,M2019-06-08D,Race(7),,
11,0,8,0,8,0,4,16,20,0,8,5,13,0,20,21,41,5.5,5.5,0.0,M2019-06-08D,Race(7),,
1,5,0,5,10,0,0,1,1,0,0,0,0,5,0,6,11,15,15,0.0,M2019-06-08D,Race(8),,
2,2,2,10,14,1,3,5,9,6,4,6,16,9,9,21,39,6.5,6.5,2.0,M2019-06-08D,Race(8),,
3,9,10,9,28,17,5,6,28,10,6,6,22,36,21,21,78,3,3,1.0,M2019-06-08D,Race(8),,
4,3,6,2,11,2,4,13,19,4,4,1,9,9,14,16,39,8,8,0.0,M2019-06-08D,Race(8),,
5,0,0,2,2,0,2,1,3,0,3,1,4,0,5,4,9,21,21,0.0,M2019-06-08D,Race(8),,
6,0,0,0,0,0,0,0,0,0,0,0,0,0,0,0,0,101,101,0.0,M2019-06-08D,Race(8),,
7,11,10,2,23,9,13,2,24,5,6,5,16,25,29,9,63,3.5,3.5,0.0,M2019-06-08D,Race(8),,
8,0,0,0,0,0,0,0,0,0,0,0,0,0,0,0,0,81,81,0.0,M2019-06-08D,Race(8),,
9,0,0,0,0,0,0,0,0,0,0,2,2,0,0,2,2,81,81,0.0,M2019-06-08D,Race(8),,
10,0,0,0,0,0,0,0,0,0,0,0,0,0,0,0,0,12,12,0.0,M2019-06-08D,Race(8),,
11,0,0,0,0,0,0,0,0,0,0,0,0,0,0,0,0,81,81,0.0,M2019-06-08D,Race(8),,
12,0,0,0,0,0,0,0,0,0,0,0,0,0,0,0,0,101,101,0.0,M2019-06-08D,Race(8),,
13,0,0,0,0,1,0,1,2,1,0,1,2,2,0,2,4,13,13,3.0,M2019-06-08D,Race(8),,
14,0,2,0,2,0,3,1,4,0,3,4,7,0,8,5,13,21,21,0.0,M2019-06-08D,Race(8),,
1,5,6,2,13,2,2,2,6,1,4,0,5,8,12,4,24,5,5.5,0.0,M2019-06-08D,Race(9),,
2,0,0,0,0,4,2,3,9,0,0,0,0,4,2,3,9,0,0,0.0,M2019-06-08D,Race(9),,
3,6,3,3,12,3,1,3,7,3,2,5,10,12,6,11,29,6,5.5,0.0,M2019-06-08D,Race(9),,
4,2,0,0,2,0,1,0,1,0,1,2,3,2,2,2,6,31,31,0.0,M2019-06-08D,Race(9),,
5,0,0,3,3,0,0,0,0,1,0,2,3,1,0,5,6,26,26,0.0,M2019-06-08D,Race(9),,
6,0,0,0,0,0,1,1,2,0,1,2,3,0,2,3,5,11,11,0.0,M2019-06-08D,Race(9),,
7,0,0,0,0,0,0,1,1,0,2,1,3,0,2,2,4,13,14,0.0,M2019-06-08D,Race(9),,
8,5,9,8,22,16,6,3,25,10,5,3,18,31,20,14,65,4.8,4.6,3.0,M2019-06-08D,Race(9),,
9,0,2,0,2,0,0,0,0,0,0,0,0,0,2,0,2,15,15,0.0,M2019-06-08D,Race(9),,
10,0,7,4,11,3,11,3,17,1,4,2,7,4,22,9,35,7.5,7.5,2.0,M2019-06-08D,Race(9),,
11,12,3,10,25,2,6,14,22,5,7,4,16,19,16,28,63,3.6,3.8,1.0,M2019-06-08D,Race(9),,
1,7,2,8,17,3,1,2,6,4,1,5,10,14,4,15,33,3.8,3.8,0.0,M2019-06-12D,Race(1),,
2,0,0,0,0,0,1,0,1,0,0,0,0,0,1,0,1,0,0,0.0,M2019-06-12D,Race(1),,
3,0,3,2,5,0,1,2,3,0,2,3,5,0,6,7,13,12,12,0.0,M2019-06-12D,Race(1),,
4,0,3,0,3,0,0,0,0,0,0,1,1,0,3,1,4,20,20,0.0,M2019-06-12D,Race(1),,
5,0,5,0,5,1,3,0,4,1,6,0,7,2,14,0,16,10,10,3.0,M2019-06-12D,Race(1),,
6,5,2,13,20,3,15,5,23,4,4,7,15,12,21,25,58,4.2,4.2,1.0,M2019-06-12D,Race(1),,
7,5,0,3,8,2,2,17,21,0,7,4,11,7,9,24,40,7,7,0.0,M2019-06-12D,Race(1),,
8,11,8,2,21,19,5,3,27,14,2,4,20,44,15,9,68,3.8,3.8,2.0,M2019-06-12D,Race(1),,
9,2,7,2,11,2,2,1,5,3,2,1,6,7,11,4,22,8.5,8.5,0.0,M2019-06-12D,Race(1),,
1,0,0,0,0,0,0,0,0,1,0,1,2,1,0,1,2,13,13,0.0,M2019-06-12D,Race(2),,
2,2,6,10,18,0,2,4,6,2,3,3,8,4,11,17,32,8,8,0.0,M2019-06-12D,Race(2),,
3,0,0,0,0,0,0,2,2,0,1,3,4,0,1,5,6,11,11,0.0,M2019-06-12D,Race(2),,
4,0,15,8,23,1,16,7,24,4,9,6,19,5,40,21,66,4.8,4.8,3.0,M2019-06-12D,Race(2),,
5,28,2,0,30,24,4,2,30,12,6,3,21,64,12,5,81,2.15,2.15,2.0,M2019-06-12D,Race(2),,
6,0,0,0,0,0,0,0,0,2,0,0,2,2,0,0,2,51,51,1.0,M2019-06-12D,Race(2),,
7,0,2,8,10,4,8,14,26,5,6,8,19,9,16,30,55,5.5,5.5,0.0,M2019-06-12D,Race(2),,
8,0,3,0,3,0,0,0,0,0,0,1,1,0,3,1,4,41,41,0.0,M2019-06-12D,Race(2),,
9,0,2,4,6,1,0,1,2,0,0,1,1,1,2,6,9,13,13,0.0,M2019-06-12D,Race(2),,
10,0,0,0,0,0,0,0,0,0,1,0,1,0,1,0,1,101,101,0.0,M2019-06-12D,Race(2),,
1,0,2,2,4,2,0,1,3,1,0,0,1,3,2,3,8,19,19,0.0,M2019-06-12D,Race(3),,
2,2,3,9,14,4,5,16,25,3,5,5,13,9,13,30,52,8.5,8.5,0.0,M2019-06-12D,Race(3),,
3,0,3,2,5,1,2,3,6,3,3,3,9,4,8,8,20,9,9,0.0,M2019-06-12D,Race(3),,
4,0,0,0,0,2,1,0,3,2,3,1,6,4,4,1,9,15,15,0.0,M2019-06-12D,Race(3),,
5,20,2,0,22,20,4,1,25,15,4,2,21,55,10,3,68,2.9,2.9,1.0,M2019-06-12D,Race(3),,
6,0,0,3,3,0,0,0,0,1,0,1,2,1,0,4,5,14,14,0.0,M2019-06-12D,Race(3),,
7,2,5,0,7,1,1,2,4,0,1,2,3,3,7,4,14,8,8,0.0,M2019-06-12D,Race(3),,
8,0,0,0,0,0,0,0,0,1,0,0,1,1,0,0,1,13,13,3.0,M2019-06-12D,Race(3),,
9,4,0,0,4,0,0,1,1,0,0,0,0,4,0,1,5,19,19,0.0,M2019-06-12D,Race(3),,
10,0,12,11,23,0,14,2,16,0,4,7,11,0,30,20,50,11,11,0.0,M2019-06-12D,Race(3),,
11,0,3,0,3,0,2,3,5,0,4,2,6,0,9,5,14,17,17,2.0,M2019-06-12D,Race(3),,
12,2,0,3,5,0,0,0,0,0,0,1,1,2,0,4,6,31,31,0.0,M2019-06-12D,Race(3),,
13,0,0,0,0,0,1,1,2,0,2,2,4,0,3,3,6,15,15,0.0,M2019-06-12D,Race(3),,
14,0,0,0,0,0,0,0,0,0,0,0,0,0,0,0,0,81,81,0.0,M2019-06-12D,Race(3),,
1,0,2,2,4,1,0,0,1,0,0,0,0,1,2,2,5,26,26,0.0,M2019-06-12D,Race(4),,
2,3,10,8,21,2,5,16,23,2,4,7,13,7,19,31,57,7.5,7.5,3.0,M2019-06-12D,Race(4),,
3,3,0,3,6,1,2,0,3,0,2,0,2,4,4,3,11,11,11,0.0,M2019-06-12D,Race(4),,
4,18,2,8,28,23,4,0,27,19,3,0,22,60,9,8,77,2.6,2.6,2.0,M2019-06-12D,Race(4),,
5,0,0,2,2,0,0,1,1,0,0,0,0,0,0,3,3,26,26,0.0,M2019-06-12D,Race(4),,
6,0,0,0,0,0,0,0,0,0,0,0,0,0,0,0,0,51,51,0.0,M2019-06-12D,Race(4),,
7,2,4,0,6,0,2,3,5,1,4,4,9,3,10,7,20,10,10,0.0,M2019-06-12D,Race(4),,
8,0,0,0,0,0,3,0,3,1,6,4,11,1,9,4,14,10,10,0.0,M2019-06-12D,Race(4),,
9,0,3,0,3,0,0,0,0,0,0,0,0,0,3,0,3,34,34,0.0,M2019-06-12D,Race(4),,
10,0,6,5,11,1,13,4,18,2,4,5,11,3,23,14,40,7,7,0.0,M2019-06-12D,Race(4),,
11,0,0,0,0,0,0,0,0,0,0,1,1,0,0,1,1,51,51,0.0,M2019-06-12D,Race(4),,
12,4,3,2,9,2,1,6,9,1,3,5,9,7,7,13,27,5.5,5.5,1.0,M2019-06-12D,Race(4),,
1,20,3,2,25,21,3,3,27,13,4,4,21,54,10,9,73,3.6,3.6,1.0,M2019-06-12D,Race(5),,
2,3,13,2,18,6,19,2,27,4,9,4,17,13,41,8,62,4.8,4.8,3.0,M2019-06-12D,Race(5),,
3,0,0,0,0,0,0,0,0,0,0,1,1,0,0,1,1,26,26,0.0,M2019-06-12D,Race(5),,
4,0,0,0,0,0,0,0,0,2,0,0,2,2,0,0,2,51,51,0.0,M2019-06-12D,Race(5),,
5,3,2,18,23,3,3,16,22,4,4,4,12,10,9,38,57,4.6,4.6,0.0,M2019-06-12D,Race(5),,
6,4,0,0,4,0,0,5,5,0,3,8,11,4,3,13,20,10,10,2.0,M2019-06-12D,Race(5),,
7,0,7,0,7,0,2,2,4,1,2,3,6,1,11,5,17,7,7,0.0,M2019-06-12D,Race(5),,
8,0,3,2,5,0,2,0,2,1,1,0,2,1,6,2,9,19,19,0.0,M2019-06-12D,Race(5),,
9,0,2,3,5,0,1,0,1,0,2,0,2,0,5,3,8,14,14,0.0,M2019-06-12D,Race(5),,
10,0,0,0,0,0,0,0,0,0,0,0,0,0,0,0,0,41,41,0.0,M2019-06-12D,Race(5),,
11,0,0,0,0,0,0,1,1,0,1,0,1,0,1,1,2,14,14,0.0,M2019-06-12D,Race(5),,
12,0,0,3,3,0,0,1,1,1,0,2,3,1,0,6,7,19,19,0.0,M2019-06-12D,Race(5),,
1,0,0,2,2,0,0,17,17,0,1,7,8,0,1,26,27,19,19,0.0,M2019-06-12D,Race(6),,
2,18,7,5,30,8,18,3,29,16,6,4,26,42,31,12,85,3.2,3.2,2.0,M2019-06-12D,Race(6),,
3,2,14,5,21,21,8,1,30,9,11,2,22,32,33,8,73,3.6,3.5,0.0,M2019-06-12D,Race(6),,
4,0,5,8,13,0,0,3,3,0,1,6,7,0,6,17,23,9.5,9,0.0,M2019-06-12D,Race(6),,
5,10,2,5,17,0,4,5,9,1,5,3,9,11,11,13,35,5,6.5,0.0,M2019-06-12D,Race(6),,
6,0,2,0,2,0,0,0,0,0,0,0,0,0,2,0,2,17,17,0.0,M2019-06-12D,Race(6),,
7,0,0,0,0,1,0,0,1,0,0,1,1,1,0,1,2,12,11,0.0,M2019-06-12D,Race(6),,
8,0,0,0,0,0,0,0,0,0,0,0,0,0,0,0,0,51,51,0.0,M2019-06-12D,Race(6),,
9,0,0,0,0,0,0,0,0,0,0,2,2,0,0,2,2,21,21,1.0,M2019-06-12D,Race(6),,
10,0,0,2,2,0,0,0,0,0,0,0,0,0,0,2,2,34,34,0.0,M2019-06-12D,Race(6),,
11,0,0,0,0,0,0,0,0,0,0,1,1,0,0,1,1,21,21,0.0,M2019-06-12D,Race(6),,
12,0,0,3,3,0,0,1,1,0,2,0,2,0,2,4,6,15,15,3.0,M2019-06-12D,Race(6),,
1,3,0,0,3,0,0,2,2,0,1,1,2,3,1,3,7,14,14,0.0,M2019-06-12D,Race(7),,
2,0,0,6,6,0,1,1,2,1,2,1,4,1,3,8,12,12,12,0.0,M2019-06-12D,Race(7),,
3,0,0,0,0,0,0,1,1,0,0,1,1,0,0,2,2,61,61,0.0,M2019-06-12D,Race(7),,
4,8,5,5,18,2,16,4,22,7,8,5,20,17,29,14,60,6,6,3.0,M2019-06-12D,Race(7),,
5,5,13,2,20,21,4,4,29,11,8,2,21,37,25,8,70,2.75,2.9,2.0,M2019-06-12D,Race(7),,
6,7,0,7,14,2,4,16,22,3,3,10,16,12,7,33,52,7.5,7.5,0.0,M2019-06-12D,Race(7),,
7,3,5,8,16,1,3,1,5,4,2,5,11,8,10,14,32,6.5,6.5,1.0,M2019-06-12D,Race(7),,
8,2,3,2,7,0,1,1,2,0,1,0,1,2,5,3,10,7.5,7.5,0.0,M2019-06-12D,Race(7),,
9,0,0,0,0,3,0,0,3,0,1,1,2,3,1,1,5,11,11,0.0,M2019-06-12D,Race(7),,
10,2,0,0,2,1,1,0,2,0,0,0,0,3,1,0,4,21,21,0.0,M2019-06-12D,Race(7),,
11,0,4,0,4,0,0,0,0,0,0,0,0,0,4,0,4,41,51,0.0,M2019-06-12D,Race(7),,
12,0,0,0,0,0,0,0,0,0,0,0,0,0,0,0,0,71,67,0.0,M2019-06-12D,Race(7),,
1,5,9,4,18,19,6,4,29,11,9,4,24,35,24,12,71,5.5,5.5,0.0,M2019-06-12D,Race(8),,
2,0,0,2,2,0,0,0,0,0,0,0,0,0,0,2,2,34,35,0.0,M2019-06-12D,Race(8),,
3,0,0,0,0,0,0,0,0,0,0,0,0,0,0,0,0,26,26,0.0,M2019-06-12D,Race(8),,
4,0,0,0,0,0,0,0,0,0,0,0,0,0,0,0,0,81,81,0.0,M2019-06-12D,Race(8),,
5,3,6,6,15,2,4,5,11,2,6,8,16,7,16,19,42,4.6,4.6,1.0,M2019-06-12D,Race(8),,
6,5,0,2,7,0,0,2,2,0,0,4,4,5,0,8,13,11,11,0.0,M2019-06-12D,Race(8),,
7,0,0,0,0,0,0,0,0,0,1,0,1,0,1,0,1,51,51,0.0,M2019-06-12D,Race(8),,
8,0,0,0,0,0,1,0,1,0,0,1,1,0,1,1,2,15,15,0.0,M2019-06-12D,Race(8),,
9,11,7,3,21,7,17,3,27,11,7,3,21,29,31,9,69,3,3,2.0,M2019-06-12D,Race(8),,
10,6,0,8,14,0,2,14,16,1,3,4,8,7,5,26,38,8,8,0.0,M2019-06-12D,Race(8),,
11,0,8,5,13,2,0,2,4,1,0,2,3,3,8,9,20,9.5,9.5,3.0,M2019-06-12D,Race(8),,
12,0,0,0,0,0,0,0,0,0,0,0,0,0,0,0,0,71,67,0.0,M2019-06-12D,Race(8),,
13,0,0,0,0,0,0,0,0,0,0,0,0,0,0,0,0,71,67,0.0,M2019-06-12D,Race(8),,
14,0,0,0,0,0,0,0,0,0,0,0,0,0,0,0,0,34,34,0.0,M2019-06-12D,Race(8),,
1,0,0,3,3,0,0,2,2,0,1,2,3,0,1,7,8,81,81,0.0,M2019-06-16D,Race(1),,
2,0,2,5,7,0,0,9,9,0,0,3,3,0,2,17,19,31,31,0.0,M2019-06-16D,Race(1),,
3,30,0,0,30,22,1,0,23,22,3,1,26,74,4,1,79,1.16,1.16,1.0,M2019-06-16D,Race(1),,
4,0,26,4,30,8,21,1,30,4,21,0,25,12,68,5,85,5,5,3.0,M2019-06-16D,Race(1),,
5,0,0,5,5,0,0,2,2,0,1,15,16,0,1,22,23,17,17,0.0,M2019-06-16D,Race(1),,
6,0,0,7,7,0,0,0,0,0,0,1,1,0,0,8,8,81,81,0.0,M2019-06-16D,Race(1),,
7,0,2,6,8,0,8,5,13,0,0,4,4,0,10,15,25,19,19,2.0,M2019-06-16D,Race(1),,
1,0,2,0,2,0,0,0,0,0,0,1,1,0,2,1,3,61,61,3.0,M2019-06-16D,Race(10),,
2,0,3,0,3,0,0,0,0,0,0,0,0,0,3,0,3,91,91,0.0,M2019-06-16D,Race(10),,
3,0,5,6,11,3,6,3,12,1,4,3,8,4,15,12,31,7,7,0.0,M2019-06-16D,Race(10),,
4,5,8,3,16,9,6,3,18,14,5,0,19,28,19,6,53,6.5,6.5,0.0,M2019-06-16D,Race(10),,
5,0,0,5,5,0,0,5,5,0,0,5,5,0,0,15,15,8.5,9,0.0,M2019-06-16D,Race(10),,
6,0,0,0,0,0,0,0,0,0,0,0,0,0,0,0,0,126,126,0.0,M2019-06-16D,Race(10),,
7,0,0,0,0,0,0,0,0,0,0,0,0,0,0,0,0,31,31,0.0,M2019-06-16D,Race(10),,
8,20,8,2,30,0,9,2,11,10,13,0,23,30,30,4,64,2.2,2.15,0.0,M2019-06-16D,Race(10),,
9,0,0,3,3,0,0,1,1,0,1,3,4,0,1,7,8,31,27,0.0,M2019-06-16D,Race(10),,
10,5,4,0,9,8,1,4,13,1,2,6,9,14,7,10,31,7.5,7.5,2.0,M2019-06-16D,Race(10),,
11,0,0,6,6,0,0,8,8,0,1,3,4,0,1,17,18,19,19,0.0,M2019-06-16D,Race(10),,
12,0,0,0,0,0,0,3,3,0,0,2,2,0,0,5,5,31,31,1.0,M2019-06-16D,Race(10),,
13,0,0,3,3,0,0,0,0,0,0,0,0,0,0,3,3,31,31,0.0,M2019-06-16D,Race(10),,
14,0,0,2,2,0,8,1,9,0,0,3,3,0,8,6,14,18,18,0.0,M2019-06-16D,Race(10),,
1,0,2,3,5,0,0,0,0,0,0,0,0,0,2,3,5,31,31,0.0,M2019-06-16D,Race(11),,
2,13,6,7,26,8,7,3,18,9,7,4,20,30,20,14,64,4.6,4.5,3.0,M2019-06-16D,Race(11),,
3,10,16,2,28,11,9,1,21,11,10,2,23,32,35,5,72,2.9,3,0.0,M2019-06-16D,Race(11),,
4,0,0,0,0,0,0,8,8,0,0,0,0,0,0,8,8,26,26,0.0,M2019-06-16D,Race(11),,
5,0,0,0,0,0,0,2,2,0,0,3,3,0,0,5,5,19,17,0.0,M2019-06-16D,Race(11),,
6,0,2,0,2,0,0,2,2,0,1,2,3,0,3,4,7,11,11,0.0,M2019-06-16D,Race(11),,
7,2,0,3,5,0,0,0,0,0,0,0,0,2,0,3,5,19,19,0.0,M2019-06-16D,Race(11),,
8,0,0,3,3,0,0,0,0,0,0,0,0,0,0,3,3,18,19,0.0,M2019-06-16D,Race(11),,
9,0,0,2,2,0,2,3,5,0,0,5,5,0,2,10,12,16,16,0.0,M2019-06-16D,Race(11),,
10,2,2,3,7,2,1,3,6,4,4,4,12,8,7,10,25,9,10,0.0,M2019-06-16D,Race(11),,
11,0,0,3,3,1,8,1,10,0,2,0,2,1,10,4,15,20,18,2.0,M2019-06-16D,Race(11),,
12,0,0,0,0,0,0,0,0,1,0,0,1,1,0,0,1,81,91,0.0,M2019-06-16D,Race(11),,
13,0,0,0,0,0,0,0,0,0,0,0,0,0,0,0,0,34,34,0.0,M2019-06-16D,Race(11),,
14,3,2,4,9,8,3,7,18,1,2,6,9,12,7,17,36,7.5,7.5,1.0,M2019-06-16D,Race(11),,
1,6,5,4,15,3,1,2,6,4,2,2,8,13,8,8,29,8,8,3.0,M2019-06-16D,Race(2),,
2,10,10,8,28,13,7,2,22,11,8,3,22,34,25,13,72,3.4,3.4,1.0,M2019-06-16D,Race(2),,
3,0,0,0,0,0,0,0,0,0,0,0,0,0,0,0,0,23,23,0.0,M2019-06-16D,Race(2),,
4,0,0,0,0,0,0,0,0,0,0,0,0,0,0,0,0,71,67,0.0,M2019-06-16D,Race(2),,
5,5,5,2,12,0,3,5,8,1,5,7,13,6,13,14,33,6,6,2.0,M2019-06-16D,Race(2),,
6,4,8,2,14,2,4,5,11,4,2,5,11,10,14,12,36,6,6,0.0,M2019-06-16D,Race(2),,
7,0,0,0,0,0,0,0,0,0,0,0,0,0,0,0,0,81,81,0.0,M2019-06-16D,Race(2),,
8,0,0,0,0,0,8,0,8,0,1,0,1,0,9,0,9,17,17,0.0,M2019-06-16D,Race(2),,
9,0,0,0,0,0,0,3,3,0,1,1,2,0,1,4,5,26,26,0.0,M2019-06-16D,Race(2),,
10,5,0,3,8,3,7,5,15,3,6,5,14,11,13,13,37,10,10,0.0,M2019-06-16D,Race(2),,
11,0,0,0,0,8,0,0,8,2,1,0,3,10,1,0,11,31,31,0.0,M2019-06-16D,Race(2),,
12,0,2,9,11,1,0,8,9,0,0,0,0,1,2,17,20,6,6,0.0,M2019-06-16D,Race(2),,
13,0,0,0,0,0,0,0,0,1,0,3,4,1,0,3,4,0,0,0.0,M2019-06-16D,Race(2),,
14,0,0,2,2,0,0,0,0,0,0,0,0,0,0,2,2,21,21,0.0,M2019-06-16D,Race(2),,
1,10,11,4,25,7,10,4,21,11,9,3,23,28,30,11,69,3.8,3.8,0.0,M2019-06-16D,Race(3),,
2,0,0,0,0,0,0,0,0,0,0,1,1,0,0,1,1,101,101,0.0,M2019-06-16D,Race(3),,
3,0,0,0,0,0,2,5,7,0,0,0,0,0,2,5,7,34,34,0.0,M2019-06-16D,Race(3),,
4,16,11,0,27,13,8,2,23,12,11,1,24,41,30,3,74,2,2,0.0,M2019-06-16D,Race(3),,
5,0,0,2,2,0,0,1,1,0,0,0,0,0,0,3,3,51,51,0.0,M2019-06-16D,Race(3),,
6,4,3,2,9,2,2,7,11,2,1,5,8,8,6,14,28,7,7,1.0,M2019-06-16D,Race(3),,
7,0,3,9,12,0,0,1,1,1,0,2,3,1,3,12,16,10,10,2.0,M2019-06-16D,Race(3),,
8,0,0,2,2,8,0,0,8,0,2,2,4,8,2,4,14,31,31,0.0,M2019-06-16D,Race(3),,
9,0,0,0,0,0,8,0,8,0,0,1,1,0,8,1,9,31,31,0.0,M2019-06-16D,Race(3),,
10,0,2,5,7,0,0,2,2,0,0,2,2,0,2,9,11,15,15,0.0,M2019-06-16D,Race(3),,
11,0,0,3,3,0,0,0,0,0,0,0,0,0,0,3,3,51,51,0.0,M2019-06-16D,Race(3),,
12,0,0,3,3,0,0,8,8,0,0,1,1,0,0,12,12,26,26,3.0,M2019-06-16D,Race(3),,
13,0,0,0,0,0,0,0,0,0,0,0,0,0,0,0,0,151,151,0.0,M2019-06-16D,Race(3),,
14,0,0,0,0,0,0,0,0,0,0,0,0,0,0,0,0,51,51,0.0,M2019-06-16D,Race(3),,
1,2,2,0,4,8,0,2,10,3,0,1,4,13,2,3,18,8,8,0.0,M2019-06-16D,Race(4),,
2,5,5,10,20,2,5,5,12,3,7,5,15,10,17,20,47,5.5,5.5,0.0,M2019-06-16D,Race(4),,
3,0,3,0,3,0,0,0,0,0,0,0,0,0,3,0,3,51,51,0.0,M2019-06-16D,Race(4),,
4,0,0,3,3,0,0,0,0,0,0,1,1,0,0,4,4,21,21,0.0,M2019-06-16D,Race(4),,
5,0,0,0,0,0,0,0,0,0,0,0,0,0,0,0,0,151,151,0.0,M2019-06-16D,Race(4),,
6,11,2,4,17,9,6,3,18,12,4,1,17,32,12,8,52,3.7,3.7,0.0,M2019-06-16D,Race(4),,
7,2,0,0,2,4,2,8,14,4,2,1,7,10,4,9,23,26,26,2.0,M2019-06-16D,Race(4),,
8,6,8,0,14,4,5,1,10,1,7,3,11,11,20,4,35,6,6,3.0,M2019-06-16D,Race(4),,
9,0,2,5,7,0,9,2,11,0,1,4,5,0,12,11,23,7,7,1.0,M2019-06-16D,Race(4),,
10,4,5,8,17,3,3,6,12,3,5,7,15,10,13,21,44,4.6,4.5,0.0,M2019-06-16D,Race(4),,
11,0,3,0,3,0,0,3,3,0,0,3,3,0,3,6,9,21,21,0.0,M2019-06-16D,Race(4),,
12,0,0,0,0,0,0,0,0,0,0,0,0,0,0,0,0,91,91,0.0,M2019-06-16D,Race(4),,
1,0,10,11,21,5,6,5,16,2,5,5,12,7,21,21,49,4.6,4.6,1.0,M2019-06-16D,Race(5),,
2,20,5,2,27,15,6,2,23,19,4,2,25,54,15,6,75,1.95,1.95,3.0,M2019-06-16D,Race(5),,
3,0,0,0,0,8,0,2,10,0,0,2,2,8,0,4,12,41,41,0.0,M2019-06-16D,Race(5),,
4,0,0,0,0,0,2,9,11,0,2,3,5,0,4,12,16,15,15,0.0,M2019-06-16D,Race(5),,
5,0,0,0,0,0,0,0,0,0,0,0,0,0,0,0,0,151,151,0.0,M2019-06-16D,Race(5),,
6,0,0,0,0,0,0,0,0,0,0,0,0,0,0,0,0,151,151,0.0,M2019-06-16D,Race(5),,
7,0,12,4,16,0,9,0,9,1,3,2,6,1,24,6,31,7,7,0.0,M2019-06-16D,Race(5),,
8,8,3,7,18,2,7,8,17,3,10,6,19,13,20,21,54,6,6,0.0,M2019-06-16D,Race(5),,
9,2,0,3,5,0,0,4,4,1,0,5,6,3,0,12,15,14,14,0.0,M2019-06-16D,Race(5),,
10,0,0,3,3,0,0,0,0,0,1,0,1,0,1,3,4,61,61,0.0,M2019-06-16D,Race(5),,
11,0,0,0,0,0,0,0,0,0,1,1,2,0,1,1,2,26,26,2.0,M2019-06-16D,Race(5),,
12,0,0,0,0,0,0,0,0,0,0,0,0,0,0,0,0,151,151,0.0,M2019-06-16D,Race(5),,
1,8,6,7,21,2,3,6,11,4,3,7,14,14,12,20,46,8,8,0.0,M2019-06-16D,Race(6),,
2,11,7,5,23,14,5,2,21,14,5,2,21,39,17,9,65,2.4,2.4,0.0,M2019-06-16D,Race(6),,
3,4,8,8,20,4,8,5,17,2,12,4,18,10,28,17,55,4.4,4.4,0.0,M2019-06-16D,Race(6),,
4,0,0,0,0,0,0,0,0,0,0,0,0,0,0,0,0,21,21,0.0,M2019-06-16D,Race(6),,
5,0,0,0,0,0,0,0,0,0,0,0,0,0,0,0,0,101,101,0.0,M2019-06-16D,Race(6),,
6,0,0,4,4,0,0,3,3,1,1,3,5,1,1,10,12,21,21,3.0,M2019-06-16D,Race(6),,
7,0,3,0,3,0,0,0,0,0,0,0,0,0,3,0,3,51,51,0.0,M2019-06-16D,Race(6),,
8,5,0,0,5,2,1,2,5,3,1,1,5,10,2,3,15,14,14,0.0,M2019-06-16D,Race(6),,
9,0,2,0,2,0,8,0,8,0,0,2,2,0,10,2,12,10,10,1.0,M2019-06-16D,Race(6),,
10,0,0,0,0,0,2,0,2,0,1,1,2,0,3,1,4,17,17,0.0,M2019-06-16D,Race(6),,
11,0,0,0,0,0,0,0,0,0,0,0,0,0,0,0,0,126,126,0.0,M2019-06-16D,Race(6),,
12,0,0,0,0,0,0,0,0,0,0,0,0,0,0,0,0,126,126,0.0,M2019-06-16D,Race(6),,
13,0,2,3,5,8,2,3,13,2,3,4,9,10,7,10,27,13,13,2.0,M2019-06-16D,Race(6),,
14,2,2,3,7,0,1,9,10,0,0,2,2,2,3,14,19,15,15,0.0,M2019-06-16D,Race(6),,
1,11,9,3,23,13,6,3,22,10,7,3,20,34,22,9,65,3.4,3.4,0.0,M2019-06-16D,Race(7),,
2,7,9,4,20,4,12,3,19,8,7,4,19,19,28,11,58,4.8,4.8,3.0,M2019-06-16D,Race(7),,
3,0,3,0,3,0,1,2,3,0,4,1,5,0,8,3,11,11,11,0.0,M2019-06-16D,Race(7),,
4,0,0,3,3,0,0,5,5,0,0,7,7,0,0,15,15,14,14,0.0,M2019-06-16D,Race(7),,
5,0,0,0,0,0,0,0,0,0,0,0,0,0,0,0,0,71,71,0.0,M2019-06-16D,Race(7),,
6,0,0,0,0,2,0,0,2,2,0,1,3,4,0,1,5,14,14,1.0,M2019-06-16D,Race(7),,
7,0,0,4,4,0,0,8,8,0,1,2,3,0,1,14,15,8.5,8.5,0.0,M2019-06-16D,Race(7),,
8,10,4,3,17,3,1,4,8,6,2,2,10,19,7,9,35,7.5,7.5,0.0,M2019-06-16D,Race(7),,
9,2,3,0,5,0,8,1,9,0,2,0,2,2,13,1,16,14,14,0.0,M2019-06-16D,Race(7),,
10,0,2,13,15,8,1,4,13,0,3,5,8,8,6,22,36,9,9,0.0,M2019-06-16D,Race(7),,
11,0,0,0,0,0,0,0,0,0,0,0,0,0,0,0,0,34,34,2.0,M2019-06-16D,Race(7),,
12,0,0,0,0,0,0,0,0,0,0,0,0,0,0,0,0,151,151,0.0,M2019-06-16D,Race(7),,
13,0,0,0,0,0,1,0,1,0,0,1,1,0,1,1,2,31,31,0.0,M2019-06-16D,Race(7),,
14,0,0,0,0,0,0,0,0,0,0,0,0,0,0,0,0,41,41,0.0,M2019-06-16D,Race(7),,
1,0,5,0,5,0,8,4,12,0,1,3,4,0,14,7,21,16,16,3.0,M2019-06-16D,Race(8),,
2,5,10,13,28,18,7,4,29,14,7,2,23,37,24,19,80,3.7,3.7,0.0,M2019-06-16D,Race(8),,
3,2,0,0,2,0,1,8,9,0,2,2,4,2,3,10,15,21,21,0.0,M2019-06-16D,Race(8),,
4,0,0,0,0,0,0,0,0,1,0,0,1,1,0,0,1,51,51,0.0,M2019-06-16D,Race(8),,
5,0,0,0,0,0,0,0,0,0,0,0,0,0,0,0,0,126,126,0.0,M2019-06-16D,Race(8),,
6,0,0,0,0,0,0,0,0,0,1,0,1,0,1,0,1,151,151,0.0,M2019-06-16D,Race(8),,
7,17,8,5,30,9,7,5,21,7,6,6,19,33,21,16,70,2.7,2.7,0.0,M2019-06-16D,Race(8),,
8,3,7,7,17,3,5,9,17,3,6,11,20,9,18,27,54,6.5,6.5,2.0,M2019-06-16D,Race(8),,
9,0,0,3,3,0,0,0,0,0,0,0,0,0,0,3,3,8,8,0.0,M2019-06-16D,Race(8),,
10,0,0,0,0,0,0,0,0,0,0,0,0,0,0,0,0,101,101,0.0,M2019-06-16D,Race(8),,
11,0,0,0,0,0,0,0,0,0,1,0,1,0,1,0,1,151,151,0.0,M2019-06-16D,Race(8),,
12,3,0,2,5,0,2,0,2,1,2,2,5,4,4,4,12,5,5,1.0,M2019-06-16D,Race(8),,
1,5,0,2,7,8,1,7,16,4,3,7,14,17,4,16,37,10,9,2.0,M2019-06-16D,Race(9),,
2,0,2,0,2,0,0,0,0,0,0,0,0,0,2,0,2,18,19,0.0,M2019-06-16D,Race(9),,
3,0,3,5,8,1,1,9,11,0,3,3,6,1,7,17,25,9,9,0.0,M2019-06-16D,Race(9),,
4,7,7,11,25,7,10,3,20,9,6,6,21,23,23,20,66,3.9,3.5,0.0,M2019-06-16D,Race(9),,
5,0,0,0,0,0,0,0,0,0,0,0,0,0,0,0,0,101,151,0.0,M2019-06-16D,Race(9),,
6,0,0,0,0,0,0,0,0,0,0,0,0,0,0,0,0,34,41,0.0,M2019-06-16D,Race(9),,
7,0,0,0,0,0,0,0,0,0,0,0,0,0,0,0,0,11,10,0.0,M2019-06-16D,Race(9),,
8,14,12,2,28,13,6,3,22,13,6,4,23,40,24,9,73,2.4,2.4,3.0,M2019-06-16D,Race(9),,
9,2,0,0,2,0,0,0,0,0,1,0,1,2,1,0,3,51,51,1.0,M2019-06-16D,Race(9),,
10,0,0,0,0,0,0,0,0,0,0,0,0,0,0,0,0,34,41,0.0,M2019-06-16D,Race(9),,
11,0,6,7,13,1,4,8,13,0,7,5,12,1,17,20,38,7.5,7,0.0,M2019-06-16D,Race(9),,
12,0,0,0,0,0,8,0,8,0,0,1,1,0,8,1,9,61,67,0.0,M2019-06-16D,Race(9),,
1,3,8,7,18,16,5,4,25,8,4,2,14,27,17,13,57,4.2,4.2,2.0,M2019-06-23D,Race(1),,
2,0,0,0,0,0,1,1,2,1,1,1,3,1,2,2,5,26,26,1.0,M2019-06-23D,Race(1),,
3,9,2,0,11,7,3,11,21,7,2,4,13,23,7,15,45,8,8.5,0.0,M2019-06-23D,Race(1),,
4,2,12,0,14,2,2,3,7,1,4,4,9,5,18,7,30,6.5,7,0.0,M2019-06-23D,Race(1),,
5,0,0,5,5,1,0,1,2,2,2,0,4,3,2,6,11,21,21,3.0,M2019-06-23D,Race(1),,
6,5,0,0,5,0,4,4,8,1,4,6,11,6,8,10,24,11,11,0.0,M2019-06-23D,Race(1),,
7,0,0,6,6,0,1,0,1,0,0,1,1,0,1,7,8,15,16,0.0,M2019-06-23D,Race(1),,
8,8,5,6,19,2,13,3,18,6,9,3,18,16,27,12,55,5.5,5.5,0.0,M2019-06-23D,Race(1),,
9,0,0,0,0,0,0,0,0,0,0,1,1,0,0,1,1,31,31,0.0,M2019-06-23D,Race(1),,
10,0,0,2,2,0,0,0,0,0,0,0,0,0,0,2,2,31,31,0.0,M2019-06-23D,Race(1),,
11,3,0,0,3,2,0,2,4,0,0,0,0,5,0,2,7,8.5,9,0.0,M2019-06-23D,Race(1),,
12,0,0,2,2,0,1,1,2,0,0,3,3,0,1,6,7,11,11,0.0,M2019-06-23D,Race(1),,
13,0,3,2,5,0,0,0,0,0,0,1,1,0,3,3,6,16,16,0.0,M2019-06-23D,Race(1),,
14,0,0,0,0,0,0,0,0,0,0,0,0,0,0,0,0,31,31,0.0,M2019-06-23D,Race(1),,
1,2,2,0,4,1,3,0,4,2,0,1,3,5,5,1,11,10,11,0.0,M2019-06-23D,Race(10),,
2,0,0,0,0,0,0,0,0,2,0,0,2,2,0,0,2,21,21,0.0,M2019-06-23D,Race(10),,
3,0,0,0,0,0,0,0,0,1,1,0,2,1,1,0,2,41,41,0.0,M2019-06-23D,Race(10),,
4,5,3,0,8,3,11,3,17,0,7,5,12,8,21,8,37,10,11,2.0,M2019-06-23D,Race(10),,
5,4,2,3,9,1,2,1,4,0,1,2,3,5,5,6,16,17,17,0.0,M2019-06-23D,Race(10),,
6,3,0,3,6,2,2,1,5,2,3,0,5,7,5,4,16,9,8.5,3.0,M2019-06-23D,Race(10),,
7,8,11,3,22,14,5,6,25,12,4,7,23,34,20,16,70,2.5,2.5,0.0,M2019-06-23D,Race(10),,
8,0,0,5,5,0,1,1,2,0,2,1,3,0,3,7,10,14,14,0.0,M2019-06-23D,Race(10),,
9,0,5,9,14,6,2,3,11,3,3,1,7,9,10,13,32,11,7,1.0,M2019-06-23D,Race(10),,
10,0,0,0,0,0,0,0,0,0,0,0,0,0,0,0,0,101,101,0.0,M2019-06-23D,Race(10),,
11,0,0,0,0,0,1,1,2,0,0,2,2,0,1,3,4,41,41,0.0,M2019-06-23D,Race(10),,
12,0,0,0,0,0,0,0,0,0,0,0,0,0,0,0,0,41,41,0.0,M2019-06-23D,Race(10),,
13,8,4,5,17,3,3,13,19,4,5,6,15,15,12,24,51,6.5,6.5,0.0,M2019-06-23D,Race(10),,
14,0,3,2,5,0,0,1,1,0,0,1,1,0,3,4,7,16,14,0.0,M2019-06-23D,Race(10),,
1,0,0,0,0,0,0,0,0,0,0,0,0,0,0,0,0,31,31,0.0,M2019-06-23D,Race(2),,
2,10,13,2,25,19,8,0,27,11,7,1,19,40,28,3,71,5.5,5.5,3.0,M2019-06-23D,Race(2),,
3,0,0,0,0,0,0,0,0,0,0,1,1,0,0,1,1,31,31,0.0,M2019-06-23D,Race(2),,
4,6,5,10,21,2,2,4,8,2,1,4,7,10,8,18,36,4.6,4.5,1.0,M2019-06-23D,Race(2),,
5,0,0,0,0,0,0,0,0,0,0,0,0,0,0,0,0,31,31,0.0,M2019-06-23D,Race(2),,
6,0,4,4,8,1,0,0,1,0,1,0,1,1,5,4,10,10,10,0.0,M2019-06-23D,Race(2),,
7,0,0,0,0,1,0,0,1,1,1,0,2,2,1,0,3,21,21,0.0,M2019-06-23D,Race(2),,
8,7,8,6,21,6,16,6,28,7,8,7,22,20,32,19,71,2.7,2.7,0.0,M2019-06-23D,Race(2),,
9,0,0,0,0,0,0,0,0,0,0,1,1,0,0,1,1,31,31,0.0,M2019-06-23D,Race(2),,
10,0,0,0,0,0,0,0,0,0,0,0,0,0,0,0,0,101,101,0.0,M2019-06-23D,Race(2),,
11,5,0,5,10,1,4,19,24,5,7,8,20,11,11,32,54,7,7,2.0,M2019-06-23D,Race(2),,
12,2,0,3,5,0,0,1,1,0,1,4,5,2,1,8,11,12,12,0.0,M2019-06-23D,Race(2),,
1,7,7,2,16,15,5,6,26,6,6,3,15,28,18,11,57,4,4,3.0,M2019-06-23D,Race(3),,
2,0,0,0,0,0,0,0,0,0,0,0,0,0,0,0,0,18,18,0.0,M2019-06-23D,Race(3),,
3,0,0,2,2,0,1,0,1,0,0,0,0,0,1,2,3,26,26,0.0,M2019-06-23D,Race(3),,
4,7,3,7,17,2,2,3,7,6,4,2,12,15,9,12,36,5,5,2.0,M2019-06-23D,Race(3),,
5,5,4,3,12,3,13,6,22,3,6,12,21,11,23,21,55,7,7,0.0,M2019-06-23D,Race(3),,
6,3,2,3,8,1,4,12,17,1,1,4,6,5,7,19,31,6,6,0.0,M2019-06-23D,Race(3),,
7,3,6,3,12,0,2,1,3,1,3,3,7,4,11,7,22,10,10,0.0,M2019-06-23D,Race(3),,
8,5,8,10,23,9,3,2,14,9,6,2,17,23,17,14,54,3.3,3.3,1.0,M2019-06-23D,Race(3),,
1,0,0,9,9,0,1,1,2,0,1,1,2,0,2,11,13,12,12,0.0,M2019-06-23D,Race(4),,
2,0,3,0,3,0,0,2,2,0,1,0,1,0,4,2,6,26,26,0.0,M2019-06-23D,Race(4),,
3,0,2,0,2,2,3,2,7,2,2,5,9,4,7,7,18,17,18,0.0,M2019-06-23D,Race(4),,
4,0,5,5,10,1,4,12,17,3,3,4,10,4,12,21,37,9,9,0.0,M2019-06-23D,Race(4),,
5,3,0,0,3,1,1,1,3,5,5,0,10,9,6,1,16,11,11,0.0,M2019-06-23D,Race(4),,
6,12,0,8,20,14,3,4,21,6,3,3,12,32,6,15,53,4.8,4.8,2.0,M2019-06-23D,Race(4),,
7,0,0,0,0,0,0,0,0,0,1,0,1,0,1,0,1,21,21,0.0,M2019-06-23D,Race(4),,
8,6,8,2,16,6,13,6,25,6,4,7,17,18,25,15,58,5.5,5.5,0.0,M2019-06-23D,Race(4),,
9,2,7,0,9,4,3,1,8,2,3,3,8,8,13,4,25,6.5,6.5,3.0,M2019-06-23D,Race(4),,
10,2,3,2,7,1,0,0,1,1,0,0,1,4,3,2,9,15,15,0.0,M2019-06-23D,Race(4),,
11,3,0,4,7,0,1,0,1,1,1,2,4,4,2,6,12,7.5,7.5,0.0,M2019-06-23D,Race(4),,
12,0,0,0,0,0,0,0,0,0,0,0,0,0,0,0,0,151,151,0.0,M2019-06-23D,Race(4),,
13,0,2,0,2,1,0,1,2,0,0,0,0,1,2,1,4,17,17,1.0,M2019-06-23D,Race(4),,
14,2,0,0,2,0,1,0,1,0,2,1,3,2,3,1,6,21,21,0.0,M2019-06-23D,Race(4),,
1,6,0,3,9,2,1,1,4,1,3,2,6,9,4,6,19,13,13,0.0,M2019-06-23D,Race(5),,
2,3,3,3,9,2,1,1,4,2,0,0,2,7,4,4,15,13,13,0.0,M2019-06-23D,Race(5),,
3,0,2,0,2,3,2,6,11,0,0,0,0,3,4,6,13,14,14,0.0,M2019-06-23D,Race(5),,
4,3,0,3,6,3,1,1,5,2,1,0,3,8,2,4,14,9.5,9.5,2.0,M2019-06-23D,Race(5),,
5,8,8,5,21,12,3,3,18,10,4,3,17,30,15,11,56,2.8,2.8,1.0,M2019-06-23D,Race(5),,
6,5,8,6,19,4,15,2,21,5,7,2,14,14,30,10,54,7,7,0.0,M2019-06-23D,Race(5),,
7,0,0,6,6,1,2,2,5,2,3,6,11,3,5,14,22,8,8,0.0,M2019-06-23D,Race(5),,
8,0,2,0,2,1,0,0,1,0,0,0,0,1,2,0,3,13,13,0.0,M2019-06-23D,Race(5),,
9,0,0,0,0,0,0,0,0,0,0,0,0,0,0,0,0,101,101,0.0,M2019-06-23D,Race(5),,
10,0,7,0,7,1,4,2,7,1,4,4,9,2,15,6,23,17,17,0.0,M2019-06-23D,Race(5),,
11,0,0,0,0,0,0,0,0,0,0,0,0,0,0,0,0,151,151,0.0,M2019-06-23D,Race(5),,
12,5,0,4,9,1,1,12,14,3,4,8,15,9,5,24,38,7,7,3.0,M2019-06-23D,Race(5),,
13,0,0,0,0,0,0,0,0,0,0,1,1,0,0,1,1,101,101,0.0,M2019-06-23D,Race(5),,
14,0,0,0,0,0,0,0,0,0,0,0,0,0,0,0,0,51,51,0.0,M2019-06-23D,Race(5),,
1,5,3,7,15,17,3,2,22,13,2,3,18,35,8,12,55,4,4,3.0,M2019-06-23D,Race(6),,
2,0,0,0,0,0,0,0,0,0,0,0,0,0,0,0,0,51,51,0.0,M2019-06-23D,Race(6),,
3,2,0,0,2,0,1,4,5,0,1,6,7,2,2,10,14,13,13,0.0,M2019-06-23D,Race(6),,
4,4,5,3,12,3,3,3,9,2,4,4,10,9,12,10,31,8.5,8.5,0.0,M2019-06-23D,Race(6),,
5,6,13,9,28,2,13,2,17,2,7,1,10,10,33,12,55,7.5,7.5,2.0,M2019-06-23D,Race(6),,
6,10,2,5,17,6,5,12,23,6,7,5,18,22,14,22,58,4.6,4.5,1.0,M2019-06-23D,Race(6),,
7,3,7,0,10,0,0,1,1,0,0,2,2,3,7,3,13,11,11,0.0,M2019-06-23D,Race(6),,
8,0,0,0,0,0,0,0,0,0,0,0,0,0,0,0,0,81,81,0.0,M2019-06-23D,Race(6),,
9,0,0,0,0,0,0,0,0,0,0,0,0,0,0,0,0,51,51,0.0,M2019-06-23D,Race(6),,
10,0,0,3,3,0,1,0,1,0,0,0,0,0,1,3,4,8,8,0.0,M2019-06-23D,Race(6),,
11,0,0,0,0,0,0,0,0,0,0,0,0,0,0,0,0,31,31,0.0,M2019-06-23D,Race(6),,
12,0,0,3,3,2,4,6,12,3,5,5,13,5,9,14,28,8.5,8.5,0.0,M2019-06-23D,Race(6),,
13,0,0,0,0,0,0,0,0,0,0,0,0,0,0,0,0,31,31,0.0,M2019-06-23D,Race(6),,
14,0,0,0,0,0,0,0,0,0,0,0,0,0,0,0,0,31,31,0.0,M2019-06-23D,Race(6),,
1,25,0,5,30,30,0,0,30,24,2,0,26,79,2,5,86,1.4,1.4,1.0,M2019-06-23D,Race(7),,
2,0,14,7,21,0,15,8,23,0,8,8,16,0,37,23,60,10,10,0.0,M2019-06-23D,Race(7),,
3,0,0,0,0,0,0,0,0,0,2,0,2,0,2,0,2,151,151,0.0,M2019-06-23D,Race(7),,
4,0,2,0,2,0,0,0,0,0,0,1,1,0,2,1,3,101,101,0.0,M2019-06-23D,Race(7),,
5,0,0,2,2,0,1,0,1,0,0,1,1,0,1,3,4,18,18,0.0,M2019-06-23D,Race(7),,
6,0,0,0,0,0,1,0,1,0,0,0,0,0,1,0,1,51,51,0.0,M2019-06-23D,Race(7),,
7,0,0,0,0,0,0,0,0,0,0,0,0,0,0,0,0,151,151,0.0,M2019-06-23D,Race(7),,
8,0,0,0,0,0,0,0,0,0,0,0,0,0,0,0,0,51,51,0.0,M2019-06-23D,Race(7),,
9,2,5,3,10,0,3,4,7,0,1,4,5,2,9,11,22,18,18,3.0,M2019-06-23D,Race(7),,
10,0,0,0,0,0,0,0,0,0,0,0,0,0,0,0,0,126,126,0.0,M2019-06-23D,Race(7),,
11,0,2,8,10,0,3,13,16,0,3,7,10,0,8,28,36,9,9,0.0,M2019-06-23D,Race(7),,
12,3,7,3,13,0,6,5,11,1,7,4,12,4,20,12,36,9,9,0.0,M2019-06-23D,Race(7),,
13,0,0,0,0,0,1,0,1,1,3,0,4,1,4,0,5,31,31,2.0,M2019-06-23D,Race(7),,
14,0,0,2,2,0,0,0,0,0,0,1,1,0,0,3,3,31,31,0.0,M2019-06-23D,Race(7),,
1,16,8,2,26,17,4,8,29,12,4,5,21,45,16,15,76,3.2,3.6,1.0,M2019-06-23D,Race(8),,
2,0,2,0,2,2,0,2,4,3,1,4,8,5,3,6,14,10,11,0.0,M2019-06-23D,Race(8),,
3,0,5,3,8,0,1,2,3,1,1,3,5,1,7,8,16,11,12,0.0,M2019-06-23D,Race(8),,
4,5,0,3,8,0,0,0,0,0,1,0,1,5,1,3,9,8,10,2.0,M2019-06-23D,Race(8),,
5,5,0,5,10,1,2,0,3,2,2,0,4,8,4,5,17,8.5,10,3.0,M2019-06-23D,Race(8),,
6,0,3,4,7,1,3,2,6,1,2,3,6,2,8,9,19,11,12,0.0,M2019-06-23D,Race(8),,
7,2,4,8,14,7,4,11,22,4,5,4,13,13,13,23,49,0,0,0.0,M2019-06-23D,Race(8),,
8,0,3,0,3,0,0,0,0,1,1,0,2,1,4,0,5,19,21,0.0,M2019-06-23D,Race(8),,
9,2,3,3,8,2,12,4,18,1,3,5,9,5,18,12,35,5.5,6.5,0.0,M2019-06-23D,Race(8),,
10,0,2,0,2,0,4,1,5,1,6,1,8,1,12,2,15,7,8,0.0,M2019-06-23D,Race(8),,
11,0,0,2,2,0,0,0,0,0,0,1,1,0,0,3,3,23,31,0.0,M2019-06-23D,Race(8),,
1,0,10,7,17,3,14,4,21,3,11,3,17,6,35,14,55,6,6.5,0.0,M2019-06-23D,Race(9),,
2,30,0,0,30,22,7,1,30,17,9,0,26,69,16,1,86,2.25,2.3,0.0,M2019-06-23D,Race(9),,
3,0,2,2,4,0,0,0,0,0,0,0,0,0,2,2,4,41,41,0.0,M2019-06-23D,Race(9),,
4,0,3,3,6,0,1,1,2,0,1,0,1,0,5,4,9,23,26,0.0,M2019-06-23D,Race(9),,
5,0,0,3,3,1,0,2,3,0,1,3,4,1,1,8,10,26,27,0.0,M2019-06-23D,Race(9),,
6,0,0,0,0,0,0,0,0,0,0,0,0,0,0,0,0,51,51,0.0,M2019-06-23D,Race(9),,
7,0,0,0,0,0,0,1,1,0,0,2,2,0,0,3,3,13,14,1.0,M2019-06-23D,Race(9),,
8,0,0,0,0,0,0,2,2,0,0,2,2,0,0,4,4,34,35,2.0,M2019-06-23D,Race(9),,
9,0,5,0,5,0,0,1,1,0,0,2,2,0,5,3,8,26,23,0.0,M2019-06-23D,Race(9),,
10,0,5,8,13,2,6,15,23,3,2,9,14,5,13,32,50,9,9,3.0,M2019-06-23D,Race(9),,
11,0,5,3,8,2,1,0,3,2,0,0,2,4,6,3,13,9,9,0.0,M2019-06-23D,Race(9),,
12,0,0,2,2,0,1,1,2,1,1,0,2,1,2,3,6,13,13,0.0,M2019-06-23D,Race(9),,
13,0,0,0,0,0,0,2,2,0,1,5,6,0,1,7,8,13,12,0.0,M2019-06-23D,Race(9),,
14,0,0,2,2,0,0,0,0,0,0,0,0,0,0,2,2,34,35,0.0,M2019-06-23D,Race(9),,
1,0,2,0,2,0,0,0,0,0,0,1,1,0,2,1,3,13,13,3.0,M2019-06-26D,Race(1),,
2,0,2,4,6,0,2,3,5,1,2,5,8,1,6,12,19,16,16,0.0,M2019-06-26D,Race(1),,
3,10,8,7,25,6,6,12,24,8,8,2,18,24,22,21,67,6,6,1.0,M2019-06-26D,Race(1),,
4,0,5,5,10,0,15,2,17,1,5,1,7,1,25,8,34,14,14,0.0,M2019-06-26D,Race(1),,
5,0,0,0,0,0,0,1,1,0,0,0,0,0,0,1,1,9,9,0.0,M2019-06-26D,Race(1),,
6,0,0,0,0,0,0,0,0,0,0,1,1,0,0,1,1,34,34,0.0,M2019-06-26D,Race(1),,
7,0,0,0,0,0,0,0,0,0,0,0,0,0,0,0,0,81,81,0.0,M2019-06-26D,Race(1),,
8,0,0,0,0,3,0,0,3,2,2,2,6,5,2,2,9,21,21,0.0,M2019-06-26D,Race(1),,
9,0,0,0,0,0,1,1,2,0,1,3,4,0,2,4,6,34,34,0.0,M2019-06-26D,Race(1),,
10,7,8,8,23,8,4,3,15,8,4,2,14,23,16,13,52,4.4,4.4,0.0,M2019-06-26D,Race(1),,
11,13,5,3,21,12,2,7,21,5,4,6,15,30,11,16,57,2.6,2.6,2.0,M2019-06-26D,Race(1),,
12,0,0,3,3,1,0,1,2,1,0,3,4,2,0,7,9,17,17,0.0,M2019-06-26D,Race(1),,
1,0,0,3,3,0,0,0,0,0,0,0,0,0,0,3,3,26,26,0.0,M2019-06-26D,Race(2),,
2,2,2,0,4,0,2,2,4,0,2,3,5,2,6,5,13,9,9,0.0,M2019-06-26D,Race(2),,
3,2,5,12,19,0,1,3,4,0,0,1,1,2,6,16,24,4.8,4.8,0.0,M2019-06-26D,Race(2),,
4,0,0,0,0,0,0,2,2,1,0,5,6,1,0,7,8,19,19,0.0,M2019-06-26D,Race(2),,
5,3,0,6,9,0,1,2,3,2,4,1,7,5,5,9,19,13,13,0.0,M2019-06-26D,Race(2),,
6,2,3,0,5,1,1,4,6,1,1,3,5,4,5,7,16,17,17,1.0,M2019-06-26D,Race(2),,
7,9,13,4,26,25,2,1,28,18,3,2,23,52,18,7,77,3.1,3.1,3.0,M2019-06-26D,Race(2),,
8,0,0,0,0,0,1,0,1,0,2,1,3,0,3,1,4,34,34,0.0,M2019-06-26D,Race(2),,
9,2,5,0,7,0,12,2,14,0,5,3,8,2,22,5,29,9.5,9.5,2.0,M2019-06-26D,Race(2),,
10,10,2,5,17,4,10,14,28,4,9,7,20,18,21,26,65,4.6,4.5,0.0,M2019-06-26D,Race(2),,
11,0,0,0,0,0,0,0,0,0,0,0,0,0,0,0,0,51,51,0.0,M2019-06-26D,Race(2),,
12,0,0,0,0,0,0,0,0,0,0,0,0,0,0,0,0,31,31,0.0,M2019-06-26D,Race(2),,
1,5,7,4,16,5,4,13,22,8,2,4,14,18,13,21,52,8,8,0.0,M2019-06-26D,Race(3),,
2,3,0,0,3,1,1,0,2,1,3,0,4,5,4,0,9,15,15,0.0,M2019-06-26D,Race(3),,
3,7,7,5,19,13,4,5,22,7,3,4,14,27,14,14,55,4.2,4.2,1.0,M2019-06-26D,Race(3),,
4,3,0,8,11,1,12,2,15,2,2,4,8,6,14,14,34,15,15,0.0,M2019-06-26D,Race(3),,
5,8,3,3,14,2,4,4,10,1,6,8,15,11,13,15,39,4.2,4.2,0.0,M2019-06-26D,Race(3),,
6,4,2,0,6,2,1,0,3,1,5,0,6,7,8,0,15,8,8,2.0,M2019-06-26D,Race(3),,
7,0,2,2,4,5,0,3,8,3,0,0,3,8,2,5,15,11,11,3.0,M2019-06-26D,Race(3),,
8,0,0,5,5,1,2,1,4,1,3,4,8,2,5,10,17,11,11,0.0,M2019-06-26D,Race(3),,
9,0,0,0,0,0,0,0,0,0,0,0,0,0,0,0,0,51,51,0.0,M2019-06-26D,Race(3),,
10,0,6,0,6,0,1,1,2,0,0,1,1,0,7,2,9,8.5,8.5,0.0,M2019-06-26D,Race(3),,
11,0,3,3,6,0,1,1,2,2,2,1,5,2,6,5,13,13,13,0.0,M2019-06-26D,Race(3),,
12,0,0,0,0,0,0,0,0,0,0,0,0,0,0,0,0,41,41,0.0,M2019-06-26D,Race(3),,
1,21,2,7,30,20,4,3,27,17,3,2,22,58,9,12,79,4,4,2.0,M2019-06-26D,Race(4),,
2,0,0,0,0,0,1,1,2,0,0,3,3,0,1,4,5,41,41,0.0,M2019-06-26D,Race(4),,
3,2,7,5,14,0,16,6,22,0,8,5,13,2,31,16,49,6,6,0.0,M2019-06-26D,Race(4),,
4,0,0,6,6,0,0,4,4,0,2,3,5,0,2,13,15,14,14,0.0,M2019-06-26D,Race(4),,
5,2,0,0,2,0,0,0,0,0,1,1,2,2,1,1,4,10,10,0.0,M2019-06-26D,Race(4),,
6,5,16,9,30,10,8,9,27,9,11,3,23,24,35,21,80,3,3,0.0,M2019-06-26D,Race(4),,
7,0,0,0,0,0,0,0,0,0,0,0,0,0,0,0,0,31,31,0.0,M2019-06-26D,Race(4),,
8,0,0,0,0,0,0,0,0,0,0,0,0,0,0,0,0,21,21,1.0,M2019-06-26D,Race(4),,
9,0,3,0,3,0,0,5,5,0,1,6,7,0,4,11,15,21,21,0.0,M2019-06-26D,Race(4),,
10,0,0,0,0,0,0,0,0,0,0,0,0,0,0,0,0,151,151,0.0,M2019-06-26D,Race(4),,
11,0,0,3,3,0,0,0,0,0,0,0,0,0,0,3,3,18,18,3.0,M2019-06-26D,Race(4),,
12,0,2,0,2,0,1,2,3,0,0,3,3,0,3,5,8,7,7,0.0,M2019-06-26D,Race(4),,
1,3,2,0,5,1,1,2,4,2,2,4,8,6,5,6,17,12,12,0.0,M2019-06-26D,Race(5),,
2,0,0,7,7,3,2,10,15,2,2,3,7,5,4,20,29,8.5,8.5,0.0,M2019-06-26D,Race(5),,
3,13,10,0,23,18,7,3,28,12,8,3,23,43,25,6,74,4.6,4.6,3.0,M2019-06-26D,Race(5),,
4,0,0,3,3,0,2,3,5,0,3,4,7,0,5,10,15,12,12,1.0,M2019-06-26D,Race(5),,
5,0,4,8,12,2,1,0,3,0,1,0,1,2,6,8,16,9,9,0.0,M2019-06-26D,Race(5),,
6,0,0,0,0,0,0,0,0,0,2,0,2,0,2,0,2,51,51,0.0,M2019-06-26D,Race(5),,
7,3,0,2,5,0,1,2,3,0,0,3,3,3,1,7,11,15,15,0.0,M2019-06-26D,Race(5),,
8,4,3,0,7,3,1,3,7,4,0,2,6,11,4,5,20,8.5,8.5,0.0,M2019-06-26D,Race(5),,
9,0,0,0,0,0,0,0,0,0,0,0,0,0,0,0,0,41,41,2.0,M2019-06-26D,Race(5),,
10,0,0,0,0,0,0,0,0,0,0,1,1,0,0,1,1,16,16,0.0,M2019-06-26D,Race(5),,
11,0,0,7,7,0,2,1,3,0,2,0,2,0,4,8,12,9.5,9.5,0.0,M2019-06-26D,Race(5),,
12,7,11,3,21,3,13,6,22,6,6,6,18,16,30,15,61,3.6,3.7,0.0,M2019-06-26D,Race(5),,
1,3,3,2,8,0,0,1,1,0,1,0,1,3,4,3,10,13,13,0.0,M2019-06-26D,Race(6),,
2,0,6,7,13,0,4,2,6,0,2,2,4,0,12,11,23,10,10,0.0,M2019-06-26D,Race(6),,
3,17,5,3,25,27,3,0,30,19,5,1,25,63,13,4,80,2.6,2.6,0.0,M2019-06-26D,Race(6),,
4,0,0,3,3,1,0,12,13,2,0,5,7,3,0,20,23,15,15,0.0,M2019-06-26D,Race(6),,
5,3,0,2,5,1,12,5,18,0,5,6,11,4,17,13,34,6,6,0.0,M2019-06-26D,Race(6),,
6,0,0,0,0,0,0,0,0,2,0,0,2,2,0,0,2,31,31,0.0,M2019-06-26D,Race(6),,
7,0,2,0,2,0,3,1,4,0,4,1,5,0,9,2,11,21,21,0.0,M2019-06-26D,Race(6),,
8,0,0,2,2,1,1,1,3,0,0,2,2,1,1,5,7,26,27,0.0,M2019-06-26D,Race(6),,
9,0,0,0,0,0,0,1,1,0,0,0,0,0,0,1,1,17,17,0.0,M2019-06-26D,Race(6),,
10,4,7,0,11,0,4,4,8,2,3,4,9,6,14,8,28,8,8,3.0,M2019-06-26D,Race(6),,
11,3,0,5,8,0,1,1,2,1,1,0,2,4,2,6,12,15,15,1.0,M2019-06-26D,Race(6),,
12,0,7,6,13,0,2,2,4,0,5,5,10,0,14,13,27,9,9,2.0,M2019-06-26D,Race(6),,
1,9,3,9,21,17,9,2,28,8,8,2,18,34,20,13,67,3.4,3.4,0.0,M2019-06-26D,Race(7),,
2,2,2,0,4,5,2,15,22,3,4,9,16,10,8,24,42,8,8,0.0,M2019-06-26D,Race(7),,
3,6,2,13,21,4,4,4,12,5,6,3,14,15,12,20,47,4.6,4.6,1.0,M2019-06-26D,Race(7),,
4,8,16,4,28,1,12,6,19,7,3,4,14,16,31,14,61,5,5,2.0,M2019-06-26D,Race(7),,
5,2,0,0,2,0,0,2,2,1,2,2,5,3,2,4,9,12,12,0.0,M2019-06-26D,Race(7),,
6,0,3,0,3,0,1,1,2,0,0,2,2,0,4,3,7,15,15,0.0,M2019-06-26D,Race(7),,
7,0,0,0,0,0,0,0,0,0,0,0,0,0,0,0,0,41,41,0.0,M2019-06-26D,Race(7),,
8,0,2,0,2,1,1,0,2,2,2,2,6,3,5,2,10,19,19,0.0,M2019-06-26D,Race(7),,
9,0,2,2,4,0,0,0,0,0,0,1,1,0,2,3,5,18,18,0.0,M2019-06-26D,Race(7),,
10,0,0,0,0,1,0,0,1,0,0,0,0,1,0,0,1,34,34,0.0,M2019-06-26D,Race(7),,
11,3,0,2,5,1,1,0,2,0,1,1,2,4,2,3,9,9,9,3.0,M2019-06-26D,Race(7),,
12,0,0,0,0,0,0,0,0,0,0,0,0,0,0,0,0,51,51,0.0,M2019-06-26D,Race(7),,
1,0,6,15,21,0,4,3,7,0,4,3,7,0,14,21,35,9.5,9.5,2.0,M2019-06-26D,Race(8),,
2,4,6,0,10,2,6,14,22,4,8,6,18,10,20,20,50,8.5,8.5,0.0,M2019-06-26D,Race(8),,
3,0,4,6,10,3,14,6,23,5,5,1,11,8,23,13,44,8,8,0.0,M2019-06-26D,Race(8),,
4,24,0,2,26,24,4,2,30,14,7,3,24,62,11,7,80,2.1,2.1,1.0,M2019-06-26D,Race(8),,
5,0,0,0,0,0,0,0,0,0,0,0,0,0,0,0,0,126,126,0.0,M2019-06-26D,Race(8),,
6,2,0,0,2,0,1,1,2,0,1,6,7,2,2,7,11,14,14,3.0,M2019-06-26D,Race(8),,
7,0,3,0,3,0,0,1,1,0,0,2,2,0,3,3,6,15,15,0.0,M2019-06-26D,Race(8),,
8,0,0,0,0,0,0,0,0,0,0,0,0,0,0,0,0,51,51,0.0,M2019-06-26D,Race(8),,
9,0,2,3,5,1,0,0,1,2,0,0,2,3,2,3,8,14,14,0.0,M2019-06-26D,Race(8),,
10,0,2,0,2,0,1,0,1,0,1,0,1,0,4,0,4,15,15,0.0,M2019-06-26D,Race(8),,
11,0,7,2,9,0,0,1,1,0,0,2,2,0,7,5,12,12,12,0.0,M2019-06-26D,Race(8),,
12,0,0,2,2,0,0,2,2,0,0,3,3,0,0,7,7,15,15,0.0,M2019-06-26D,Race(8),,
1,24,6,0,30,22,1,0,23,25,1,0,26,71,8,0,79,1.7,1.7,1.0,M2019-07-01D,Race(1),,
2,2,10,10,22,0,7,5,12,0,8,1,9,2,25,16,43,5,5,2.0,M2019-07-01D,Race(1),,
3,0,0,0,0,0,0,0,0,0,0,0,0,0,0,0,0,81,81,0.0,M2019-07-01D,Race(1),,
4,0,3,3,6,0,2,6,8,0,3,9,12,0,8,18,26,14,14,0.0,M2019-07-01D,Race(1),,
5,2,0,6,8,0,2,7,9,0,2,5,7,2,4,18,24,9.5,9.5,0.0,M2019-07-01D,Race(1),,
6,0,0,0,0,0,2,0,2,0,2,2,4,0,4,2,6,51,51,0.0,M2019-07-01D,Race(1),,
7,2,0,0,2,0,2,0,2,0,2,0,2,2,4,0,6,51,51,0.0,M2019-07-01D,Race(1),,
8,0,5,2,7,0,8,5,13,0,1,4,5,0,14,11,25,17,17,0.0,M2019-07-01D,Race(1),,
9,0,0,5,5,0,4,2,6,0,3,2,5,0,7,9,16,11,11,0.0,M2019-07-01D,Race(1),,
10,0,0,0,0,0,0,0,0,0,0,0,0,0,0,0,0,151,151,0.0,M2019-07-01D,Race(1),,
11,0,0,0,0,0,0,0,0,0,0,0,0,0,0,0,0,151,151,0.0,M2019-07-01D,Race(1),,
12,0,6,2,8,8,2,3,13,1,4,2,7,9,12,7,28,21,21,0.0,M2019-07-01D,Race(1),,
13,0,0,0,0,0,0,0,0,0,0,1,1,0,0,1,1,51,51,3.0,M2019-07-01D,Race(1),,
14,0,0,2,2,0,0,0,0,0,0,0,0,0,0,2,2,34,34,0.0,M2019-07-01D,Race(1),,
1,0,0,0,0,0,0,0,0,0,0,0,0,0,0,0,0,71,67,0.0,M2019-07-01D,Race(10),,
2,2,2,3,7,0,0,0,0,1,0,0,1,3,2,3,8,13,13,0.0,M2019-07-01D,Race(10),,
3,2,2,0,4,0,0,8,8,1,0,2,3,3,2,10,15,10,10,2.0,M2019-07-01D,Race(10),,
4,0,3,12,15,0,3,5,8,0,6,7,13,0,12,24,36,9,9,3.0,M2019-07-01D,Race(10),,
5,0,0,0,0,0,0,0,0,0,0,1,1,0,0,1,1,17,17,1.0,M2019-07-01D,Race(10),,
6,0,0,0,0,0,0,0,0,0,0,0,0,0,0,0,0,51,51,0.0,M2019-07-01D,Race(10),,
7,13,6,7,26,13,6,4,23,18,5,2,25,44,17,13,74,3.8,3.8,0.0,M2019-07-01D,Race(10),,
8,0,0,0,0,1,0,0,1,1,0,0,1,2,0,0,2,13,13,0.0,M2019-07-01D,Race(10),,
9,0,0,0,0,0,8,0,8,0,1,0,1,0,9,0,9,23,23,0.0,M2019-07-01D,Race(10),,
10,11,12,5,28,6,10,7,23,5,9,9,23,22,31,21,74,2.8,3,0.0,M2019-07-01D,Race(10),,
11,0,0,0,0,0,0,0,0,0,0,0,0,0,0,0,0,151,151,0.0,M2019-07-01D,Race(10),,
12,2,5,3,10,2,3,6,11,0,4,5,9,4,12,14,30,7.5,7.5,0.0,M2019-07-01D,Race(10),,
13,0,0,0,0,0,0,0,0,0,0,0,0,0,0,0,0,51,51,0.0,M2019-07-01D,Race(10),,
14,0,0,0,0,8,0,0,8,0,1,0,1,8,1,0,9,51,51,0.0,M2019-07-01D,Race(10),,
1,4,3,3,10,8,3,5,16,7,6,7,20,19,12,15,46,10,10,0.0,M2019-07-01D,Race(2),,
2,2,0,2,4,0,0,1,1,0,0,1,1,2,0,4,6,21,21,0.0,M2019-07-01D,Race(2),,
3,11,4,5,20,9,7,3,19,11,6,4,21,31,17,12,60,3.5,3.5,0.0,M2019-07-01D,Race(2),,
4,4,9,4,17,1,5,4,10,2,4,3,9,7,18,11,36,6,6,3.0,M2019-07-01D,Race(2),,
5,0,0,0,0,0,0,0,0,0,0,0,0,0,0,0,0,71,67,0.0,M2019-07-01D,Race(2),,
6,3,2,3,8,2,1,2,5,0,1,1,2,5,4,6,15,12,12,0.0,M2019-07-01D,Race(2),,
7,0,0,0,0,0,0,0,0,1,0,1,2,1,0,1,2,15,15,0.0,M2019-07-01D,Race(2),,
8,0,2,0,2,0,8,0,8,0,1,1,2,0,11,1,12,18,18,0.0,M2019-07-01D,Race(2),,
9,3,0,10,13,1,4,2,7,2,7,1,10,6,11,13,30,9,9,2.0,M2019-07-01D,Race(2),,
10,0,0,0,0,0,0,0,0,0,0,0,0,0,0,0,0,71,71,0.0,M2019-07-01D,Race(2),,
11,0,0,0,0,8,0,0,8,1,0,0,1,9,0,0,9,15,15,0.0,M2019-07-01D,Race(2),,
12,0,0,0,0,0,0,2,2,1,0,3,4,1,0,5,6,21,21,0.0,M2019-07-01D,Race(2),,
13,3,10,3,16,1,2,3,6,1,1,3,5,5,13,9,27,6.5,6.5,1.0,M2019-07-01D,Race(2),,
14,0,0,0,0,0,0,8,8,0,0,1,1,0,0,9,9,15,15,0.0,M2019-07-01D,Race(2),,
1,3,18,4,25,3,12,6,21,4,11,6,21,10,41,16,67,5,5,1.0,M2019-07-01D,Race(3),,
2,23,5,2,30,17,4,2,23,19,4,3,26,59,13,7,79,2,2,2.0,M2019-07-01D,Race(3),,
3,0,0,0,0,1,0,0,1,0,0,1,1,1,0,1,2,26,26,0.0,M2019-07-01D,Race(3),,
4,0,0,0,0,0,0,0,0,0,0,0,0,0,0,0,0,101,101,0.0,M2019-07-01D,Race(3),,
5,0,0,0,0,0,0,0,0,0,0,0,0,0,0,0,0,151,151,0.0,M2019-07-01D,Race(3),,
6,0,0,0,0,0,0,0,0,0,1,0,1,0,1,0,1,61,61,0.0,M2019-07-01D,Race(3),,
7,2,0,6,8,0,2,8,10,2,3,7,12,4,5,21,30,8.5,8.5,0.0,M2019-07-01D,Race(3),,
8,0,0,0,0,0,0,0,0,0,0,1,1,0,0,1,1,101,101,0.0,M2019-07-01D,Race(3),,
9,0,3,5,8,1,0,10,11,0,0,5,5,1,3,20,24,8.5,8.5,0.0,M2019-07-01D,Race(3),,
10,2,2,13,17,0,4,4,8,0,6,2,8,2,12,19,33,7.5,7.5,3.0,M2019-07-01D,Race(3),,
11,0,2,0,2,0,8,0,8,0,1,1,2,0,11,1,12,21,21,0.0,M2019-07-01D,Race(3),,
12,0,0,0,0,0,0,0,0,0,0,0,0,0,0,0,0,151,151,0.0,M2019-07-01D,Race(3),,
13,0,0,0,0,0,0,0,0,0,0,0,0,0,0,0,0,101,101,0.0,M2019-07-01D,Race(3),,
14,0,0,0,0,8,0,0,8,1,0,0,1,9,0,0,9,16,16,0.0,M2019-07-01D,Race(3),,
1,5,7,3,15,5,8,1,14,3,10,5,18,13,25,9,47,6,6,1.0,M2019-07-01D,Race(4),,
2,5,4,12,21,6,3,5,14,7,4,5,16,18,11,22,51,5.5,5.5,0.0,M2019-07-01D,Race(4),,
3,0,5,4,9,1,0,2,3,1,0,5,6,2,5,11,18,13,13,0.0,M2019-07-01D,Race(4),,
4,11,8,6,25,8,7,5,20,11,6,5,22,30,21,16,67,5.5,5.5,0.0,M2019-07-01D,Race(4),,
5,0,0,2,2,8,0,2,10,1,1,1,3,9,1,5,15,16,16,3.0,M2019-07-01D,Race(4),,
6,2,0,0,2,0,0,2,2,0,1,0,1,2,1,2,5,11,11,0.0,M2019-07-01D,Race(4),,
7,0,0,0,0,0,0,0,0,0,0,0,0,0,0,0,0,13,13,0.0,M2019-07-01D,Race(4),,
8,2,6,0,8,2,9,3,14,0,0,1,1,4,15,4,23,7,7,0.0,M2019-07-01D,Race(4),,
9,0,0,0,0,0,0,0,0,0,0,1,1,0,0,1,1,151,151,0.0,M2019-07-01D,Race(4),,
10,0,0,3,3,0,0,2,2,1,1,1,3,1,1,6,8,15,15,0.0,M2019-07-01D,Race(4),,
11,0,0,0,0,0,0,0,0,0,0,0,0,0,0,0,0,31,31,0.0,M2019-07-01D,Race(4),,
12,2,0,0,2,0,3,8,11,1,2,2,5,3,5,10,18,13,13,0.0,M2019-07-01D,Race(4),,
13,0,0,0,0,0,0,0,0,0,0,0,0,0,0,0,0,151,151,0.0,M2019-07-01D,Race(4),,
14,3,0,0,3,0,0,0,0,1,1,0,2,4,1,0,5,9.5,9.5,2.0,M2019-07-01D,Race(4),,
1,0,7,2,9,2,5,4,11,3,4,2,9,5,16,8,29,10,10,0.0,M2019-07-01D,Race(5),,
2,0,0,5,5,0,3,2,5,0,1,1,2,0,4,8,12,21,21,0.0,M2019-07-01D,Race(5),,
3,23,2,2,27,18,2,3,23,17,6,2,25,58,10,7,75,2,2,3.0,M2019-07-01D,Race(5),,
4,2,8,8,18,8,7,7,22,3,7,9,19,13,22,24,59,6.5,6.5,2.0,M2019-07-01D,Race(5),,
5,0,0,2,2,0,0,8,8,0,0,2,2,0,0,12,12,26,26,0.0,M2019-07-01D,Race(5),,
6,0,0,0,0,2,2,0,4,0,1,1,2,2,3,1,6,34,35,0.0,M2019-07-01D,Race(5),,
7,0,0,0,0,0,0,0,0,0,0,0,0,0,0,0,0,81,81,0.0,M2019-07-01D,Race(5),,
8,0,0,0,0,0,0,0,0,0,0,0,0,0,0,0,0,71,67,0.0,M2019-07-01D,Race(5),,
9,0,2,0,2,0,0,0,0,0,0,0,0,0,2,0,2,18,18,0.0,M2019-07-01D,Race(5),,
10,0,0,0,0,0,0,0,0,0,0,2,2,0,0,2,2,18,18,0.0,M2019-07-01D,Race(5),,
11,0,6,5,11,0,8,4,12,0,4,6,10,0,18,15,33,12,12,0.0,M2019-07-01D,Race(5),,
12,5,5,6,16,2,2,0,4,3,3,1,7,10,10,7,27,5.5,5.5,1.0,M2019-07-01D,Race(5),,
13,0,0,0,0,0,0,0,0,0,0,0,0,0,0,0,0,151,151,0.0,M2019-07-01D,Race(5),,
1,0,0,2,2,0,0,0,0,0,0,0,0,0,0,2,2,16,16,0.0,M2019-07-01D,Race(6),,
2,0,8,8,16,1,10,6,17,2,7,9,18,3,25,23,51,8,8,2.0,M2019-07-01D,Race(6),,
3,0,0,2,2,0,0,0,0,0,0,0,0,0,0,2,2,41,41,0.0,M2019-07-01D,Race(6),,
4,0,0,2,2,0,2,2,4,0,2,2,4,0,4,6,10,34,34,0.0,M2019-07-01D,Race(6),,
5,0,0,0,0,0,0,0,0,0,1,0,1,0,1,0,1,51,51,0.0,M2019-07-01D,Race(6),,
6,3,0,0,3,0,0,0,0,1,0,1,2,4,0,1,5,19,19,0.0,M2019-07-01D,Race(6),,
7,0,5,13,18,0,2,6,8,0,4,4,8,0,11,23,34,9.5,9.5,0.0,M2019-07-01D,Race(6),,
8,27,0,0,27,21,2,0,23,19,3,2,24,67,5,2,74,2.1,2.1,1.0,M2019-07-01D,Race(6),,
9,0,0,0,0,0,0,0,0,0,0,0,0,0,0,0,0,51,51,0.0,M2019-07-01D,Race(6),,
10,0,2,3,5,0,0,8,8,0,0,0,0,0,2,11,13,13,13,0.0,M2019-07-01D,Race(6),,
11,0,0,0,0,0,0,0,0,1,0,0,1,1,0,0,1,15,15,0.0,M2019-07-01D,Race(6),,
12,0,0,0,0,0,8,3,11,1,3,2,6,1,11,5,17,16,16,3.0,M2019-07-01D,Race(6),,
13,0,15,0,15,8,6,3,17,2,6,5,13,10,27,8,45,8,8,0.0,M2019-07-01D,Race(6),,
14,0,0,0,0,0,0,2,2,0,0,1,1,0,0,3,3,31,31,0.0,M2019-07-01D,Race(6),,
1,0,0,0,0,0,0,0,0,0,0,0,0,0,0,0,0,41,41,0.0,M2019-07-01D,Race(7),,
2,0,0,0,0,0,0,1,1,1,0,0,1,1,0,1,2,26,26,0.0,M2019-07-01D,Race(7),,
3,0,2,5,7,9,5,4,18,1,3,5,9,10,10,14,34,14,14,3.0,M2019-07-01D,Race(7),,
4,0,0,8,8,0,2,4,6,2,1,5,8,2,3,17,22,19,19,0.0,M2019-07-01D,Race(7),,
5,5,23,2,30,7,9,5,21,10,11,3,24,22,43,10,75,2.5,2.5,0.0,M2019-07-01D,Race(7),,
6,0,0,0,0,0,0,0,0,0,0,0,0,0,0,0,0,81,81,0.0,M2019-07-01D,Race(7),,
7,25,5,0,30,14,6,3,23,12,11,1,24,51,22,4,77,2.2,2.2,0.0,M2019-07-01D,Race(7),,
8,0,0,4,4,0,0,0,0,0,0,0,0,0,0,4,4,14,14,0.0,M2019-07-01D,Race(7),,
9,0,0,8,8,0,0,4,4,0,0,10,10,0,0,22,22,21,21,0.0,M2019-07-01D,Race(7),,
10,0,0,0,0,0,0,8,8,0,0,0,0,0,0,8,8,34,34,1.0,M2019-07-01D,Race(7),,
11,0,0,3,3,0,8,0,8,0,0,2,2,0,8,5,13,34,34,2.0,M2019-07-01D,Race(7),,
12,0,0,0,0,0,0,1,1,0,0,0,0,0,0,1,1,71,67,0.0,M2019-07-01D,Race(7),,
13,0,0,0,0,0,0,0,0,0,0,0,0,0,0,0,0,81,81,0.0,M2019-07-01D,Race(7),,
14,0,0,0,0,0,0,0,0,0,0,0,0,0,0,0,0,51,51,0.0,M2019-07-01D,Race(7),,
1,0,3,0,3,0,0,1,1,0,0,1,1,0,3,2,5,21,21,0.0,M2019-07-01D,Race(8),,
2,8,6,5,19,9,2,8,19,2,1,12,15,19,9,25,53,8.5,8.5,0.0,M2019-07-01D,Race(8),,
3,0,0,0,0,0,0,0,0,0,0,0,0,0,0,0,0,17,17,0.0,M2019-07-01D,Race(8),,
4,0,2,3,5,0,1,2,3,1,1,2,4,1,4,7,12,16,16,0.0,M2019-07-01D,Race(8),,
5,0,0,3,3,0,8,0,8,1,0,0,1,1,8,3,12,18,18,0.0,M2019-07-01D,Race(8),,
6,0,0,0,0,0,0,0,0,0,1,0,1,0,1,0,1,101,101,0.0,M2019-07-01D,Race(8),,
7,0,7,15,22,6,8,5,19,8,10,4,22,14,25,24,63,6,6,0.0,M2019-07-01D,Race(8),,
8,0,0,0,0,0,0,0,0,0,0,0,0,0,0,0,0,101,101,0.0,M2019-07-01D,Race(8),,
9,0,0,0,0,0,0,0,0,0,0,0,0,0,0,0,0,31,31,0.0,M2019-07-01D,Race(8),,
10,22,6,2,30,15,6,0,21,12,9,0,21,49,21,2,72,1.8,1.85,1.0,M2019-07-01D,Race(8),,
11,0,0,0,0,0,0,0,0,0,0,0,0,0,0,0,0,151,201,0.0,M2019-07-01D,Race(8),,
12,0,0,0,0,0,2,8,10,1,1,1,3,1,3,9,13,12,12,2.0,M2019-07-01D,Race(8),,
13,0,6,2,8,0,3,6,9,1,3,6,10,1,12,14,27,13,13,3.0,M2019-07-01D,Race(8),,
14,0,0,0,0,0,0,0,0,0,0,0,0,0,0,0,0,101,101,0.0,M2019-07-01D,Race(8),,
1,11,0,13,24,7,4,7,18,8,7,4,19,26,11,24,61,6.5,6.5,0.0,M2019-07-01D,Race(9),,
2,0,0,0,0,0,0,0,0,0,0,0,0,0,0,0,0,31,31,0.0,M2019-07-01D,Race(9),,
3,9,14,0,23,5,12,3,20,8,9,3,20,22,35,6,63,3.7,3.7,1.0,M2019-07-01D,Race(9),,
4,8,3,5,16,4,2,4,10,6,3,8,17,18,8,17,43,5.5,5.5,3.0,M2019-07-01D,Race(9),,
5,0,2,0,2,9,1,1,11,1,0,0,1,10,3,1,14,11,11,0.0,M2019-07-01D,Race(9),,
6,2,4,2,8,0,8,0,8,0,1,0,1,2,13,2,17,10,10,0.0,M2019-07-01D,Race(9),,
7,0,0,0,0,0,0,1,1,0,1,1,2,0,1,2,3,26,26,0.0,M2019-07-01D,Race(9),,
8,0,0,0,0,0,0,0,0,0,0,0,0,0,0,0,0,51,51,0.0,M2019-07-01D,Race(9),,
9,0,0,2,2,0,1,2,3,0,1,3,4,0,2,7,9,9,9,0.0,M2019-07-01D,Race(9),,
10,0,0,0,0,0,0,8,8,0,0,0,0,0,0,8,8,81,81,0.0,M2019-07-01D,Race(9),,
11,0,0,0,0,0,0,0,0,0,0,0,0,0,0,0,0,26,26,0.0,M2019-07-01D,Race(9),,
12,0,5,5,10,5,2,4,11,3,4,6,13,8,11,15,34,11,11,2.0,M2019-07-01D,Race(9),,
13,0,0,0,0,0,0,0,0,0,0,1,1,0,0,1,1,51,51,0.0,M2019-07-01D,Race(9),,
14,0,2,3,5,0,0,0,0,0,0,0,0,0,2,3,5,8.5,8.5,0.0,M2019-07-01D,Race(9),,
1,0,0,0,0,0,0,0,0,0,0,0,0,0,0,0,0,34,34,0.0,M2019-07-03D,Race(1),,
2,5,4,2,11,4,13,4,21,9,4,3,16,18,21,9,48,9,9,0.0,M2019-07-03D,Race(1),,
3,11,3,8,22,16,8,2,26,8,8,1,17,35,19,11,65,3.8,3.8,0.0,M2019-07-03D,Race(1),,
4,4,5,0,9,0,1,1,2,0,1,3,4,4,7,4,15,6.5,6.5,1.0,M2019-07-03D,Race(1),,
5,0,0,0,0,0,0,0,0,1,0,0,1,1,0,0,1,34,34,2.0,M2019-07-03D,Race(1),,
6,0,0,0,0,0,1,1,2,0,0,2,2,0,1,3,4,34,34,0.0,M2019-07-03D,Race(1),,
7,0,5,0,5,3,0,2,5,3,0,1,4,6,5,3,14,10,10,0.0,M2019-07-03D,Race(1),,
8,6,4,11,21,3,2,2,7,2,4,4,10,11,10,17,38,5.5,5.5,3.0,M2019-07-03D,Race(1),,
9,4,9,6,19,4,5,16,25,3,6,11,20,11,20,33,64,5.5,5.5,0.0,M2019-07-03D,Race(1),,
10,0,0,3,3,0,0,2,2,0,2,0,2,0,2,5,7,10,10,0.0,M2019-07-03D,Race(1),,
11,0,0,0,0,0,0,0,0,0,0,1,1,0,0,1,1,15,15,0.0,M2019-07-03D,Race(1),,
12,0,0,0,0,0,0,0,0,0,1,0,1,0,1,0,1,34,34,0.0,M2019-07-03D,Race(1),,
1,0,0,2,2,0,3,3,6,1,3,3,7,1,6,8,15,17,17,0.0,M2019-07-03D,Race(2),,
2,4,8,14,26,3,4,17,24,2,3,12,17,9,15,43,67,4.6,4.6,3.0,M2019-07-03D,Race(2),,
3,0,0,0,0,0,0,0,0,0,0,0,0,0,0,0,0,51,51,0.0,M2019-07-03D,Race(2),,
4,16,6,0,22,19,4,4,27,15,4,2,21,50,14,6,70,3.6,3.6,2.0,M2019-07-03D,Race(2),,
5,0,0,0,0,0,0,0,0,0,1,1,2,0,1,1,2,21,21,0.0,M2019-07-03D,Race(2),,
6,2,0,0,2,0,0,0,0,0,1,1,2,2,1,1,4,34,34,0.0,M2019-07-03D,Race(2),,
7,0,2,7,9,0,2,2,4,1,3,1,5,1,7,10,18,6.5,6.5,0.0,M2019-07-03D,Race(2),,
8,8,14,5,27,8,16,4,28,7,10,6,23,23,40,15,78,3,3,1.0,M2019-07-03D,Race(2),,
9,0,0,2,2,0,0,0,0,0,1,0,1,0,1,2,3,16,16,0.0,M2019-07-03D,Race(2),,
10,0,0,0,0,0,1,0,1,0,0,0,0,0,1,0,1,26,26,0.0,M2019-07-03D,Race(2),,
11,0,0,0,0,0,0,0,0,0,0,0,0,0,0,0,0,51,51,0.0,M2019-07-03D,Race(2),,
12,0,0,0,0,0,0,0,0,0,0,0,0,0,0,0,0,51,51,0.0,M2019-07-03D,Race(2),,
1,10,3,8,21,2,2,5,9,6,4,7,17,18,9,20,47,5,5,0.0,M2019-07-03D,Race(3),,
2,3,0,0,3,0,1,0,1,0,0,0,0,3,1,0,4,26,26,0.0,M2019-07-03D,Race(3),,
3,0,2,5,7,0,1,0,1,0,2,1,3,0,5,6,11,15,15,0.0,M2019-07-03D,Race(3),,
4,0,0,0,0,0,0,0,0,0,0,0,0,0,0,0,0,31,31,0.0,M2019-07-03D,Race(3),,
5,7,7,2,16,5,12,4,21,7,4,3,14,19,23,9,51,5,5,0.0,M2019-07-03D,Race(3),,
6,0,0,0,0,0,0,0,0,0,1,1,2,0,1,1,2,31,31,0.0,M2019-07-03D,Race(3),,
7,2,0,2,4,1,0,1,2,1,0,1,2,4,0,4,8,12,12,2.0,M2019-07-03D,Race(3),,
8,3,5,3,11,5,5,14,24,5,5,6,16,13,15,23,51,7,7,3.0,M2019-07-03D,Race(3),,
9,2,13,0,15,16,6,3,25,6,6,5,17,24,25,8,57,4.8,4.8,1.0,M2019-07-03D,Race(3),,
10,3,0,10,13,1,3,3,7,1,4,2,7,5,7,15,27,4.8,4.8,0.0,M2019-07-03D,Race(3),,
11,0,0,0,0,0,0,0,0,0,0,0,0,0,0,0,0,51,51,0.0,M2019-07-03D,Race(3),,
12,0,0,0,0,0,0,0,0,0,0,0,0,0,0,0,0,21,21,0.0,M2019-07-03D,Race(3),,
1,0,11,10,21,2,6,6,14,0,7,2,9,2,24,18,44,5,5,3.0,M2019-07-03D,Race(4),,
2,21,9,0,30,25,4,0,29,25,1,0,26,71,14,0,85,2.5,2.5,1.0,M2019-07-03D,Race(4),,
3,5,3,13,21,0,14,5,19,0,8,8,16,5,25,26,56,7.5,7.5,0.0,M2019-07-03D,Race(4),,
4,0,0,0,0,0,0,0,0,0,1,0,1,0,1,0,1,34,34,0.0,M2019-07-03D,Race(4),,
5,0,0,0,0,0,1,0,1,0,0,1,1,0,1,1,2,19,19,0.0,M2019-07-03D,Race(4),,
6,2,2,0,4,1,0,3,4,0,1,1,2,3,3,4,10,12,12,2.0,M2019-07-03D,Race(4),,
7,0,2,5,7,2,2,14,18,1,7,10,18,3,11,29,43,5.5,5.5,0.0,M2019-07-03D,Race(4),,
8,0,3,2,5,0,0,0,0,0,0,1,1,0,3,3,6,18,18,0.0,M2019-07-03D,Race(4),,
9,0,0,0,0,0,0,0,0,0,0,0,0,0,0,0,0,101,101,0.0,M2019-07-03D,Race(4),,
10,0,0,0,0,0,0,0,0,0,0,0,0,0,0,0,0,61,61,0.0,M2019-07-03D,Race(4),,
11,2,0,0,2,0,3,2,5,0,1,1,2,2,4,3,9,13,13,0.0,M2019-07-03D,Race(4),,
12,0,0,0,0,0,0,0,0,0,0,2,2,0,0,2,2,26,26,0.0,M2019-07-03D,Race(4),,
1,0,2,0,2,3,1,1,5,4,0,0,4,7,3,1,11,21,21,0.0,M2019-07-03D,Race(5),,
2,0,6,6,12,3,2,4,9,6,3,3,12,9,11,13,33,9.5,9.5,0.0,M2019-07-03D,Race(5),,
3,0,2,2,4,1,4,0,5,1,3,0,4,2,9,2,13,8,8,0.0,M2019-07-03D,Race(5),,
4,0,0,11,11,2,0,12,14,5,2,2,9,7,2,25,34,10,10,0.0,M2019-07-03D,Race(5),,
5,2,2,0,4,0,0,4,4,0,0,6,6,2,2,10,14,21,21,0.0,M2019-07-03D,Race(5),,
6,3,0,0,3,0,0,0,0,0,0,0,0,3,0,0,3,16,16,0.0,M2019-07-03D,Race(5),,
7,2,3,0,5,0,0,1,1,1,2,0,3,3,5,1,9,11,11,2.0,M2019-07-03D,Race(5),,
8,0,0,0,0,0,0,0,0,0,0,0,0,0,0,0,0,21,21,0.0,M2019-07-03D,Race(5),,
9,17,0,5,22,17,5,6,28,8,6,6,20,42,11,17,70,2.7,2.7,1.0,M2019-07-03D,Race(5),,
10,6,2,6,14,4,15,2,21,0,8,5,13,10,25,13,48,6,6,3.0,M2019-07-03D,Race(5),,
11,0,0,0,0,0,0,0,0,0,0,0,0,0,0,0,0,101,101,0.0,M2019-07-03D,Race(5),,
12,0,13,0,13,0,3,0,3,1,2,4,7,1,18,4,23,9.5,9.5,0.0,M2019-07-03D,Race(5),,
1,0,5,10,15,0,2,2,4,2,0,1,3,2,7,13,22,8.5,8.5,0.0,M2019-07-03D,Race(6),,
2,0,0,0,0,0,0,0,0,0,0,0,0,0,0,0,0,13,13,0.0,M2019-07-03D,Race(6),,
3,0,2,3,5,0,2,0,2,0,0,0,0,0,4,3,7,10,10,0.0,M2019-07-03D,Race(6),,
4,0,0,0,0,0,0,1,1,0,0,0,0,0,0,1,1,14,14,0.0,M2019-07-03D,Race(6),,
5,6,5,2,13,5,4,14,23,6,7,4,17,17,16,20,53,5,5,1.0,M2019-07-03D,Race(6),,
6,0,0,0,0,0,0,0,0,0,0,0,0,0,0,0,0,51,51,0.0,M2019-07-03D,Race(6),,
7,0,2,0,2,0,0,0,0,1,0,0,1,1,2,0,3,31,31,0.0,M2019-07-03D,Race(6),,
8,0,0,0,0,0,0,0,0,0,1,0,1,0,1,0,1,71,67,0.0,M2019-07-03D,Race(6),,
9,10,3,7,20,4,13,2,19,7,5,4,16,21,21,13,55,6.5,6.5,0.0,M2019-07-03D,Race(6),,
10,10,9,2,21,15,5,5,25,4,7,7,18,29,21,14,64,3.8,3.8,3.0,M2019-07-03D,Race(6),,
11,4,4,6,14,3,3,2,8,2,4,4,10,9,11,12,32,5.5,5.5,2.0,M2019-07-03D,Race(6),,
12,0,0,0,0,0,0,1,1,0,0,1,1,0,0,2,2,21,21,0.0,M2019-07-03D,Race(6),,
1,3,0,2,5,3,2,3,8,2,1,2,5,8,3,7,18,17,17,0.0,M2019-07-03D,Race(7),,
2,0,2,2,4,0,1,1,2,0,0,1,1,0,3,4,7,17,17,0.0,M2019-07-03D,Race(7),,
3,0,0,0,0,1,0,11,12,0,1,6,7,1,1,17,19,13,13,0.0,M2019-07-03D,Race(7),,
4,0,3,0,3,0,2,0,2,1,2,0,3,1,7,0,8,17,17,3.0,M2019-07-03D,Race(7),,
5,2,2,0,4,1,1,1,3,2,1,2,5,5,4,3,12,11,11,1.0,M2019-07-03D,Race(7),,
6,2,4,8,14,6,12,3,21,4,7,4,15,12,23,15,50,5.5,5.5,2.0,M2019-07-03D,Race(7),,
7,5,0,0,5,0,0,1,1,0,1,1,2,5,1,2,8,17,17,0.0,M2019-07-03D,Race(7),,
8,3,0,4,7,3,3,2,8,1,3,2,6,7,6,8,21,12,12,0.0,M2019-07-03D,Race(7),,
9,0,0,0,0,0,1,0,1,0,1,0,1,0,2,0,2,81,81,0.0,M2019-07-03D,Race(7),,
10,8,5,0,13,0,0,2,2,0,1,2,3,8,6,4,18,7,7,0.0,M2019-07-03D,Race(7),,
11,5,14,2,21,16,6,4,26,14,7,2,23,35,27,8,70,3.2,3.2,0.0,M2019-07-03D,Race(7),,
12,2,0,12,14,0,2,2,4,2,1,4,7,4,3,18,25,7,7,0.0,M2019-07-03D,Race(7),,
1,0,6,2,8,1,4,1,6,0,3,1,4,1,13,4,18,19,19,0.0,M2019-07-03D,Race(8),,
2,0,2,6,8,1,1,1,3,0,4,1,5,1,7,8,16,21,21,0.0,M2019-07-03D,Race(8),,
3,2,2,2,6,0,0,2,2,2,0,1,3,4,2,5,11,19,19,0.0,M2019-07-03D,Race(8),,
4,0,2,0,2,1,0,0,1,1,0,0,1,2,2,0,4,14,14,0.0,M2019-07-03D,Race(8),,
5,3,2,3,8,0,1,0,1,0,2,0,2,3,5,3,11,10,10,0.0,M2019-07-03D,Race(8),,
6,14,7,5,26,18,7,1,26,16,7,1,24,48,21,7,76,5,5,3.0,M2019-07-03D,Race(8),,
7,0,0,0,0,0,2,1,3,0,0,2,2,0,2,3,5,9,9,2.0,M2019-07-03D,Race(8),,
8,4,0,2,6,4,1,16,21,3,4,9,16,11,5,27,43,9,9,1.0,M2019-07-03D,Race(8),,
9,0,0,0,0,0,1,0,1,0,0,0,0,0,1,0,1,81,81,0.0,M2019-07-03D,Race(8),,
10,5,9,2,16,3,11,5,19,2,5,9,16,10,25,16,51,4.4,4.4,0.0,M2019-07-03D,Race(8),,
11,0,0,5,5,0,0,1,1,1,0,1,2,1,0,7,8,6,6,0.0,M2019-07-03D,Race(8),,
12,2,0,3,5,2,2,2,6,1,1,1,3,5,3,6,14,8,8,0.0,M2019-07-03D,Race(8),,
1,10,8,12,30,13,4,4,21,11,5,5,21,34,17,21,72,3.2,3.2,1.0,M2019-07-07D,Race(1),,
2,0,0,0,0,0,0,0,0,0,0,0,0,0,0,0,0,71,67,0.0,M2019-07-07D,Race(1),,
3,0,0,3,3,0,0,0,0,0,0,0,0,0,0,3,3,19,19,3.0,M2019-07-07D,Race(1),,
4,0,0,0,0,0,0,0,0,0,0,1,1,0,0,1,1,19,19,0.0,M2019-07-07D,Race(1),,
5,0,6,2,8,11,9,7,27,4,10,5,19,15,25,14,54,4.8,4.8,0.0,M2019-07-07D,Race(1),,
6,17,8,2,27,4,6,7,17,7,8,8,23,28,22,17,67,2.4,2.4,2.0,M2019-07-07D,Race(1),,
7,0,0,0,0,0,2,9,11,0,0,3,3,0,2,12,14,15,15,0.0,M2019-07-07D,Race(1),,
8,0,2,0,2,0,0,0,0,0,0,0,0,0,2,0,2,34,34,0.0,M2019-07-07D,Race(1),,
9,3,6,11,20,2,9,3,14,4,3,4,11,9,18,18,45,7.5,7.5,0.0,M2019-07-07D,Race(1),,
1,3,0,2,5,8,0,2,10,0,0,1,1,11,0,5,16,15,15,0.0,M2019-07-07D,Race(10),,
2,2,8,3,13,2,8,7,17,1,4,8,13,5,20,18,43,6.5,6.5,0.0,M2019-07-07D,Race(10),,
3,0,3,6,9,8,3,3,14,8,6,3,17,16,12,12,40,6.5,6.5,3.0,M2019-07-07D,Race(10),,
4,2,0,2,4,2,0,0,2,1,2,0,3,5,2,2,9,10,10,0.0,M2019-07-07D,Race(10),,
5,3,4,11,18,2,8,3,13,2,3,7,12,7,15,21,43,7,7,2.0,M2019-07-07D,Race(10),,
6,18,3,2,23,7,9,4,20,12,10,2,24,37,22,8,67,3.4,3.4,1.0,M2019-07-07D,Race(10),,
7,2,0,0,2,0,0,0,0,0,0,0,0,2,0,0,2,13,13,0.0,M2019-07-07D,Race(10),,
8,0,7,4,11,1,0,8,9,1,1,0,2,2,8,12,22,7.5,7.5,0.0,M2019-07-07D,Race(10),,
9,0,0,0,0,0,0,0,0,0,0,0,0,0,0,0,0,51,51,0.0,M2019-07-07D,Race(10),,
10,0,0,0,0,0,0,0,0,0,0,1,1,0,0,1,1,151,151,0.0,M2019-07-07D,Race(10),,
11,0,0,0,0,0,0,0,0,0,0,0,0,0,0,0,0,41,41,0.0,M2019-07-07D,Race(10),,
12,0,5,0,5,0,2,3,5,1,0,4,5,1,7,7,15,9.5,9.5,0.0,M2019-07-07D,Race(10),,
1,2,0,3,5,9,3,2,14,2,3,2,7,13,6,7,26,10,10,0.0,M2019-07-07D,Race(11),,
2,0,0,0,0,0,0,0,0,0,0,0,0,0,0,0,0,34,34,1.0,M2019-07-07D,Race(11),,
3,0,0,0,0,0,0,2,2,1,0,3,4,1,0,5,6,34,34,0.0,M2019-07-07D,Race(11),,
4,15,5,10,30,14,3,5,22,19,4,1,24,48,12,16,76,3,3,0.0,M2019-07-07D,Race(11),,
5,2,0,0,2,0,2,0,2,0,0,1,1,2,2,1,5,11,11,0.0,M2019-07-07D,Race(11),,
6,3,2,0,5,0,8,2,10,0,3,3,6,3,13,5,21,13,13,0.0,M2019-07-07D,Race(11),,
7,6,17,4,27,5,6,5,16,2,11,5,18,13,34,14,61,6,6,0.0,M2019-07-07D,Race(11),,
8,0,3,2,5,0,0,0,0,0,0,0,0,0,3,2,5,11,11,0.0,M2019-07-07D,Race(11),,
9,0,0,0,0,0,0,0,0,0,0,0,0,0,0,0,0,101,101,0.0,M2019-07-07D,Race(11),,
10,2,3,11,16,2,6,5,13,2,3,8,13,6,12,24,42,5.5,5.5,0.0,M2019-07-07D,Race(11),,
11,0,0,0,0,0,2,9,11,0,2,3,5,0,4,12,16,11,11,3.0,M2019-07-07D,Race(11),,
12,0,0,0,0,0,0,0,0,0,0,0,0,0,0,0,0,31,31,2.0,M2019-07-07D,Race(11),,
13,0,0,0,0,0,0,0,0,0,0,0,0,0,0,0,0,31,31,0.0,M2019-07-07D,Race(11),,
14,0,0,0,0,0,0,0,0,0,0,0,0,0,0,0,0,41,41,0.0,M2019-07-07D,Race(11),,
1,5,2,5,12,1,2,3,6,2,4,5,11,8,8,13,29,6.5,6.5,3.0,M2019-07-07D,Race(2),,
2,6,0,0,6,1,1,0,2,0,0,1,1,7,1,1,9,8.5,8.5,0.0,M2019-07-07D,Race(2),,
3,8,16,2,26,12,6,3,21,10,8,4,22,30,30,9,69,2.7,2.8,2.0,M2019-07-07D,Race(2),,
4,0,0,10,10,2,4,4,10,3,5,5,13,5,9,19,33,7,7,1.0,M2019-07-07D,Race(2),,
5,0,0,0,0,0,8,1,9,0,0,0,0,0,8,1,9,41,41,0.0,M2019-07-07D,Race(2),,
6,0,0,2,2,0,0,1,1,0,0,0,0,0,0,3,3,21,21,0.0,M2019-07-07D,Race(2),,
7,0,0,2,2,0,0,0,0,0,0,0,0,0,0,2,2,17,17,0.0,M2019-07-07D,Race(2),,
8,0,0,0,0,0,0,0,0,0,0,0,0,0,0,0,0,71,67,0.0,M2019-07-07D,Race(2),,
9,7,10,3,20,6,5,8,19,7,3,5,15,20,18,16,54,5,5,0.0,M2019-07-07D,Race(2),,
10,2,2,0,4,0,0,8,8,0,2,0,2,2,4,8,14,21,21,0.0,M2019-07-07D,Race(2),,
11,2,0,6,8,8,2,2,12,3,4,4,11,13,6,12,31,9.5,9.5,0.0,M2019-07-07D,Race(2),,
12,0,0,0,0,0,0,0,0,0,0,1,1,0,0,1,1,71,67,0.0,M2019-07-07D,Race(2),,
1,0,3,0,3,2,1,1,4,2,0,1,3,4,4,2,10,9,9,0.0,M2019-07-07D,Race(3),,
2,10,8,4,22,0,5,5,10,1,6,5,12,11,19,14,44,5.5,5.5,2.0,M2019-07-07D,Race(3),,
3,0,2,0,2,0,0,8,8,1,0,0,1,1,2,8,11,15,15,0.0,M2019-07-07D,Race(3),,
4,12,7,8,27,15,3,3,21,14,8,3,25,41,18,14,73,3,3,3.0,M2019-07-07D,Race(3),,
5,2,0,0,2,0,0,0,0,0,0,0,0,2,0,0,2,19,19,0.0,M2019-07-07D,Race(3),,
6,4,5,3,12,0,1,2,3,0,4,5,9,4,10,10,24,9,9,0.0,M2019-07-07D,Race(3),,
7,0,2,3,5,2,8,5,15,2,2,8,12,4,12,16,32,11,11,0.0,M2019-07-07D,Race(3),,
8,2,0,6,8,3,2,3,8,3,3,2,8,8,5,11,24,14,14,0.0,M2019-07-07D,Race(3),,
9,0,0,0,0,8,0,0,8,0,0,0,0,8,0,0,8,26,26,0.0,M2019-07-07D,Race(3),,
10,0,0,0,0,0,0,0,0,0,0,0,0,0,0,0,0,51,51,0.0,M2019-07-07D,Race(3),,
11,0,0,6,6,0,8,0,8,2,2,0,4,2,10,6,18,8,8,1.0,M2019-07-07D,Race(3),,
12,0,0,0,0,0,0,0,0,0,0,0,0,0,0,0,0,71,67,0.0,M2019-07-07D,Race(3),,
13,0,3,0,3,0,0,3,3,1,1,2,4,1,4,5,10,19,19,0.0,M2019-07-07D,Race(3),,
14,0,0,0,0,0,0,0,0,0,0,0,0,0,0,0,0,71,67,0.0,M2019-07-07D,Race(3),,
1,0,3,0,3,0,0,0,0,0,0,0,0,0,3,0,3,26,26,0.0,M2019-07-07D,Race(4),,
2,0,0,0,0,0,0,0,0,0,1,0,1,0,1,0,1,101,101,0.0,M2019-07-07D,Race(4),,
3,6,8,3,17,14,5,2,21,14,6,4,24,34,19,9,62,5.5,5.5,0.0,M2019-07-07D,Race(4),,
4,3,2,6,11,0,9,0,9,1,2,3,6,4,13,9,26,6.5,6.5,1.0,M2019-07-07D,Race(4),,
5,0,5,6,11,1,5,5,11,0,7,4,11,1,17,15,33,5,5,0.0,M2019-07-07D,Race(4),,
6,3,2,5,10,1,3,7,11,2,3,5,10,6,8,17,31,6,6,0.0,M2019-07-07D,Race(4),,
7,10,6,7,23,4,5,5,14,7,4,4,15,21,15,16,52,7.5,7.5,2.0,M2019-07-07D,Race(4),,
8,0,0,0,0,8,0,0,8,1,0,1,2,9,0,1,10,26,26,0.0,M2019-07-07D,Race(4),,
9,2,0,0,2,1,0,8,9,0,1,1,2,3,1,9,13,11,11,0.0,M2019-07-07D,Race(4),,
10,6,4,3,13,1,3,3,7,1,2,4,7,8,9,10,27,5,5,3.0,M2019-07-07D,Race(4),,
11,0,0,0,0,0,0,0,0,0,0,0,0,0,0,0,0,17,17,0.0,M2019-07-07D,Race(4),,
12,0,0,0,0,0,0,0,0,0,0,0,0,0,0,0,0,101,101,0.0,M2019-07-07D,Race(4),,
1,0,2,0,2,0,0,0,0,0,0,0,0,0,2,0,2,41,41,0.0,M2019-07-07D,Race(5),,
2,0,0,0,0,0,0,0,0,0,0,0,0,0,0,0,0,51,51,0.0,M2019-07-07D,Race(5),,
3,0,0,0,0,0,8,0,8,0,0,1,1,0,8,1,9,34,34,0.0,M2019-07-07D,Race(5),,
4,0,9,5,14,1,4,3,8,1,5,5,11,2,18,13,33,8.5,8.5,0.0,M2019-07-07D,Race(5),,
5,12,6,0,18,6,5,5,16,12,3,5,20,30,14,10,54,2.7,2.7,1.0,M2019-07-07D,Race(5),,
6,0,0,0,0,1,1,0,2,0,1,1,2,1,2,1,4,21,21,0.0,M2019-07-07D,Race(5),,
7,0,3,7,10,1,1,3,5,1,0,4,5,2,4,14,20,9,9,2.0,M2019-07-07D,Race(5),,
8,0,3,11,14,0,3,1,4,0,4,2,6,0,10,14,24,5.5,5.5,0.0,M2019-07-07D,Race(5),,
9,11,7,3,21,11,5,5,21,11,9,3,23,33,21,11,65,6.5,6.5,3.0,M2019-07-07D,Race(5),,
10,7,0,2,9,2,2,4,8,1,2,2,5,10,4,8,22,8,8,0.0,M2019-07-07D,Race(5),,
11,0,0,2,2,0,0,8,8,0,1,2,3,0,1,12,13,11,11,0.0,M2019-07-07D,Race(5),,
12,0,0,0,0,0,0,0,0,0,0,0,0,0,0,0,0,101,101,0.0,M2019-07-07D,Race(5),,
1,0,2,0,2,0,2,2,4,0,2,4,6,0,6,6,12,12,12,0.0,M2019-07-07D,Race(6),,
2,2,2,0,4,0,9,1,10,3,1,1,5,5,12,2,19,8.5,9,1.0,M2019-07-07D,Race(6),,
3,0,3,0,3,0,0,0,0,0,0,0,0,0,3,0,3,15,15,0.0,M2019-07-07D,Race(6),,
4,2,5,8,15,9,7,2,18,9,8,3,20,20,20,13,53,8,8,0.0,M2019-07-07D,Race(6),,
5,0,0,0,0,0,0,0,0,0,0,1,1,0,0,1,1,51,51,0.0,M2019-07-07D,Race(6),,
6,14,0,6,20,12,4,5,21,9,9,6,24,35,13,17,65,3.4,3.4,0.0,M2019-07-07D,Race(6),,
7,0,0,2,2,0,0,0,0,0,0,0,0,0,0,2,2,19,19,0.0,M2019-07-07D,Race(6),,
8,0,3,2,5,0,0,8,8,0,0,1,1,0,3,11,14,9.5,9.5,0.0,M2019-07-07D,Race(6),,
9,0,0,0,0,0,0,0,0,0,0,0,0,0,0,0,0,151,151,0.0,M2019-07-07D,Race(6),,
10,9,5,5,19,1,7,8,16,2,4,6,12,12,16,19,47,4,4,2.0,M2019-07-07D,Race(6),,
11,3,10,7,20,8,1,4,13,3,2,4,9,14,13,15,42,8.5,8.5,3.0,M2019-07-07D,Race(6),,
12,0,0,0,0,0,0,0,0,0,0,0,0,0,0,0,0,41,41,0.0,M2019-07-07D,Race(6),,
13,0,0,0,0,0,0,0,0,0,0,0,0,0,0,0,0,151,151,0.0,M2019-07-07D,Race(6),,
14,0,0,0,0,0,0,0,0,0,0,0,0,0,0,0,0,71,0,0.0,M2019-07-07D,Race(6),,
1,0,0,2,2,0,0,0,0,0,0,0,0,0,0,2,2,34,34,0.0,M2019-07-07D,Race(7),,
2,2,15,10,27,10,6,4,20,11,8,3,22,23,29,17,69,3.8,3.8,3.0,M2019-07-07D,Race(7),,
3,15,2,13,30,9,9,2,20,13,8,1,22,37,19,16,72,2.6,2.6,1.0,M2019-07-07D,Race(7),,
4,0,0,0,0,0,0,0,0,0,0,1,1,0,0,1,1,71,67,0.0,M2019-07-07D,Race(7),,
5,0,0,0,0,0,0,8,8,0,0,1,1,0,0,9,9,71,67,0.0,M2019-07-07D,Race(7),,
6,0,0,0,0,0,0,0,0,0,1,0,1,0,1,0,1,151,151,0.0,M2019-07-07D,Race(7),,
7,0,0,0,0,0,0,0,0,0,0,0,0,0,0,0,0,26,26,0.0,M2019-07-07D,Race(7),,
8,0,3,5,8,4,8,6,18,2,0,4,6,6,11,15,32,9,9,0.0,M2019-07-07D,Race(7),,
9,0,0,0,0,0,0,0,0,0,0,0,0,0,0,0,0,126,126,0.0,M2019-07-07D,Race(7),,
10,3,3,0,6,0,0,4,4,0,1,6,7,3,4,10,17,11,11,0.0,M2019-07-07D,Race(7),,
11,5,3,0,8,0,4,4,8,0,3,7,10,5,10,11,26,6.5,6.5,0.0,M2019-07-07D,Race(7),,
12,0,0,0,0,0,0,0,0,0,0,0,0,0,0,0,0,71,67,0.0,M2019-07-07D,Race(7),,
13,5,4,0,9,7,3,2,12,0,5,3,8,12,12,5,29,10,10,2.0,M2019-07-07D,Race(7),,
14,0,0,0,0,0,0,0,0,0,0,0,0,0,0,0,0,21,21,0.0,M2019-07-07D,Race(7),,
1,0,0,0,0,0,0,0,0,0,0,0,0,0,0,0,0,26,26,0.0,M2019-07-07D,Race(8),,
2,7,15,6,28,4,8,8,20,6,13,6,25,17,36,20,73,8,6.5,0.0,M2019-07-07D,Race(8),,
3,7,15,8,30,4,9,5,18,2,3,9,14,13,27,22,62,4.2,4.4,2.0,M2019-07-07D,Race(8),,
4,0,0,4,4,10,3,2,15,3,3,1,7,13,6,7,26,11,12,0.0,M2019-07-07D,Race(8),,
5,0,0,0,0,0,0,0,0,0,0,1,1,0,0,1,1,34,26,3.0,M2019-07-07D,Race(8),,
6,0,0,0,0,0,0,0,0,0,0,0,0,0,0,0,0,31,34,0.0,M2019-07-07D,Race(8),,
7,0,0,0,0,0,0,0,0,0,0,0,0,0,0,0,0,26,26,0.0,M2019-07-07D,Race(8),,
8,0,0,2,2,0,0,2,2,0,1,4,5,0,1,8,9,31,34,0.0,M2019-07-07D,Race(8),,
9,0,0,0,0,0,8,0,8,0,0,0,0,0,8,0,8,61,67,0.0,M2019-07-07D,Race(8),,
10,0,0,3,3,0,1,8,9,0,3,2,5,0,4,13,17,20,21,0.0,M2019-07-07D,Race(8),,
11,0,0,0,0,0,0,0,0,0,0,0,0,0,0,0,0,91,101,0.0,M2019-07-07D,Race(8),,
12,0,0,2,2,0,0,0,0,0,0,2,2,0,0,4,4,18,19,0.0,M2019-07-07D,Race(8),,
13,16,0,5,21,12,1,5,18,15,3,1,19,43,4,11,58,1.75,2,1.0,M2019-07-07D,Race(8),,
14,0,0,0,0,0,0,0,0,0,0,0,0,0,0,0,0,51,51,0.0,M2019-07-07D,Race(8),,
1,9,0,6,15,7,4,8,19,5,7,5,17,21,11,19,51,6,6,1.0,M2019-07-07D,Race(9),,
2,3,3,0,6,0,0,1,1,1,0,1,2,4,3,2,9,21,21,0.0,M2019-07-07D,Race(9),,
3,0,0,2,2,0,1,3,4,0,2,3,5,0,3,8,11,9.5,9.5,0.0,M2019-07-07D,Race(9),,
4,12,12,3,27,12,7,3,22,16,4,3,23,40,23,9,72,2.4,2.4,0.0,M2019-07-07D,Race(9),,
5,3,3,2,8,8,1,2,11,2,1,0,3,13,5,4,22,8,8,2.0,M2019-07-07D,Race(9),,
6,0,2,13,15,0,4,2,6,0,4,6,10,0,10,21,31,7,7,0.0,M2019-07-07D,Race(9),,
7,0,0,0,0,0,0,0,0,0,0,0,0,0,0,0,0,101,101,0.0,M2019-07-07D,Race(9),,
8,0,3,0,3,0,0,3,3,0,1,3,4,0,4,6,10,26,26,0.0,M2019-07-07D,Race(9),,
9,0,0,0,0,0,0,0,0,0,0,0,0,0,0,0,0,21,21,0.0,M2019-07-07D,Race(9),,
10,0,0,2,2,0,0,0,0,0,1,0,1,0,1,2,3,26,26,3.0,M2019-07-07D,Race(9),,
11,3,5,0,8,3,5,8,16,2,5,5,12,8,15,13,36,11,11,0.0,M2019-07-07D,Race(9),,
12,0,2,2,4,0,8,0,8,0,1,0,1,0,11,2,13,21,21,0.0,M2019-07-07D,Race(9),,
1,13,8,9,30,18,9,1,28,14,7,1,22,45,24,11,80,3.4,3.4,3.0,M2019-07-10D,Race(1),,
2,2,0,0,2,0,0,1,1,1,0,1,2,3,0,2,5,17,17,2.0,M2019-07-10D,Race(1),,
3,0,3,4,7,1,1,4,6,1,1,2,4,2,5,10,17,14,14,0.0,M2019-07-10D,Race(1),,
4,9,4,3,16,7,13,5,25,6,6,5,17,22,23,13,58,3.4,3.4,1.0,M2019-07-10D,Race(1),,
5,0,7,2,9,2,4,13,19,4,7,4,15,6,18,19,43,7,7,0.0,M2019-07-10D,Race(1),,
6,0,0,0,0,0,0,0,0,0,0,0,0,0,0,0,0,81,81,0.0,M2019-07-10D,Race(1),,
7,2,3,3,8,1,0,1,2,0,1,5,6,3,4,9,16,8.5,8.5,0.0,M2019-07-10D,Race(1),,
8,0,0,0,0,0,0,1,1,0,0,3,3,0,0,4,4,31,31,0.0,M2019-07-10D,Race(1),,
9,2,0,3,5,1,3,3,7,0,4,3,7,3,7,9,19,8.5,8.5,0.0,M2019-07-10D,Race(1),,
10,0,5,3,8,0,0,1,1,0,0,2,2,0,5,6,11,16,16,0.0,M2019-07-10D,Race(1),,
11,2,0,3,5,0,0,0,0,0,0,0,0,2,0,3,5,17,17,0.0,M2019-07-10D,Race(1),,
12,0,0,0,0,0,0,0,0,0,0,0,0,0,0,0,0,71,67,0.0,M2019-07-10D,Race(1),,
1,4,8,3,15,2,3,3,8,3,7,1,11,9,18,7,34,5,5,3.0,M2019-07-10D,Race(2),,
2,0,10,10,20,6,14,4,24,2,7,9,18,8,31,23,62,5,5,0.0,M2019-07-10D,Race(2),,
3,4,0,0,4,0,3,0,3,2,4,0,6,6,7,0,13,19,19,0.0,M2019-07-10D,Race(2),,
4,3,0,9,12,0,3,1,4,0,2,0,2,3,5,10,18,5.5,5.5,1.0,M2019-07-10D,Race(2),,
5,0,0,0,0,0,0,0,0,0,0,0,0,0,0,0,0,31,31,0.0,M2019-07-10D,Race(2),,
6,3,4,2,9,2,1,12,15,2,1,7,10,7,6,21,34,10,10,2.0,M2019-07-10D,Race(2),,
7,0,0,3,3,0,2,0,2,1,1,0,2,1,3,3,7,17,17,0.0,M2019-07-10D,Race(2),,
8,0,0,0,0,0,1,3,4,0,1,1,2,0,2,4,6,34,34,0.0,M2019-07-10D,Race(2),,
9,0,0,0,0,0,0,0,0,0,0,0,0,0,0,0,0,41,41,0.0,M2019-07-10D,Race(2),,
10,13,8,3,24,20,3,6,29,16,3,4,23,49,14,13,76,3.2,3.2,0.0,M2019-07-10D,Race(2),,
11,0,0,0,0,0,0,0,0,0,0,1,1,0,0,1,1,51,51,0.0,M2019-07-10D,Race(2),,
12,3,0,0,3,0,0,1,1,0,0,3,3,3,0,4,7,15,15,0.0,M2019-07-10D,Race(2),,
1,5,2,7,14,14,4,4,22,5,8,2,15,24,14,13,51,6.5,6.5,2.0,M2019-07-10D,Race(3),,
2,3,7,2,12,1,4,2,7,1,2,3,6,5,13,7,25,4.4,4.4,3.0,M2019-07-10D,Race(3),,
3,8,0,3,11,5,2,10,17,10,5,3,18,23,7,16,46,7.5,7.5,0.0,M2019-07-10D,Race(3),,
4,0,8,7,15,2,3,3,8,2,3,5,10,4,14,15,33,7,7,0.0,M2019-07-10D,Race(3),,
5,0,0,0,0,0,0,0,0,0,0,0,0,0,0,0,0,81,81,0.0,M2019-07-10D,Race(3),,
6,2,0,0,2,1,0,0,1,2,0,1,3,5,0,1,6,21,21,0.0,M2019-07-10D,Race(3),,
7,0,0,0,0,1,2,3,6,1,0,4,5,2,2,7,11,15,15,0.0,M2019-07-10D,Race(3),,
8,0,5,5,10,0,1,2,3,0,1,4,5,0,7,11,18,6.5,6.5,1.0,M2019-07-10D,Race(3),,
9,2,3,6,11,0,0,4,4,0,1,2,3,2,4,12,18,7.5,7.5,0.0,M2019-07-10D,Race(3),,
10,0,0,0,0,0,0,0,0,0,0,0,0,0,0,0,0,126,126,0.0,M2019-07-10D,Race(3),,
11,5,0,0,5,0,0,1,1,0,0,0,0,5,0,1,6,11,11,0.0,M2019-07-10D,Race(3),,
12,5,5,0,10,6,14,1,21,5,6,2,13,16,25,3,44,9.5,9.5,0.0,M2019-07-10D,Race(3),,
1,0,0,0,0,0,0,1,1,0,0,1,1,0,0,2,2,71,67,0.0,M2019-07-10D,Race(4),,
2,13,5,4,22,6,17,4,27,12,8,2,22,31,30,10,71,3,3,3.0,M2019-07-10D,Race(4),,
3,2,0,0,2,0,1,2,3,0,0,2,2,2,1,4,7,21,21,0.0,M2019-07-10D,Race(4),,
4,3,0,0,3,0,0,0,0,0,0,0,0,3,0,0,3,19,19,0.0,M2019-07-10D,Race(4),,
5,3,4,6,13,1,2,3,6,1,0,2,3,5,6,11,22,9.5,9.5,0.0,M2019-07-10D,Race(4),,
6,0,3,5,8,1,2,11,14,1,4,4,9,2,9,20,31,9.5,9.5,2.0,M2019-07-10D,Race(4),,
7,0,3,0,3,0,1,0,1,0,2,1,3,0,6,1,7,7,7,1.0,M2019-07-10D,Race(4),,
8,2,0,3,5,0,3,1,4,0,3,1,4,2,6,5,13,21,21,0.0,M2019-07-10D,Race(4),,
9,4,10,9,23,20,3,6,29,9,8,8,25,33,21,23,77,3.2,3.2,0.0,M2019-07-10D,Race(4),,
10,0,0,0,0,0,0,0,0,0,0,0,0,0,0,0,0,41,41,0.0,M2019-07-10D,Race(4),,
11,3,5,3,11,2,1,2,5,3,1,5,9,8,7,10,25,12,12,0.0,M2019-07-10D,Race(4),,
12,0,0,0,0,0,0,0,0,0,0,0,0,0,0,0,0,101,101,0.0,M2019-07-10D,Race(4),,
1,0,0,0,0,0,0,0,0,0,0,1,1,0,0,1,1,26,26,0.0,M2019-07-10D,Race(5),,
2,5,5,0,10,1,1,0,2,2,0,2,4,8,6,2,16,8.5,8.5,2.0,M2019-07-10D,Race(5),,
3,0,0,3,3,1,1,3,5,2,2,5,9,3,3,11,17,15,15,0.0,M2019-07-10D,Race(5),,
4,0,2,2,4,0,1,0,1,0,2,0,2,0,5,2,7,14,14,0.0,M2019-07-10D,Race(5),,
5,14,5,0,19,7,6,5,18,12,6,2,20,33,17,7,57,3.2,3.2,1.0,M2019-07-10D,Race(5),,
6,0,0,3,3,0,0,0,0,0,0,1,1,0,0,4,4,19,19,0.0,M2019-07-10D,Race(5),,
7,2,0,8,10,3,14,2,19,2,8,2,12,7,22,12,41,10,10,0.0,M2019-07-10D,Race(5),,
8,5,10,10,25,18,3,5,26,8,2,5,15,31,15,20,66,4.8,4.8,3.0,M2019-07-10D,Race(5),,
9,2,8,4,14,0,3,14,17,0,3,7,10,2,14,25,41,8.5,8.5,0.0,M2019-07-10D,Race(5),,
10,0,0,0,0,0,1,0,1,0,3,1,4,0,4,1,5,8,8,0.0,M2019-07-10D,Race(5),,
11,2,0,0,2,0,0,1,1,0,0,0,0,2,0,1,3,19,19,0.0,M2019-07-10D,Race(5),,
12,0,0,0,0,0,0,0,0,0,0,0,0,0,0,0,0,71,67,0.0,M2019-07-10D,Race(5),,
1,14,7,6,27,17,5,4,26,9,8,5,22,40,20,15,75,3,3,1.0,M2019-07-10D,Race(6),,
2,0,0,2,2,0,1,0,1,0,0,1,1,0,1,3,4,14,14,0.0,M2019-07-10D,Race(6),,
3,0,7,4,11,7,5,5,17,11,6,4,21,18,18,13,49,7,7,3.0,M2019-07-10D,Race(6),,
4,3,0,0,3,0,0,2,2,1,1,5,7,4,1,7,12,10,10,0.0,M2019-07-10D,Race(6),,
5,6,7,2,15,0,3,1,4,0,0,1,1,6,10,4,20,5.5,5.5,2.0,M2019-07-10D,Race(6),,
6,0,3,0,3,0,0,0,0,0,0,0,0,0,3,0,3,61,61,0.0,M2019-07-10D,Race(6),,
7,4,6,14,24,5,12,5,22,4,4,4,12,13,22,23,58,4.2,4.2,0.0,M2019-07-10D,Race(6),,
8,0,0,0,0,0,0,0,0,0,0,0,0,0,0,0,0,34,34,0.0,M2019-07-10D,Race(6),,
9,0,0,0,0,0,0,0,0,0,0,0,0,0,0,0,0,81,81,0.0,M2019-07-10D,Race(6),,
10,3,0,2,5,1,4,13,18,1,5,6,12,5,9,21,35,10,10,0.0,M2019-07-10D,Race(6),,
11,0,0,0,0,0,0,0,0,0,0,0,0,0,0,0,0,81,81,0.0,M2019-07-10D,Race(6),,
12,0,0,0,0,0,0,0,0,0,2,0,2,0,2,0,2,26,26,0.0,M2019-07-10D,Race(6),,
1,6,9,0,15,2,1,2,5,2,0,4,6,10,10,6,26,9,9,0.0,M2019-07-10D,Race(7),,
2,0,0,2,2,3,3,3,9,1,2,3,6,4,5,8,17,11,11,0.0,M2019-07-10D,Race(7),,
3,3,8,0,11,2,3,8,13,2,1,2,5,7,12,10,29,12,12,0.0,M2019-07-10D,Race(7),,
4,2,3,6,11,12,7,7,26,7,4,5,16,21,14,18,53,3.8,3.8,1.0,M2019-07-10D,Race(7),,
5,5,0,2,7,4,1,1,6,4,2,1,7,13,3,4,20,9.5,9.5,0.0,M2019-07-10D,Race(7),,
6,6,0,8,14,4,12,2,18,4,7,1,12,14,19,11,44,5.5,5.5,3.0,M2019-07-10D,Race(7),,
7,2,5,4,11,0,3,1,4,1,5,0,6,3,13,5,21,6.5,6.5,2.0,M2019-07-10D,Race(7),,
8,6,2,6,14,0,0,3,3,2,3,4,9,8,5,13,26,10,10,0.0,M2019-07-10D,Race(7),,
9,0,0,0,0,0,0,0,0,0,0,1,1,0,0,1,1,61,61,0.0,M2019-07-10D,Race(7),,
10,0,0,0,0,0,0,0,0,0,0,1,1,0,0,1,1,16,16,0.0,M2019-07-10D,Race(7),,
11,0,3,2,5,1,0,2,3,2,2,2,6,3,5,6,14,12,12,0.0,M2019-07-10D,Race(7),,
12,0,0,0,0,2,0,1,3,1,0,2,3,3,0,3,6,41,41,0.0,M2019-07-10D,Race(7),,
1,0,3,3,6,0,1,4,5,0,0,2,2,0,4,9,13,17,17,0.0,M2019-07-10D,Race(8),,
2,11,9,3,23,16,4,6,26,13,5,2,20,40,18,11,69,4,4,1.0,M2019-07-10D,Race(8),,
3,14,11,2,27,11,15,4,30,11,11,4,26,36,37,10,83,2,2,3.0,M2019-07-10D,Race(8),,
4,3,0,2,5,0,0,3,3,0,3,8,11,3,3,13,19,13,13,0.0,M2019-07-10D,Race(8),,
5,0,0,0,0,0,0,0,0,0,0,0,0,0,0,0,0,34,34,0.0,M2019-07-10D,Race(8),,
6,0,2,3,5,0,0,0,0,0,0,2,2,0,2,5,7,15,15,2.0,M2019-07-10D,Race(8),,
7,0,0,0,0,0,0,0,0,0,0,0,0,0,0,0,0,71,67,0.0,M2019-07-10D,Race(8),,
8,0,0,0,0,0,0,0,0,0,0,0,0,0,0,0,0,51,51,0.0,M2019-07-10D,Race(8),,
9,2,0,0,2,0,0,1,1,0,0,1,1,2,0,2,4,12,12,0.0,M2019-07-10D,Race(8),,
10,0,0,12,12,0,2,3,5,0,3,2,5,0,5,17,22,18,18,0.0,M2019-07-10D,Race(8),,
11,0,5,5,10,3,7,8,18,2,3,5,10,5,15,18,38,13,13,0.0,M2019-07-10D,Race(8),,
12,0,0,0,0,0,1,1,2,0,1,0,1,0,2,1,3,21,21,0.0,M2019-07-10D,Race(8),,
1,5,0,5,10,1,2,14,17,2,2,5,9,8,4,24,36,10,10,0.0,M2019-07-10D,Race(9),,
2,4,0,0,4,3,1,0,4,3,5,0,8,10,6,0,16,26,26,0.0,M2019-07-10D,Race(9),,
3,2,2,5,9,1,12,3,16,1,7,2,10,4,21,10,35,8,8,0.0,M2019-07-10D,Race(9),,
4,0,0,0,0,0,0,2,2,0,1,2,3,0,1,4,5,16,16,0.0,M2019-07-10D,Race(9),,
5,2,10,2,14,1,3,3,7,1,4,4,9,4,17,9,30,6.5,6.5,1.0,M2019-07-10D,Race(9),,
6,2,2,9,13,4,2,1,7,3,2,3,8,9,6,13,28,8,8,3.0,M2019-07-10D,Race(9),,
7,6,3,2,11,0,3,0,3,1,0,1,2,7,6,3,16,7.5,8,0.0,M2019-07-10D,Race(9),,
8,6,5,5,16,19,5,3,27,12,3,5,20,37,13,13,63,3.7,3.7,0.0,M2019-07-10D,Race(9),,
9,0,0,0,0,0,0,0,0,0,0,0,0,0,0,0,0,18,18,0.0,M2019-07-10D,Race(9),,
10,0,3,2,5,1,2,3,6,3,2,3,8,4,7,8,19,11,11,2.0,M2019-07-10D,Race(9),,
11,3,2,0,5,0,0,0,0,0,0,0,0,3,2,0,5,12,12,0.0,M2019-07-10D,Race(9),,
12,0,3,0,3,0,0,1,1,0,0,1,1,0,3,2,5,21,21,0.0,M2019-07-10D,Race(9),,
1,0,2,2,4,0,2,10,12,0,0,3,3,0,4,15,19,15,15,2.0,M2019-07-14D,Race(1),,
2,0,0,3,3,0,0,0,0,0,0,0,0,0,0,3,3,26,26,0.0,M2019-07-14D,Race(1),,
3,2,2,5,9,10,7,6,23,2,10,7,19,14,19,18,51,9,9,0.0,M2019-07-14D,Race(1),,
4,16,5,7,28,8,7,5,20,13,7,3,23,37,19,15,71,4,4,3.0,M2019-07-14D,Race(1),,
5,0,0,0,0,0,0,0,0,0,1,0,1,0,1,0,1,26,26,0.0,M2019-07-14D,Race(1),,
6,5,14,4,23,9,4,3,16,8,0,4,12,22,18,11,51,3.5,3.5,1.0,M2019-07-14D,Race(1),,
7,0,0,0,0,0,0,0,0,1,0,0,1,1,0,0,1,61,61,0.0,M2019-07-14D,Race(1),,
8,0,0,0,0,0,0,0,0,0,1,0,1,0,1,0,1,61,61,0.0,M2019-07-14D,Race(1),,
9,3,0,0,3,0,0,0,0,1,1,0,2,4,1,0,5,19,19,0.0,M2019-07-14D,Race(1),,
10,2,7,9,18,3,2,3,8,1,5,5,11,6,14,17,37,4.4,4.4,0.0,M2019-07-14D,Race(1),,
11,0,0,0,0,0,8,3,11,0,1,4,5,0,9,7,16,26,26,0.0,M2019-07-14D,Race(1),,
12,2,0,0,2,0,0,0,0,0,0,0,0,2,0,0,2,12,12,0.0,M2019-07-14D,Race(1),,
13,0,0,0,0,0,0,0,0,0,0,0,0,0,0,0,0,21,21,0.0,M2019-07-14D,Race(1),,
14,0,0,0,0,0,0,0,0,0,0,0,0,0,0,0,0,126,126,0.0,M2019-07-14D,Race(1),,
1,0,0,0,0,0,0,0,0,0,1,0,1,0,1,0,1,101,101,0.0,M2019-07-14D,Race(10),,
2,10,3,3,16,9,3,5,17,12,5,2,19,31,11,10,52,3.7,4.6,0.0,M2019-07-14D,Race(10),,
3,3,0,3,6,0,2,1,3,1,1,1,3,4,3,5,12,21,19,0.0,M2019-07-14D,Race(10),,
4,0,4,8,12,2,2,3,7,2,2,2,6,4,8,13,25,11,10,0.0,M2019-07-14D,Race(10),,
5,0,2,0,2,0,0,8,8,0,0,0,0,0,2,8,10,18,16,2.0,M2019-07-14D,Race(10),,
6,11,9,7,27,8,8,4,20,8,7,4,19,27,24,15,66,2.9,3.1,0.0,M2019-07-14D,Race(10),,
7,2,6,4,12,3,4,2,9,1,4,4,9,6,14,10,30,9.5,8.5,0.0,M2019-07-14D,Race(10),,
8,0,0,0,0,0,0,0,0,0,0,0,0,0,0,0,0,51,51,0.0,M2019-07-14D,Race(10),,
9,2,6,5,13,8,1,5,14,2,2,4,8,12,9,14,35,7.5,7,1.0,M2019-07-14D,Race(10),,
10,0,0,0,0,0,0,0,0,0,0,0,0,0,0,0,0,20,18,0.0,M2019-07-14D,Race(10),,
11,0,0,0,0,0,0,0,0,0,0,0,0,0,0,0,0,61,61,0.0,M2019-07-14D,Race(10),,
12,0,0,0,0,0,8,2,10,0,1,0,1,0,9,2,11,10,10,3.0,M2019-07-14D,Race(10),,
13,2,0,0,2,0,2,0,2,0,0,1,1,2,2,1,5,34,34,0.0,M2019-07-14D,Race(10),,
14,0,0,0,0,0,0,0,0,0,0,0,0,0,0,0,0,34,31,0.0,M2019-07-14D,Race(10),,
1,0,0,2,2,0,0,0,0,1,0,1,2,1,0,3,4,51,46,0.0,M2019-07-14D,Race(11),,
2,0,2,0,2,4,1,3,8,5,0,2,7,9,3,5,17,12,14,0.0,M2019-07-14D,Race(11),,
3,0,0,0,0,0,0,0,0,0,0,0,0,0,0,0,0,23,23,3.0,M2019-07-14D,Race(11),,
4,15,5,2,22,9,3,3,15,7,6,5,18,31,14,10,55,4.2,4.4,0.0,M2019-07-14D,Race(11),,
5,0,2,5,7,1,8,3,12,0,5,3,8,1,15,11,27,10,11,0.0,M2019-07-14D,Race(11),,
6,0,11,5,16,3,3,4,10,4,6,1,11,7,20,10,37,3.9,3.9,0.0,M2019-07-14D,Race(11),,
7,3,3,5,11,8,3,2,13,2,3,4,9,13,9,11,33,18,18,1.0,M2019-07-14D,Race(11),,
8,0,0,0,0,0,0,0,0,0,0,0,0,0,0,0,0,61,51,0.0,M2019-07-14D,Race(11),,
9,2,0,8,10,2,4,4,10,4,4,3,11,8,8,15,31,6,6,0.0,M2019-07-14D,Race(11),,
10,3,0,3,6,0,0,8,8,0,0,0,0,3,0,11,14,20,19,0.0,M2019-07-14D,Race(11),,
11,5,7,0,12,3,8,3,14,3,2,7,12,11,17,10,38,5,4.8,2.0,M2019-07-14D,Race(11),,
12,0,0,0,0,0,0,0,0,0,0,0,0,0,0,0,0,51,51,0.0,M2019-07-14D,Race(11),,
13,0,0,0,0,0,0,0,0,0,0,0,0,0,0,0,0,51,51,0.0,M2019-07-14D,Race(11),,
14,2,0,0,2,0,0,0,0,0,0,0,0,2,0,0,2,71,71,0.0,M2019-07-14D,Race(11),,
1,5,0,0,5,3,0,2,5,5,1,1,7,13,1,3,17,10,10,2.0,M2019-07-14D,Race(2),,
2,0,3,3,6,3,2,3,8,2,1,6,9,5,6,12,23,14,14,3.0,M2019-07-14D,Race(2),,
3,0,2,4,6,8,0,2,10,1,0,4,5,9,2,10,21,26,26,1.0,M2019-07-14D,Race(2),,
4,0,0,0,0,0,1,1,2,0,2,0,2,0,3,1,4,13,13,0.0,M2019-07-14D,Race(2),,
5,0,2,0,2,0,0,0,0,0,0,0,0,0,2,0,2,41,41,0.0,M2019-07-14D,Race(2),,
6,2,3,9,14,2,2,2,6,0,4,5,9,4,9,16,29,7,7,0.0,M2019-07-14D,Race(2),,
7,11,15,0,26,1,5,2,8,3,8,1,12,15,28,3,46,4,4,0.0,M2019-07-14D,Race(2),,
8,12,5,8,25,9,6,4,19,10,5,4,19,31,16,16,63,2.6,2.6,0.0,M2019-07-14D,Race(2),,
9,0,0,0,0,0,0,0,0,0,0,0,0,0,0,0,0,51,51,0.0,M2019-07-14D,Race(2),,
10,0,0,2,2,0,0,0,0,0,0,1,1,0,0,3,3,34,34,0.0,M2019-07-14D,Race(2),,
11,0,0,0,0,0,0,0,0,0,0,0,0,0,0,0,0,51,51,0.0,M2019-07-14D,Race(2),,
12,0,0,0,0,0,0,0,0,1,0,0,1,1,0,0,1,26,26,0.0,M2019-07-14D,Race(2),,
13,0,0,4,4,0,8,0,8,0,0,0,0,0,8,4,12,15,15,0.0,M2019-07-14D,Race(2),,
14,0,0,0,0,0,0,8,8,0,0,2,2,0,0,10,10,61,61,0.0,M2019-07-14D,Race(2),,
1,3,2,0,5,0,1,0,1,0,1,2,3,3,4,2,9,15,15,0.0,M2019-07-14D,Race(3),,
2,3,5,3,11,8,1,3,12,2,3,3,8,13,9,9,31,8,8,0.0,M2019-07-14D,Race(3),,
3,2,2,7,11,2,1,1,4,2,3,3,8,6,6,11,23,10,10,0.0,M2019-07-14D,Race(3),,
4,5,5,2,12,5,7,4,16,5,4,1,10,15,16,7,38,8,8,2.0,M2019-07-14D,Race(3),,
5,0,0,3,3,0,3,2,5,0,3,2,5,0,6,7,13,13,13,0.0,M2019-07-14D,Race(3),,
6,0,0,0,0,0,0,0,0,0,1,0,1,0,1,0,1,151,151,0.0,M2019-07-14D,Race(3),,
7,12,9,2,23,10,7,3,20,10,5,4,19,32,21,9,62,2.2,2.2,0.0,M2019-07-14D,Race(3),,
8,0,0,0,0,0,1,2,3,0,1,1,2,0,2,3,5,81,81,0.0,M2019-07-14D,Race(3),,
9,0,2,5,7,0,8,1,9,0,1,3,4,0,11,9,20,16,16,1.0,M2019-07-14D,Race(3),,
10,0,0,0,0,0,0,0,0,0,0,0,0,0,0,0,0,61,61,0.0,M2019-07-14D,Race(3),,
11,0,0,0,0,0,0,8,8,0,0,1,1,0,0,9,9,81,81,0.0,M2019-07-14D,Race(3),,
12,0,0,5,5,1,0,1,2,3,2,2,7,4,2,8,14,26,26,0.0,M2019-07-14D,Race(3),,
13,5,5,3,13,4,1,5,10,4,2,4,10,13,8,12,33,6.5,6.5,3.0,M2019-07-14D,Race(3),,
14,0,0,0,0,0,0,0,0,0,0,0,0,0,0,0,0,34,34,0.0,M2019-07-14D,Race(3),,
1,2,0,2,4,0,5,4,9,1,3,2,6,3,8,8,19,9,9,3.0,M2019-07-14D,Race(4),,
2,0,0,2,2,0,3,2,5,0,2,4,6,0,5,8,13,41,41,0.0,M2019-07-14D,Race(4),,
3,20,2,8,30,18,5,0,23,19,2,3,24,57,9,11,77,1.6,1.6,1.0,M2019-07-14D,Race(4),,
4,3,13,3,19,2,2,5,9,3,3,4,10,8,18,12,38,7.5,7.5,0.0,M2019-07-14D,Race(4),,
5,2,13,9,24,1,4,7,12,3,10,5,18,6,27,21,54,6,6,0.0,M2019-07-14D,Race(4),,
6,0,2,0,2,0,0,2,2,0,0,3,3,0,2,5,7,31,31,0.0,M2019-07-14D,Race(4),,
7,0,0,0,0,8,2,0,10,0,2,1,3,8,4,1,13,19,19,0.0,M2019-07-14D,Race(4),,
8,0,0,0,0,0,0,0,0,0,1,0,1,0,1,0,1,126,126,0.0,M2019-07-14D,Race(4),,
9,0,0,3,3,0,8,2,10,0,2,4,6,0,10,9,19,21,21,0.0,M2019-07-14D,Race(4),,
10,0,0,0,0,0,0,0,0,0,0,0,0,0,0,0,0,151,201,0.0,M2019-07-14D,Race(4),,
11,0,0,3,3,0,0,8,8,0,1,0,1,0,1,11,12,41,41,2.0,M2019-07-14D,Race(4),,
12,0,0,0,0,0,0,0,0,0,0,0,0,0,0,0,0,151,201,0.0,M2019-07-14D,Race(4),,
13,3,0,0,3,1,1,0,2,0,0,0,0,4,1,0,5,34,34,0.0,M2019-07-14D,Race(4),,
14,0,0,0,0,0,0,0,0,0,0,0,0,0,0,0,0,71,67,0.0,M2019-07-14D,Race(4),,
1,0,4,0,4,8,2,0,10,2,1,0,3,10,7,0,17,14,14,0.0,M2019-07-14D,Race(5),,
2,0,11,5,16,4,0,1,5,3,0,1,4,7,11,7,25,6.5,6.5,0.0,M2019-07-14D,Race(5),,
3,5,2,5,12,4,4,3,11,3,4,3,10,12,10,11,33,10,10,0.0,M2019-07-14D,Race(5),,
4,0,0,0,0,0,1,8,9,0,2,1,3,0,3,9,12,17,17,0.0,M2019-07-14D,Race(5),,
5,0,0,0,0,0,0,0,0,1,0,0,1,1,0,0,1,101,101,0.0,M2019-07-14D,Race(5),,
6,0,0,0,0,0,0,0,0,1,0,0,1,1,0,0,1,101,101,0.0,M2019-07-14D,Race(5),,
7,0,8,3,11,0,8,1,9,1,1,3,5,1,17,7,25,12,12,0.0,M2019-07-14D,Race(5),,
8,13,5,7,25,11,5,6,22,11,9,5,25,35,19,18,72,3.5,3.5,1.0,M2019-07-14D,Race(5),,
9,0,0,2,2,1,3,3,7,0,4,4,8,1,7,9,17,14,14,0.0,M2019-07-14D,Race(5),,
10,12,0,8,20,2,7,8,17,4,5,9,18,18,12,25,55,3.5,3.5,2.0,M2019-07-14D,Race(5),,
11,0,0,0,0,0,0,0,0,0,0,0,0,0,0,0,0,11,11,0.0,M2019-07-14D,Race(5),,
12,0,0,0,0,0,0,0,0,0,0,0,0,0,0,0,0,71,67,0.0,M2019-07-14D,Race(5),,
13,0,0,0,0,0,0,0,0,0,0,0,0,0,0,0,0,151,201,0.0,M2019-07-14D,Race(5),,
14,0,0,0,0,0,0,0,0,0,0,0,0,0,0,0,0,26,26,3.0,M2019-07-14D,Race(5),,
1,14,3,5,22,9,5,5,19,13,4,7,24,36,12,17,65,3,3,1.0,M2019-07-14D,Race(6),,
2,2,5,7,14,2,3,4,9,0,4,2,6,4,12,13,29,9.5,9.5,0.0,M2019-07-14D,Race(6),,
3,0,5,5,10,4,8,3,15,5,2,1,8,9,15,9,33,10,10,0.0,M2019-07-14D,Race(6),,
4,0,0,0,0,0,0,0,0,0,2,0,2,0,2,0,2,51,51,0.0,M2019-07-14D,Race(6),,
5,0,0,3,3,0,0,0,0,0,0,2,2,0,0,5,5,51,51,0.0,M2019-07-14D,Race(6),,
6,2,2,0,4,0,0,0,0,0,1,1,2,2,3,1,6,14,14,0.0,M2019-07-14D,Race(6),,
7,0,2,0,2,0,1,0,1,0,1,0,1,0,4,0,4,21,21,0.0,M2019-07-14D,Race(6),,
8,0,0,0,0,0,0,0,0,0,0,0,0,0,0,0,0,19,19,0.0,M2019-07-14D,Race(6),,
9,0,0,0,0,0,2,8,10,0,0,3,3,0,2,11,13,19,19,3.0,M2019-07-14D,Race(6),,
10,0,3,2,5,8,1,0,9,0,0,0,0,8,4,2,14,19,19,0.0,M2019-07-14D,Race(6),,
11,9,7,3,19,6,7,6,19,6,6,4,16,21,20,13,54,4.2,4.2,2.0,M2019-07-14D,Race(6),,
12,3,3,5,11,1,3,4,8,2,6,6,14,6,12,15,33,7,7,0.0,M2019-07-14D,Race(6),,
13,0,0,0,0,0,0,0,0,0,0,0,0,0,0,0,0,51,51,0.0,M2019-07-14D,Race(6),,
14,0,0,0,0,0,0,0,0,0,0,0,0,0,0,0,0,41,41,0.0,M2019-07-14D,Race(6),,
1,14,12,2,28,10,3,6,19,13,2,3,18,37,17,11,65,2.6,2.6,2.0,M2019-07-14D,Race(7),,
2,0,0,2,2,0,8,0,8,2,1,0,3,2,9,2,13,17,17,0.0,M2019-07-14D,Race(7),,
3,3,8,17,28,10,6,4,20,2,10,5,17,15,24,26,65,3.7,3.7,1.0,M2019-07-14D,Race(7),,
4,0,0,0,0,0,0,0,0,0,0,0,0,0,0,0,0,151,201,0.0,M2019-07-14D,Race(7),,
5,2,5,2,9,4,9,4,17,3,6,7,16,9,20,13,42,8,8,0.0,M2019-07-14D,Race(7),,
6,0,0,0,0,0,0,0,0,0,0,1,1,0,0,1,1,81,81,0.0,M2019-07-14D,Race(7),,
7,11,3,7,21,6,3,6,15,6,4,3,13,23,10,16,49,4.6,4.6,3.0,M2019-07-14D,Race(7),,
8,0,0,0,0,0,1,10,11,0,1,6,7,0,2,16,18,26,26,0.0,M2019-07-14D,Race(7),,
9,0,0,0,0,0,0,0,0,0,1,1,2,0,1,1,2,21,21,0.0,M2019-07-14D,Race(7),,
10,0,0,0,0,0,0,0,0,0,0,0,0,0,0,0,0,71,67,0.0,M2019-07-14D,Race(7),,
11,0,2,0,2,0,0,0,0,0,1,0,1,0,3,0,3,14,14,0.0,M2019-07-14D,Race(7),,
12,0,0,0,0,0,0,0,0,0,0,0,0,0,0,0,0,81,81,0.0,M2019-07-14D,Race(7),,
13,0,0,0,0,0,0,0,0,0,0,0,0,0,0,0,0,81,81,0.0,M2019-07-14D,Race(7),,
14,0,0,0,0,0,0,0,0,0,0,0,0,0,0,0,0,101,101,0.0,M2019-07-14D,Race(7),,
1,2,2,0,4,8,1,0,9,2,4,1,7,12,7,1,20,15,11,0.0,M2019-07-14D,Race(8),,
2,0,0,0,0,0,0,0,0,1,0,0,1,1,0,0,1,34,31,0.0,M2019-07-14D,Race(8),,
3,0,0,0,0,0,8,0,8,0,1,0,1,0,9,0,9,34,31,0.0,M2019-07-14D,Race(8),,
4,13,7,0,20,17,1,3,21,14,2,6,22,44,10,9,63,3.9,3.9,3.0,M2019-07-14D,Race(8),,
5,2,16,6,24,4,9,5,18,5,9,3,17,11,34,14,59,3.1,3.1,0.0,M2019-07-14D,Race(8),,
6,3,0,9,12,1,2,2,5,2,2,4,8,6,4,15,25,20,21,0.0,M2019-07-14D,Race(8),,
7,5,3,6,14,0,4,9,13,2,4,7,13,7,11,22,40,4.2,5,2.0,M2019-07-14D,Race(8),,
8,0,2,2,4,0,3,2,5,0,2,3,5,0,7,7,14,11,9,0.0,M2019-07-14D,Race(8),,
9,0,0,0,0,0,0,0,0,0,0,0,0,0,0,0,0,31,26,0.0,M2019-07-14D,Race(8),,
10,5,0,7,12,0,2,9,11,0,2,2,4,5,4,18,27,8.5,8,1.0,M2019-07-14D,Race(8),,
11,0,0,0,0,0,0,0,0,0,0,0,0,0,0,0,0,41,41,0.0,M2019-07-14D,Race(8),,
1,5,2,3,10,1,3,4,8,2,3,4,9,8,8,11,27,7,6.5,0.0,M2019-07-14D,Race(9),,
2,0,0,0,0,0,0,0,0,3,0,0,3,3,0,0,3,17,17,2.0,M2019-07-14D,Race(9),,
3,11,13,3,27,11,6,3,20,12,7,2,21,34,26,8,68,6,6,0.0,M2019-07-14D,Race(9),,
4,0,0,0,0,0,0,0,0,0,0,0,0,0,0,0,0,10,9.5,0.0,M2019-07-14D,Race(9),,
5,0,8,11,19,2,8,7,17,2,2,5,9,4,18,23,45,5,6,3.0,M2019-07-14D,Race(9),,
6,12,3,6,21,5,8,3,16,5,5,6,16,22,16,15,53,4.2,4.2,0.0,M2019-07-14D,Race(9),,
7,0,0,0,0,0,0,0,0,0,0,1,1,0,0,1,1,31,31,0.0,M2019-07-14D,Race(9),,
8,0,0,0,0,0,0,0,0,1,0,0,1,1,0,0,1,41,41,0.0,M2019-07-14D,Race(9),,
9,0,0,0,0,0,0,0,0,0,0,0,0,0,0,0,0,101,101,0.0,M2019-07-14D,Race(9),,
10,0,0,0,0,0,0,0,0,0,2,0,2,0,2,0,2,23,21,1.0,M2019-07-14D,Race(9),,
11,0,0,2,2,8,0,2,10,0,2,4,6,8,2,8,18,13,12,0.0,M2019-07-14D,Race(9),,
12,0,0,0,0,0,0,0,0,0,0,0,0,0,0,0,0,126,101,0.0,M2019-07-14D,Race(9),,
13,2,2,2,6,3,5,2,10,1,4,2,7,6,11,6,23,10,9.5,0.0,M2019-07-14D,Race(9),,
14,0,0,0,0,0,0,8,8,0,1,2,3,0,1,10,11,12,13,0.0,M2019-07-14D,Race(9),,
1,3,11,4,18,0,3,4,7,1,5,4,10,4,19,12,35,7.5,7.5,0.0,M2019-09-01D,Race(1),,
1,3,11,4,18,0,3,4,7,1,5,4,10,4,19,12,35,7.5,7.5,0.0,M2019-09-01D,Race(1),,
2,2,5,10,17,10,7,6,23,4,7,4,15,16,19,20,55,4.6,4.5,1.0,M2019-09-01D,Race(1),,
2,2,5,10,17,10,7,6,23,4,7,4,15,16,19,20,55,4.6,4.5,2.0,M2019-09-01D,Race(1),,
3,14,9,5,28,15,7,1,23,14,9,2,25,43,25,8,76,2.1,2.1,0.0,M2019-09-01D,Race(1),,
3,14,9,5,28,15,7,1,23,14,9,2,25,43,25,8,76,2.1,2.1,0.0,M2019-09-01D,Race(1),,
4,9,5,3,17,5,5,7,17,7,5,6,18,21,15,16,52,5,5,3.0,M2019-09-01D,Race(1),,
4,9,5,3,17,5,5,7,17,7,5,6,18,21,15,16,52,5,5,0.0,M2019-09-01D,Race(1),,
5,0,0,0,0,0,0,0,0,0,0,1,1,0,0,1,1,41,41,0.0,M2019-09-01D,Race(1),,
5,0,0,0,0,0,0,0,0,0,0,1,1,0,0,1,1,41,41,0.0,M2019-09-01D,Race(1),,
6,0,0,0,0,0,0,2,2,0,0,6,6,0,0,8,8,15,15,0.0,M2019-09-01D,Race(1),,
6,0,0,0,0,0,0,2,2,0,0,6,6,0,0,8,8,15,15,0.0,M2019-09-01D,Race(1),,
7,0,0,3,3,0,8,2,10,0,0,3,3,0,8,8,16,19,19,0.0,M2019-09-01D,Race(1),,
7,0,0,3,3,0,8,2,10,0,0,3,3,0,8,8,16,19,19,0.0,M2019-09-01D,Race(1),,
8,2,0,0,2,0,0,8,8,0,0,0,0,2,0,8,10,19,19,0.0,M2019-09-01D,Race(1),,
8,2,0,0,2,0,0,8,8,0,0,0,0,2,0,8,10,19,19,0.0,M2019-09-01D,Race(1),,
9,0,0,5,5,0,0,0,0,0,0,0,0,0,0,5,5,21,21,0.0,M2019-09-01D,Race(1),,
9,0,0,5,5,0,0,0,0,0,0,0,0,0,0,5,5,21,21,0.0,M2019-09-01D,Race(1),,
1,3,2,0,5,4,2,0,6,4,3,1,8,11,7,1,19,9,9,3.0,M2019-09-01D,Race(10),,
1,3,2,0,5,4,2,0,6,4,3,1,8,11,7,1,19,9,9,0.0,M2019-09-01D,Race(10),,
2,0,0,0,0,0,0,0,0,0,0,0,0,0,0,0,0,67,67,0.0,M2019-09-01D,Race(10),,
2,0,0,0,0,0,0,0,0,0,0,0,0,0,0,0,0,67,67,0.0,M2019-09-01D,Race(10),,
3,0,0,0,0,0,0,0,0,1,0,0,1,1,0,0,1,81,81,1.0,M2019-09-01D,Race(10),,
3,0,0,0,0,0,0,0,0,1,0,0,1,1,0,0,1,81,81,0.0,M2019-09-01D,Race(10),,
4,9,4,7,20,7,3,5,15,8,5,5,18,24,12,17,53,7,7,2.0,M2019-09-01D,Race(10),,
4,9,4,7,20,7,3,5,15,8,5,5,18,24,12,17,53,7,7,0.0,M2019-09-01D,Race(10),,
5,7,8,5,20,9,4,3,16,2,7,5,14,18,19,13,50,7.5,7.5,0.0,M2019-09-01D,Race(10),,
5,7,8,5,20,9,4,3,16,2,7,5,14,18,19,13,50,7.5,7.5,0.0,M2019-09-01D,Race(10),,
6,0,0,5,5,0,0,0,0,0,0,1,1,0,0,6,6,31,31,0.0,M2019-09-01D,Race(10),,
6,0,0,5,5,0,0,0,0,0,0,1,1,0,0,6,6,31,31,0.0,M2019-09-01D,Race(10),,
7,0,3,2,5,0,8,1,9,0,1,1,2,0,12,4,16,15,15,0.0,M2019-09-01D,Race(10),,
7,0,3,2,5,0,8,1,9,0,1,1,2,0,12,4,16,15,15,0.0,M2019-09-01D,Race(10),,
8,5,2,3,10,3,8,3,14,5,6,1,12,13,16,7,36,6,6,0.0,M2019-09-01D,Race(10),,
8,5,2,3,10,3,8,3,14,5,6,1,12,13,16,7,36,6,6,0.0,M2019-09-01D,Race(10),,
9,2,3,5,10,2,3,4,9,3,3,2,8,7,9,11,27,6,6,0.0,M2019-09-01D,Race(10),,
9,2,3,5,10,2,3,4,9,3,3,2,8,7,9,11,27,6,6,0.0,M2019-09-01D,Race(10),,
10,4,8,3,15,5,2,5,12,3,1,8,12,12,11,16,39,3.5,3.5,0.0,M2019-09-01D,Race(10),,
10,4,8,3,15,5,2,5,12,3,1,8,12,12,11,16,39,3.5,3.5,0.0,M2019-09-01D,Race(10),,
11,0,0,0,0,0,0,0,0,0,0,0,0,0,0,0,0,31,31,0.0,M2019-09-01D,Race(10),,
11,0,0,0,0,0,0,0,0,0,0,0,0,0,0,0,0,31,31,0.0,M2019-09-01D,Race(10),,
12,0,0,0,0,0,0,0,0,0,0,0,0,0,0,0,0,81,81,0.0,M2019-09-01D,Race(10),,
12,0,0,0,0,0,0,0,0,0,0,0,0,0,0,0,0,81,81,0.0,M2019-09-01D,Race(10),,
13,0,0,0,0,0,0,9,9,0,0,2,2,0,0,11,11,31,31,0.0,M2019-09-01D,Race(10),,
13,0,0,0,0,0,0,9,9,0,0,2,2,0,0,11,11,31,31,0.0,M2019-09-01D,Race(10),,
14,0,0,0,0,0,0,0,0,0,0,0,0,0,0,0,0,15,15,0.0,M2019-09-01D,Race(10),,
14,0,0,0,0,0,0,0,0,0,0,0,0,0,0,0,0,15,15,0.0,M2019-09-01D,Race(10),,
1,0,6,0,6,0,8,1,9,0,2,2,4,0,16,3,19,9,9,0.0,M2019-09-01D,Race(2),,
1,0,6,0,6,0,8,1,9,0,2,2,4,0,16,3,19,9,9,2.0,M2019-09-01D,Race(2),,
2,2,0,3,5,1,1,0,2,1,0,1,2,4,1,4,9,15,15,0.0,M2019-09-01D,Race(2),,
2,2,0,3,5,1,1,0,2,1,0,1,2,4,1,4,9,15,15,0.0,M2019-09-01D,Race(2),,
3,0,0,0,0,0,1,0,1,0,0,0,0,0,1,0,1,21,21,0.0,M2019-09-01D,Race(2),,
3,0,0,0,0,0,1,0,1,0,0,0,0,0,1,0,1,21,21,0.0,M2019-09-01D,Race(2),,
4,3,0,0,3,8,0,0,8,1,1,0,2,12,1,0,13,21,21,0.0,M2019-09-01D,Race(2),,
4,3,0,0,3,8,0,0,8,1,1,0,2,12,1,0,13,21,21,3.0,M2019-09-01D,Race(2),,
5,6,0,7,13,10,4,6,20,5,2,10,17,21,6,23,50,7.5,7.5,0.0,M2019-09-01D,Race(2),,
5,6,0,7,13,10,4,6,20,5,2,10,17,21,6,23,50,7.5,7.5,0.0,M2019-09-01D,Race(2),,
6,0,0,5,5,0,0,0,0,0,0,0,0,0,0,5,5,19,19,0.0,M2019-09-01D,Race(2),,
6,0,0,5,5,0,0,0,0,0,0,0,0,0,0,5,5,19,19,0.0,M2019-09-01D,Race(2),,
7,2,6,9,17,6,6,5,17,6,7,3,16,14,19,17,50,7.5,7.5,1.0,M2019-09-01D,Race(2),,
7,2,6,9,17,6,6,5,17,6,7,3,16,14,19,17,50,7.5,7.5,0.0,M2019-09-01D,Race(2),,
8,0,0,0,0,0,0,0,0,0,0,2,2,0,0,2,2,15,15,0.0,M2019-09-01D,Race(2),,
8,0,0,0,0,0,0,0,0,0,0,2,2,0,0,2,2,15,15,0.0,M2019-09-01D,Race(2),,
9,3,2,4,9,1,1,1,3,2,1,2,5,6,4,7,17,13,13,0.0,M2019-09-01D,Race(2),,
9,3,2,4,9,1,1,1,3,2,1,2,5,6,4,7,17,13,13,0.0,M2019-09-01D,Race(2),,
10,0,0,0,0,0,1,1,2,0,0,0,0,0,1,1,2,51,51,0.0,M2019-09-01D,Race(2),,
10,0,0,0,0,0,1,1,2,0,0,0,0,0,1,1,2,51,51,0.0,M2019-09-01D,Race(2),,
11,2,3,0,5,0,0,8,8,1,2,1,4,3,5,9,17,26,26,0.0,M2019-09-01D,Race(2),,
11,2,3,0,5,0,0,8,8,1,2,1,4,3,5,9,17,26,26,0.0,M2019-09-01D,Race(2),,
12,3,2,2,7,1,5,2,8,3,7,1,11,7,14,5,26,5.5,5.5,0.0,M2019-09-01D,Race(2),,
12,3,2,2,7,1,5,2,8,3,7,1,11,7,14,5,26,5.5,5.5,0.0,M2019-09-01D,Race(2),,
13,7,5,0,12,3,2,4,9,6,3,1,10,16,10,5,31,6,6,0.0,M2019-09-01D,Race(2),,
13,7,5,0,12,3,2,4,9,6,3,1,10,16,10,5,31,6,6,0.0,M2019-09-01D,Race(2),,
14,2,6,0,8,1,5,7,13,1,1,3,5,4,12,10,26,7.5,7.5,0.0,M2019-09-01D,Race(2),,
14,2,6,0,8,1,5,7,13,1,1,3,5,4,12,10,26,7.5,7.5,0.0,M2019-09-01D,Race(2),,
1,7,8,13,28,2,8,9,19,5,4,11,20,14,20,33,67,6.5,6.5,0.0,M2019-09-01D,Race(3),,
1,7,8,13,28,2,8,9,19,5,4,11,20,14,20,33,67,6.5,6.5,2.0,M2019-09-01D,Race(3),,
2,6,0,7,13,2,4,4,10,3,5,1,9,11,9,12,32,9,9.5,0.0,M2019-09-01D,Race(3),,
2,6,0,7,13,2,4,4,10,3,5,1,9,11,9,12,32,9,9.5,0.0,M2019-09-01D,Race(3),,
3,0,0,0,0,1,1,8,10,1,6,0,7,2,7,8,17,20,20,1.0,M2019-09-01D,Race(3),,
3,0,0,0,0,1,1,8,10,1,6,0,7,2,7,8,17,20,20,3.0,M2019-09-01D,Race(3),,
4,0,0,0,0,0,8,0,8,0,1,0,1,0,9,0,9,14,13,0.0,M2019-09-01D,Race(3),,
4,0,0,0,0,0,8,0,8,0,1,0,1,0,9,0,9,14,13,0.0,M2019-09-01D,Race(3),,
5,12,13,0,25,17,4,2,23,14,5,7,26,43,22,9,74,1.7,1.6,0.0,M2019-09-01D,Race(3),,
5,12,13,0,25,17,4,2,23,14,5,7,26,43,22,9,74,1.7,1.6,0.0,M2019-09-01D,Race(3),,
6,0,0,0,0,0,0,0,0,0,0,1,1,0,0,1,1,31,27,0.0,M2019-09-01D,Race(3),,
6,0,0,0,0,0,0,0,0,0,0,1,1,0,0,1,1,31,27,0.0,M2019-09-01D,Race(3),,
7,5,9,10,24,8,5,7,20,3,5,6,14,16,19,23,58,4,4.2,0.0,M2019-09-01D,Race(3),,
7,5,9,10,24,8,5,7,20,3,5,6,14,16,19,23,58,4,4.2,0.0,M2019-09-01D,Race(3),,
1,0,0,8,8,8,6,8,22,2,2,8,12,10,8,24,42,13,13,0.0,M2019-09-01D,Race(4),,
1,0,0,8,8,8,6,8,22,2,2,8,12,10,8,24,42,13,13,3.0,M2019-09-01D,Race(4),,
2,6,7,8,21,1,8,1,10,2,1,0,3,9,16,9,34,5,5,1.0,M2019-09-01D,Race(4),,
2,6,7,8,21,1,8,1,10,2,1,0,3,9,16,9,34,5,5,0.0,M2019-09-01D,Race(4),,
3,0,0,0,0,2,1,1,4,3,1,1,5,5,2,2,9,17,17,0.0,M2019-09-01D,Race(4),,
3,0,0,0,0,2,1,1,4,3,1,1,5,5,2,2,9,17,17,0.0,M2019-09-01D,Race(4),,
4,0,0,0,0,0,0,0,0,0,0,2,2,0,0,2,2,31,31,0.0,M2019-09-01D,Race(4),,
4,0,0,0,0,0,0,0,0,0,0,2,2,0,0,2,2,31,31,0.0,M2019-09-01D,Race(4),,
5,8,8,5,21,6,10,1,17,3,11,1,15,17,29,7,53,6.5,6.5,0.0,M2019-09-01D,Race(4),,
5,8,8,5,21,6,10,1,17,3,11,1,15,17,29,7,53,6.5,6.5,2.0,M2019-09-01D,Race(4),,
6,0,0,0,0,2,1,3,6,4,2,6,12,6,3,9,18,21,21,0.0,M2019-09-01D,Race(4),,
6,0,0,0,0,2,1,3,6,4,2,6,12,6,3,9,18,21,21,0.0,M2019-09-01D,Race(4),,
7,2,0,0,2,0,0,0,0,0,0,0,0,2,0,0,2,61,61,0.0,M2019-09-01D,Race(4),,
7,2,0,0,2,0,0,0,0,0,0,0,0,2,0,0,2,61,61,0.0,M2019-09-01D,Race(4),,
8,0,2,0,2,1,0,2,3,1,1,1,3,2,3,3,8,9,9,0.0,M2019-09-01D,Race(4),,
8,0,2,0,2,1,0,2,3,1,1,1,3,2,3,3,8,9,9,0.0,M2019-09-01D,Race(4),,
9,0,0,0,0,0,0,1,1,0,0,0,0,0,0,1,1,21,21,0.0,M2019-09-01D,Race(4),,
9,0,0,0,0,0,0,1,1,0,0,0,0,0,0,1,1,21,21,0.0,M2019-09-01D,Race(4),,
10,5,5,9,19,1,2,3,6,0,3,2,5,6,10,14,30,5,5,0.0,M2019-09-01D,Race(4),,
10,5,5,9,19,1,2,3,6,0,3,2,5,6,10,14,30,5,5,0.0,M2019-09-01D,Race(4),,
11,7,2,0,9,3,2,1,6,2,4,0,6,12,8,1,21,8.5,8.5,0.0,M2019-09-01D,Race(4),,
11,7,2,0,9,3,2,1,6,2,4,0,6,12,8,1,21,8.5,8.5,0.0,M2019-09-01D,Race(4),,
12,0,0,0,0,0,0,0,0,0,0,0,0,0,0,0,0,126,126,0.0,M2019-09-01D,Race(4),,
12,0,0,0,0,0,0,0,0,0,0,0,0,0,0,0,0,126,126,0.0,M2019-09-01D,Race(4),,
13,2,0,0,2,0,0,8,8,1,1,2,4,3,1,10,14,19,19,0.0,M2019-09-01D,Race(4),,
13,2,0,0,2,0,0,8,8,1,1,2,4,3,1,10,14,19,19,0.0,M2019-09-01D,Race(4),,
14,0,6,0,6,6,0,1,7,8,0,3,11,14,6,4,24,6.5,6.5,0.0,M2019-09-01D,Race(4),,
14,0,6,0,6,6,0,1,7,8,0,3,11,14,6,4,24,6.5,6.5,0.0,M2019-09-01D,Race(4),,
1,0,0,0,0,2,2,1,5,2,1,0,3,4,3,1,8,26,26,0.0,M2019-09-01D,Race(5),,
1,0,0,0,0,2,2,1,5,2,1,0,3,4,3,1,8,26,26,0.0,M2019-09-01D,Race(5),,
2,3,6,0,9,6,4,5,15,6,4,3,13,15,14,8,37,6,6,3.0,M2019-09-01D,Race(5),,
2,3,6,0,9,6,4,5,15,6,4,3,13,15,14,8,37,6,6,0.0,M2019-09-01D,Race(5),,
3,0,3,0,3,0,0,0,0,2,0,0,2,2,3,0,5,15,15,0.0,M2019-09-01D,Race(5),,
3,0,3,0,3,0,0,0,0,2,0,0,2,2,3,0,5,15,15,1.0,M2019-09-01D,Race(5),,
4,2,0,2,4,2,3,3,8,2,5,4,11,6,8,9,23,12,12,0.0,M2019-09-01D,Race(5),,
4,2,0,2,4,2,3,3,8,2,5,4,11,6,8,9,23,12,12,0.0,M2019-09-01D,Race(5),,
5,5,3,5,13,4,7,2,13,3,6,0,9,12,16,7,35,5,5,0.0,M2019-09-01D,Race(5),,
5,5,3,5,13,4,7,2,13,3,6,0,9,12,16,7,35,5,5,0.0,M2019-09-01D,Race(5),,
6,9,6,2,17,4,2,4,10,7,1,4,12,20,9,10,39,5,5,2.0,M2019-09-01D,Race(5),,
6,9,6,2,17,4,2,4,10,7,1,4,12,20,9,10,39,5,5,0.0,M2019-09-01D,Race(5),,
7,3,3,5,11,1,8,2,11,0,2,5,7,4,13,12,29,9,9,0.0,M2019-09-01D,Race(5),,
7,3,3,5,11,1,8,2,11,0,2,5,7,4,13,12,29,9,9,0.0,M2019-09-01D,Race(5),,
8,0,0,0,0,0,0,1,1,0,0,2,2,0,0,3,3,51,51,0.0,M2019-09-01D,Race(5),,
8,0,0,0,0,0,0,1,1,0,0,2,2,0,0,3,3,51,51,0.0,M2019-09-01D,Race(5),,
9,0,0,0,0,8,0,0,8,2,0,0,2,10,0,0,10,71,67,0.0,M2019-09-01D,Race(5),,
9,0,0,0,0,8,0,0,8,2,0,0,2,10,0,0,10,71,67,0.0,M2019-09-01D,Race(5),,
10,0,0,0,0,0,0,0,0,0,0,0,0,0,0,0,0,34,34,0.0,M2019-09-01D,Race(5),,
10,0,0,0,0,0,0,0,0,0,0,0,0,0,0,0,0,34,34,0.0,M2019-09-01D,Race(5),,
11,0,2,0,2,0,0,8,8,0,0,0,0,0,2,8,10,10,10,0.0,M2019-09-01D,Race(5),,
11,0,2,0,2,0,0,8,8,0,0,0,0,0,2,8,10,10,10,0.0,M2019-09-01D,Race(5),,
12,3,2,5,10,1,0,1,2,1,2,3,6,5,4,9,18,12,12,0.0,M2019-09-01D,Race(5),,
12,3,2,5,10,1,0,1,2,1,2,3,6,5,4,9,18,12,12,0.0,M2019-09-01D,Race(5),,
13,5,5,11,21,2,4,3,9,1,5,5,11,8,14,19,41,6.5,6.5,0.0,M2019-09-01D,Race(5),,
13,5,5,11,21,2,4,3,9,1,5,5,11,8,14,19,41,6.5,6.5,0.0,M2019-09-01D,Race(5),,
14,0,0,0,0,0,0,0,0,0,0,0,0,0,0,0,0,101,101,0.0,M2019-09-01D,Race(5),,
14,0,0,0,0,0,0,0,0,0,0,0,0,0,0,0,0,101,101,0.0,M2019-09-01D,Race(5),,
1,5,16,7,28,11,9,3,23,16,9,1,26,32,34,11,77,2.5,2.5,2.0,M2019-09-01D,Race(6),,
1,5,16,7,28,11,9,3,23,16,9,1,26,32,34,11,77,2.5,2.5,0.0,M2019-09-01D,Race(6),,
2,13,9,5,27,12,9,7,28,5,11,7,23,30,29,19,78,4,4,0.0,M2019-09-01D,Race(6),,
2,13,9,5,27,12,9,7,28,5,11,7,23,30,29,19,78,4,4,1.0,M2019-09-01D,Race(6),,
3,0,0,0,0,0,0,0,0,0,0,0,0,0,0,0,0,67,67,3.0,M2019-09-01D,Race(6),,
3,0,0,0,0,0,0,0,0,0,0,0,0,0,0,0,0,67,67,0.0,M2019-09-01D,Race(6),,
4,10,5,15,30,7,4,10,21,5,5,13,23,22,14,38,74,4.4,4.4,0.0,M2019-09-01D,Race(6),,
4,10,5,15,30,7,4,10,21,5,5,13,23,22,14,38,74,4.4,4.4,0.0,M2019-09-01D,Race(6),,
5,0,0,3,3,0,8,1,9,0,0,2,2,0,8,6,14,18,18,0.0,M2019-09-01D,Race(6),,
5,0,0,3,3,0,8,1,9,0,0,2,2,0,8,6,14,18,18,0.0,M2019-09-01D,Race(6),,
6,0,0,0,0,0,0,0,0,0,0,0,0,0,0,0,0,13,13,0.0,M2019-09-01D,Race(6),,
6,0,0,0,0,0,0,0,0,0,0,0,0,0,0,0,0,13,13,0.0,M2019-09-01D,Race(6),,
7,0,0,0,0,0,0,8,8,0,1,1,2,0,1,9,10,21,21,0.0,M2019-09-01D,Race(6),,
7,0,0,0,0,0,0,8,8,0,1,1,2,0,1,9,10,21,21,0.0,M2019-09-01D,Race(6),,
8,0,0,0,0,0,0,0,0,0,0,0,0,0,0,0,0,34,34,0.0,M2019-09-01D,Race(6),,
8,0,0,0,0,0,0,0,0,0,0,0,0,0,0,0,0,34,34,0.0,M2019-09-01D,Race(6),,
9,0,0,0,0,0,0,0,0,0,0,0,0,0,0,0,0,41,41,0.0,M2019-09-01D,Race(6),,
9,0,0,0,0,0,0,0,0,0,0,0,0,0,0,0,0,41,41,0.0,M2019-09-01D,Race(6),,
10,0,0,0,0,0,0,0,0,0,0,0,0,0,0,0,0,26,26,0.0,M2019-09-01D,Race(6),,
10,0,0,0,0,0,0,0,0,0,0,0,0,0,0,0,0,26,26,0.0,M2019-09-01D,Race(6),,
11,0,0,0,0,0,0,0,0,0,0,0,0,0,0,0,0,67,67,0.0,M2019-09-01D,Race(6),,
11,0,0,0,0,0,0,0,0,0,0,0,0,0,0,0,0,67,67,0.0,M2019-09-01D,Race(6),,
12,0,0,0,0,0,0,0,0,0,0,0,0,0,0,0,0,34,34,0.0,M2019-09-01D,Race(6),,
12,0,0,0,0,0,0,0,0,0,0,0,0,0,0,0,0,34,34,0.0,M2019-09-01D,Race(6),,
13,0,0,0,0,0,0,1,1,0,0,1,1,0,0,2,2,18,18,0.0,M2019-09-01D,Race(6),,
13,0,0,0,0,0,0,1,1,0,0,1,1,0,0,2,2,18,18,0.0,M2019-09-01D,Race(6),,
14,2,0,0,2,0,0,0,0,0,0,1,1,2,0,1,3,101,101,0.0,M2019-09-01D,Race(6),,
14,2,0,0,2,0,0,0,0,0,0,1,1,2,0,1,3,101,101,0.0,M2019-09-01D,Race(6),,
1,0,2,0,2,0,0,9,9,0,0,1,1,0,2,10,12,26,27,0.0,M2019-09-01D,Race(7),,
1,0,2,0,2,0,0,9,9,0,0,1,1,0,2,10,12,26,27,0.0,M2019-09-01D,Race(7),,
2,0,0,4,4,0,0,5,5,1,0,5,6,1,0,14,15,11,12,1.0,M2019-09-01D,Race(7),,
2,0,0,4,4,0,0,5,5,1,0,5,6,1,0,14,15,11,12,0.0,M2019-09-01D,Race(7),,
3,6,7,7,20,4,14,2,20,9,12,2,23,19,33,11,63,3.8,3.9,0.0,M2019-09-01D,Race(7),,
3,6,7,7,20,4,14,2,20,9,12,2,23,19,33,11,63,3.8,3.9,2.0,M2019-09-01D,Race(7),,
4,2,11,8,21,8,5,11,24,1,7,8,16,11,23,27,61,6,5,3.0,M2019-09-01D,Race(7),,
4,2,11,8,21,8,5,11,24,1,7,8,16,11,23,27,61,6,5,0.0,M2019-09-01D,Race(7),,
5,0,0,0,0,0,0,0,0,0,0,0,0,0,0,0,0,61,61,0.0,M2019-09-01D,Race(7),,
5,0,0,0,0,0,0,0,0,0,0,0,0,0,0,0,0,61,61,0.0,M2019-09-01D,Race(7),,
6,22,6,2,30,18,4,8,30,15,7,4,26,55,17,14,86,2.05,2.1,0.0,M2019-09-01D,Race(7),,
6,22,6,2,30,18,4,8,30,15,7,4,26,55,17,14,86,2.05,2.1,0.0,M2019-09-01D,Race(7),,
7,0,2,0,2,0,0,0,0,0,0,1,1,0,2,1,3,17,16,0.0,M2019-09-01D,Race(7),,
7,0,2,0,2,0,0,0,0,0,0,1,1,0,2,1,3,17,16,0.0,M2019-09-01D,Race(7),,
8,0,0,0,0,0,0,0,0,0,0,0,0,0,0,0,0,81,81,0.0,M2019-09-01D,Race(7),,
8,0,0,0,0,0,0,0,0,0,0,0,0,0,0,0,0,81,81,0.0,M2019-09-01D,Race(7),,
9,0,2,9,11,0,0,2,2,0,0,5,5,0,2,16,18,7,7,0.0,M2019-09-01D,Race(7),,
9,0,2,9,11,0,0,2,2,0,0,5,5,0,2,16,18,7,7,0.0,M2019-09-01D,Race(7),,
1,11,4,6,21,12,6,2,20,10,8,2,20,33,18,10,61,7.5,8,0.0,M2019-09-01D,Race(8),,
1,11,4,6,21,12,6,2,20,10,8,2,20,33,18,10,61,7.5,8,2.0,M2019-09-01D,Race(8),,
2,6,2,7,15,6,8,5,19,9,4,6,19,21,14,18,53,4.6,4.8,0.0,M2019-09-01D,Race(8),,
2,6,2,7,15,6,8,5,19,9,4,6,19,21,14,18,53,4.6,4.8,0.0,M2019-09-01D,Race(8),,
3,0,0,0,0,0,0,0,0,0,0,0,0,0,0,0,0,31,27,0.0,M2019-09-01D,Race(8),,
3,0,0,0,0,0,0,0,0,0,0,0,0,0,0,0,0,31,27,0.0,M2019-09-01D,Race(8),,
4,5,11,6,22,2,2,4,8,3,4,6,13,10,17,16,43,4.4,4.8,0.0,M2019-09-01D,Race(8),,
4,5,11,6,22,2,2,4,8,3,4,6,13,10,17,16,43,4.4,4.8,3.0,M2019-09-01D,Race(8),,
5,8,3,8,19,2,3,8,13,2,4,1,7,12,10,17,39,4.8,4.5,0.0,M2019-09-01D,Race(8),,
5,8,3,8,19,2,3,8,13,2,4,1,7,12,10,17,39,4.8,4.5,1.0,M2019-09-01D,Race(8),,
6,0,0,0,0,0,8,1,9,0,1,1,2,0,9,2,11,17,18,0.0,M2019-09-01D,Race(8),,
6,0,0,0,0,0,8,1,9,0,1,1,2,0,9,2,11,17,18,0.0,M2019-09-01D,Race(8),,
7,0,0,0,0,0,0,0,0,0,0,0,0,0,0,0,0,34,35,0.0,M2019-09-01D,Race(8),,
7,0,0,0,0,0,0,0,0,0,0,0,0,0,0,0,0,34,35,0.0,M2019-09-01D,Race(8),,
8,0,0,3,3,0,0,1,1,0,2,2,4,0,2,6,8,15,13,0.0,M2019-09-01D,Race(8),,
8,0,0,3,3,0,0,1,1,0,2,2,4,0,2,6,8,15,13,0.0,M2019-09-01D,Race(8),,
9,0,0,0,0,0,0,0,0,0,0,1,1,0,0,1,1,16,16,0.0,M2019-09-01D,Race(8),,
9,0,0,0,0,0,0,0,0,0,0,1,1,0,0,1,1,16,16,0.0,M2019-09-01D,Race(8),,
10,0,5,0,5,0,1,0,1,1,1,2,4,1,7,2,10,17,16,0.0,M2019-09-01D,Race(8),,
10,0,5,0,5,0,1,0,1,1,1,2,4,1,7,2,10,17,16,0.0,M2019-09-01D,Race(8),,
11,0,3,0,3,8,2,1,11,1,2,4,7,9,7,5,21,8.5,9,0.0,M2019-09-01D,Race(8),,
11,0,3,0,3,8,2,1,11,1,2,4,7,9,7,5,21,8.5,9,0.0,M2019-09-01D,Race(8),,
12,0,2,0,2,0,0,8,8,0,0,1,1,0,2,9,11,14,11,0.0,M2019-09-01D,Race(8),,
12,0,2,0,2,0,0,8,8,0,0,1,1,0,2,9,11,14,11,0.0,M2019-09-01D,Race(8),,
1,0,2,8,10,10,3,11,24,5,7,4,16,15,12,23,50,11,11,1.0,M2019-09-01D,Race(9),,
1,0,2,8,10,10,3,11,24,5,7,4,16,15,12,23,50,11,11,0.0,M2019-09-01D,Race(9),,
2,0,0,0,0,0,0,0,0,0,0,0,0,0,0,0,0,91,91,0.0,M2019-09-01D,Race(9),,
2,0,0,0,0,0,0,0,0,0,0,0,0,0,0,0,0,91,91,3.0,M2019-09-01D,Race(9),,
3,8,6,2,16,0,10,8,18,1,6,12,19,9,22,22,53,5.5,5.5,0.0,M2019-09-01D,Race(9),,
3,8,6,2,16,0,10,8,18,1,6,12,19,9,22,22,53,5.5,5.5,0.0,M2019-09-01D,Race(9),,
4,0,0,2,2,0,0,8,8,0,0,0,0,0,0,10,10,26,26,0.0,M2019-09-01D,Race(9),,
4,0,0,2,2,0,0,8,8,0,0,0,0,0,0,10,10,26,26,2.0,M2019-09-01D,Race(9),,
5,0,0,0,0,0,0,0,0,0,0,0,0,0,0,0,0,21,21,0.0,M2019-09-01D,Race(9),,
5,0,0,0,0,0,0,0,0,0,0,0,0,0,0,0,0,21,21,0.0,M2019-09-01D,Race(9),,
6,2,0,3,5,0,0,0,0,0,0,2,2,2,0,5,7,26,26,0.0,M2019-09-01D,Race(9),,
6,2,0,3,5,0,0,0,0,0,0,2,2,2,0,5,7,26,26,0.0,M2019-09-01D,Race(9),,
7,18,7,5,30,20,3,0,23,19,4,0,23,57,14,5,76,1.8,1.8,0.0,M2019-09-01D,Race(9),,
7,18,7,5,30,20,3,0,23,19,4,0,23,57,14,5,76,1.8,1.8,0.0,M2019-09-01D,Race(9),,
8,2,8,7,17,0,4,3,7,0,5,7,12,2,17,17,36,6,6,0.0,M2019-09-01D,Race(9),,
8,2,8,7,17,0,4,3,7,0,5,7,12,2,17,17,36,6,6,0.0,M2019-09-01D,Race(9),,
9,0,4,3,7,0,10,0,10,0,4,0,4,0,18,3,21,34,34,0.0,M2019-09-01D,Race(9),,
9,0,4,3,7,0,10,0,10,0,4,0,4,0,18,3,21,34,34,0.0,M2019-09-01D,Race(9),,
10,0,3,0,3,0,0,0,0,0,0,0,0,0,3,0,3,19,19,0.0,M2019-09-01D,Race(9),,
10,0,3,0,3,0,0,0,0,0,0,0,0,0,3,0,3,19,19,0.0,M2019-09-01D,Race(9),,
11,0,0,0,0,0,0,0,0,0,0,1,1,0,0,1,1,34,34,0.0,M2019-09-01D,Race(9),,
11,0,0,0,0,0,0,0,0,0,0,1,1,0,0,1,1,34,34,0.0,M2019-09-01D,Race(9),,
12,0,0,0,0,0,0,0,0,0,0,0,0,0,0,0,0,26,26,0.0,M2019-09-01D,Race(9),,
12,0,0,0,0,0,0,0,0,0,0,0,0,0,0,0,0,26,26,0.0,M2019-09-01D,Race(9),,
1,7,13,10,30,23,4,1,28,18,2,3,23,48,19,14,81,3.3,3.3,3.0,M2019-09-08D,Race(1),,
1,7,13,10,30,23,4,1,28,18,2,3,23,48,19,14,81,3.3,3.3,1.0,M2019-09-08D,Race(1),,
2,11,10,0,21,4,17,7,28,2,10,9,21,17,37,16,70,2.3,2.3,0.0,M2019-09-08D,Race(1),,
2,11,10,0,21,4,17,7,28,2,10,9,21,17,37,16,70,2.3,2.3,0.0,M2019-09-08D,Race(1),,
3,4,0,3,7,1,0,2,3,1,0,3,4,6,0,8,14,14,14,0.0,M2019-09-08D,Race(1),,
3,4,0,3,7,1,0,2,3,1,0,3,4,6,0,8,14,14,14,2.0,M2019-09-08D,Race(1),,
4,0,0,0,0,0,0,0,0,0,0,1,1,0,0,1,1,81,81,0.0,M2019-09-08D,Race(1),,
4,0,0,0,0,0,0,0,0,0,0,1,1,0,0,1,1,81,81,0.0,M2019-09-08D,Race(1),,
5,0,0,0,0,0,0,0,0,1,0,0,1,1,0,0,1,34,34,0.0,M2019-09-08D,Race(1),,
5,0,0,0,0,0,0,0,0,1,0,0,1,1,0,0,1,34,34,0.0,M2019-09-08D,Race(1),,
6,8,0,15,23,2,8,16,26,3,12,4,19,13,20,35,68,4,4,0.0,M2019-09-08D,Race(1),,
6,8,0,15,23,2,8,16,26,3,12,4,19,13,20,35,68,4,4,0.0,M2019-09-08D,Race(1),,
7,0,0,0,0,0,0,0,0,0,0,1,1,0,0,1,1,41,41,0.0,M2019-09-08D,Race(1),,
7,0,0,0,0,0,0,0,0,0,0,1,1,0,0,1,1,41,41,0.0,M2019-09-08D,Race(1),,
8,0,2,2,4,0,0,4,4,1,1,3,5,1,3,9,13,12,12,0.0,M2019-09-08D,Race(1),,
8,0,2,2,4,0,0,4,4,1,1,3,5,1,3,9,13,12,12,0.0,M2019-09-08D,Race(1),,
9,0,5,0,5,0,1,0,1,0,1,1,2,0,7,1,8,34,34,0.0,M2019-09-08D,Race(1),,
9,0,5,0,5,0,1,0,1,0,1,1,2,0,7,1,8,34,34,0.0,M2019-09-08D,Race(1),,
10,0,0,0,0,0,0,0,0,0,0,0,0,0,0,0,0,26,26,0.0,M2019-09-08D,Race(1),,
10,0,0,0,0,0,0,0,0,0,0,0,0,0,0,0,0,26,26,0.0,M2019-09-08D,Race(1),,
1,3,0,0,3,1,0,2,3,0,0,2,2,4,0,4,8,16,16,2.0,M2019-09-08D,Race(10),,
1,3,0,0,3,1,0,2,3,0,0,2,2,4,0,4,8,16,16,0.0,M2019-09-08D,Race(10),,
2,3,3,6,12,4,15,4,23,6,9,2,17,13,27,12,52,5,5,0.0,M2019-09-08D,Race(10),,
2,3,3,6,12,4,15,4,23,6,9,2,17,13,27,12,52,5,5,0.0,M2019-09-08D,Race(10),,
3,4,0,6,10,0,4,2,6,1,6,3,10,5,10,11,26,6.5,6.5,0.0,M2019-09-08D,Race(10),,
3,4,0,6,10,0,4,2,6,1,6,3,10,5,10,11,26,6.5,6.5,0.0,M2019-09-08D,Race(10),,
4,0,0,0,0,0,0,0,0,0,0,0,0,0,0,0,0,31,31,0.0,M2019-09-08D,Race(10),,
4,0,0,0,0,0,0,0,0,0,0,0,0,0,0,0,0,31,31,1.0,M2019-09-08D,Race(10),,
5,0,2,0,2,0,0,0,0,0,0,1,1,0,2,1,3,34,34,0.0,M2019-09-08D,Race(10),,
5,0,2,0,2,0,0,0,0,0,0,1,1,0,2,1,3,34,34,0.0,M2019-09-08D,Race(10),,
6,0,0,0,0,0,0,3,3,0,0,2,2,0,0,5,5,26,26,0.0,M2019-09-08D,Race(10),,
6,0,0,0,0,0,0,3,3,0,0,2,2,0,0,5,5,26,26,0.0,M2019-09-08D,Race(10),,
7,0,0,2,2,0,0,0,0,0,0,1,1,0,0,3,3,19,19,0.0,M2019-09-08D,Race(10),,
7,0,0,2,2,0,0,0,0,0,0,1,1,0,0,3,3,19,19,3.0,M2019-09-08D,Race(10),,
8,2,3,7,12,3,2,11,16,2,3,2,7,7,8,20,35,8.5,8.5,0.0,M2019-09-08D,Race(10),,
8,2,3,7,12,3,2,11,16,2,3,2,7,7,8,20,35,8.5,8.5,0.0,M2019-09-08D,Race(10),,
9,0,0,0,0,0,0,1,1,1,0,1,2,1,0,2,3,26,26,0.0,M2019-09-08D,Race(10),,
9,0,0,0,0,0,0,1,1,1,0,1,2,1,0,2,3,26,26,0.0,M2019-09-08D,Race(10),,
10,0,2,0,2,0,0,0,0,0,0,0,0,0,2,0,2,13,13,0.0,M2019-09-08D,Race(10),,
10,0,2,0,2,0,0,0,0,0,0,0,0,0,2,0,2,13,13,0.0,M2019-09-08D,Race(10),,
11,8,15,4,27,22,5,3,30,14,5,5,24,44,25,12,81,3.3,3.3,0.0,M2019-09-08D,Race(10),,
11,8,15,4,27,22,5,3,30,14,5,5,24,44,25,12,81,3.3,3.3,0.0,M2019-09-08D,Race(10),,
12,10,5,5,20,0,3,4,7,2,3,7,12,12,11,16,39,9,9,0.0,M2019-09-08D,Race(10),,
12,10,5,5,20,0,3,4,7,2,3,7,12,12,11,16,39,9,9,0.0,M2019-09-08D,Race(10),,
13,0,0,0,0,0,1,0,1,0,0,0,0,0,1,0,1,61,61,0.0,M2019-09-08D,Race(10),,
13,0,0,0,0,0,1,0,1,0,0,0,0,0,1,0,1,61,61,0.0,M2019-09-08D,Race(10),,
14,0,0,0,0,0,0,0,0,0,0,0,0,0,0,0,0,21,21,0.0,M2019-09-08D,Race(10),,
14,0,0,0,0,0,0,0,0,0,0,0,0,0,0,0,0,21,21,0.0,M2019-09-08D,Race(10),,
1,5,5,8,18,1,2,7,10,4,2,3,9,10,9,18,37,7,7,0.0,M2019-09-08D,Race(2),,
1,5,5,8,18,1,2,7,10,4,2,3,9,10,9,18,37,7,7,2.0,M2019-09-08D,Race(2),,
2,20,2,5,27,26,2,1,29,18,3,3,24,64,7,9,80,2,2,3.0,M2019-09-08D,Race(2),,
2,20,2,5,27,26,2,1,29,18,3,3,24,64,7,9,80,2,2,0.0,M2019-09-08D,Race(2),,
3,2,8,9,19,1,19,5,25,0,11,4,15,3,38,18,59,6.5,6.5,0.0,M2019-09-08D,Race(2),,
3,2,8,9,19,1,19,5,25,0,11,4,15,3,38,18,59,6.5,6.5,0.0,M2019-09-08D,Race(2),,
4,0,0,0,0,0,0,1,1,0,0,3,3,0,0,4,4,10,10,0.0,M2019-09-08D,Race(2),,
4,0,0,0,0,0,0,1,1,0,0,3,3,0,0,4,4,10,10,0.0,M2019-09-08D,Race(2),,
5,0,0,0,0,0,0,0,0,0,0,1,1,0,0,1,1,34,34,1.0,M2019-09-08D,Race(2),,
5,0,0,0,0,0,0,0,0,0,0,1,1,0,0,1,1,34,34,0.0,M2019-09-08D,Race(2),,
6,0,0,0,0,0,0,0,0,0,0,0,0,0,0,0,0,34,34,0.0,M2019-09-08D,Race(2),,
6,0,0,0,0,0,0,0,0,0,0,0,0,0,0,0,0,34,34,0.0,M2019-09-08D,Race(2),,
7,3,5,8,16,1,6,14,21,1,6,7,14,5,17,29,51,8.5,8.5,0.0,M2019-09-08D,Race(2),,
7,3,5,8,16,1,6,14,21,1,6,7,14,5,17,29,51,8.5,8.5,0.0,M2019-09-08D,Race(2),,
8,0,0,0,0,0,0,2,2,1,1,4,6,1,1,6,8,26,26,0.0,M2019-09-08D,Race(2),,
8,0,0,0,0,0,0,2,2,1,1,4,6,1,1,6,8,26,26,0.0,M2019-09-08D,Race(2),,
9,0,10,0,10,1,1,0,2,2,3,1,6,3,14,1,18,6,6,0.0,M2019-09-08D,Race(2),,
9,0,10,0,10,1,1,0,2,2,3,1,6,3,14,1,18,6,6,0.0,M2019-09-08D,Race(2),,
1,0,0,2,2,0,0,0,0,0,0,0,0,0,0,2,2,31,31,3.0,M2019-09-08D,Race(3),,
1,0,0,2,2,0,0,0,0,0,0,0,0,0,0,2,2,31,31,0.0,M2019-09-08D,Race(3),,
2,9,3,6,18,4,3,5,12,3,7,7,17,16,13,18,47,6.5,7,0.0,M2019-09-08D,Race(3),,
2,9,3,6,18,4,3,5,12,3,7,7,17,16,13,18,47,6.5,7,1.0,M2019-09-08D,Race(3),,
3,0,7,5,12,0,1,1,2,2,0,1,3,2,8,7,17,9.5,9,0.0,M2019-09-08D,Race(3),,
3,0,7,5,12,0,1,1,2,2,0,1,3,2,8,7,17,9.5,9,0.0,M2019-09-08D,Race(3),,
4,3,7,5,15,1,6,13,20,5,7,1,13,9,20,19,48,7.5,8,0.0,M2019-09-08D,Race(3),,
4,3,7,5,15,1,6,13,20,5,7,1,13,9,20,19,48,7.5,8,0.0,M2019-09-08D,Race(3),,
5,6,5,9,20,3,16,5,24,2,4,6,12,11,25,20,56,3.5,3.4,0.0,M2019-09-08D,Race(3),,
5,6,5,9,20,3,16,5,24,2,4,6,12,11,25,20,56,3.5,3.4,0.0,M2019-09-08D,Race(3),,
6,0,0,0,0,1,0,0,1,2,0,0,2,3,0,0,3,34,31,0.0,M2019-09-08D,Race(3),,
6,0,0,0,0,1,0,0,1,2,0,0,2,3,0,0,3,34,31,0.0,M2019-09-08D,Race(3),,
7,0,0,0,0,0,0,0,0,0,1,1,2,0,1,1,2,26,26,2.0,M2019-09-08D,Race(3),,
7,0,0,0,0,0,0,0,0,0,1,1,2,0,1,1,2,26,26,0.0,M2019-09-08D,Race(3),,
8,0,0,0,0,0,0,0,0,0,0,0,0,0,0,0,0,41,41,0.0,M2019-09-08D,Race(3),,
8,0,0,0,0,0,0,0,0,0,0,0,0,0,0,0,0,41,41,0.0,M2019-09-08D,Race(3),,
9,0,0,0,0,0,0,0,0,0,0,0,0,0,0,0,0,101,91,0.0,M2019-09-08D,Race(3),,
9,0,0,0,0,0,0,0,0,0,0,0,0,0,0,0,0,101,91,0.0,M2019-09-08D,Race(3),,
10,0,0,0,0,0,1,0,1,0,1,0,1,0,2,0,2,41,41,0.0,M2019-09-08D,Race(3),,
10,0,0,0,0,0,1,0,1,0,1,0,1,0,2,0,2,41,41,0.0,M2019-09-08D,Race(3),,
11,3,0,0,3,0,1,1,2,1,2,1,4,4,3,2,9,26,26,0.0,M2019-09-08D,Race(3),,
11,3,0,0,3,0,1,1,2,1,2,1,4,4,3,2,9,26,26,0.0,M2019-09-08D,Race(3),,
12,5,8,3,16,20,2,5,27,11,4,7,22,36,14,15,65,3.3,3.3,0.0,M2019-09-08D,Race(3),,
12,5,8,3,16,20,2,5,27,11,4,7,22,36,14,15,65,3.3,3.3,0.0,M2019-09-08D,Race(3),,
13,0,0,0,0,0,0,0,0,0,0,1,1,0,0,1,1,26,26,0.0,M2019-09-08D,Race(3),,
13,0,0,0,0,0,0,0,0,0,0,1,1,0,0,1,1,26,26,0.0,M2019-09-08D,Race(3),,
14,4,0,0,4,1,0,0,1,0,0,1,1,5,0,1,6,17,16,0.0,M2019-09-08D,Race(3),,
14,4,0,0,4,1,0,0,1,0,0,1,1,5,0,1,6,17,16,0.0,M2019-09-08D,Race(3),,
1,7,0,9,16,3,14,3,20,3,6,4,13,13,20,16,49,9,9,0.0,M2019-09-08D,Race(4),,
1,7,0,9,16,3,14,3,20,3,6,4,13,13,20,16,49,9,9,0.0,M2019-09-08D,Race(4),,
2,0,0,2,2,0,0,0,0,0,0,0,0,0,0,2,2,10,10,1.0,M2019-09-08D,Race(4),,
2,0,0,2,2,0,0,0,0,0,0,0,0,0,0,2,2,10,10,0.0,M2019-09-08D,Race(4),,
3,3,8,8,19,5,5,16,26,9,6,5,20,17,19,29,65,3.4,3.3,0.0,M2019-09-08D,Race(4),,
3,3,8,8,19,5,5,16,26,9,6,5,20,17,19,29,65,3.4,3.3,2.0,M2019-09-08D,Race(4),,
4,0,0,0,0,0,0,0,0,0,0,0,0,0,0,0,0,41,41,0.0,M2019-09-08D,Race(4),,
4,0,0,0,0,0,0,0,0,0,0,0,0,0,0,0,0,41,41,0.0,M2019-09-08D,Race(4),,
5,5,12,2,19,14,6,1,21,3,8,3,14,22,26,6,54,4.8,4.8,0.0,M2019-09-08D,Race(4),,
5,5,12,2,19,14,6,1,21,3,8,3,14,22,26,6,54,4.8,4.8,3.0,M2019-09-08D,Race(4),,
6,13,2,6,21,3,4,5,12,5,5,3,13,21,11,14,46,4.2,4.2,0.0,M2019-09-08D,Race(4),,
6,13,2,6,21,3,4,5,12,5,5,3,13,21,11,14,46,4.2,4.2,0.0,M2019-09-08D,Race(4),,
7,2,0,0,2,1,0,0,1,0,0,0,0,3,0,0,3,17,17,0.0,M2019-09-08D,Race(4),,
7,2,0,0,2,1,0,0,1,0,0,0,0,3,0,0,3,17,17,0.0,M2019-09-08D,Race(4),,
8,0,0,0,0,0,0,0,0,0,0,2,2,0,0,2,2,81,81,0.0,M2019-09-08D,Race(4),,
8,0,0,0,0,0,0,0,0,0,0,2,2,0,0,2,2,81,81,0.0,M2019-09-08D,Race(4),,
9,0,0,0,0,0,0,0,0,0,0,0,0,0,0,0,0,126,126,0.0,M2019-09-08D,Race(4),,
9,0,0,0,0,0,0,0,0,0,0,0,0,0,0,0,0,126,126,0.0,M2019-09-08D,Race(4),,
10,0,5,3,8,1,1,3,5,1,0,3,4,2,6,9,17,13,13,0.0,M2019-09-08D,Race(4),,
10,0,5,3,8,1,1,3,5,1,0,3,4,2,6,9,17,13,13,0.0,M2019-09-08D,Race(4),,
11,0,0,0,0,1,0,1,2,1,0,2,3,2,0,3,5,20,20,0.0,M2019-09-08D,Race(4),,
11,0,0,0,0,1,0,1,2,1,0,2,3,2,0,3,5,20,20,0.0,M2019-09-08D,Race(4),,
12,0,3,0,3,2,0,1,3,4,1,4,9,6,4,5,15,12,12,0.0,M2019-09-08D,Race(4),,
12,0,3,0,3,2,0,1,3,4,1,4,9,6,4,5,15,12,12,0.0,M2019-09-08D,Race(4),,
1,13,3,0,16,7,4,12,23,8,3,1,12,28,10,13,51,4.4,4.4,3.0,M2019-09-08D,Race(5),,
1,13,3,0,16,7,4,12,23,8,3,1,12,28,10,13,51,4.4,4.4,0.0,M2019-09-08D,Race(5),,
2,0,0,0,0,0,0,0,0,0,0,0,0,0,0,0,0,81,81,0.0,M2019-09-08D,Race(5),,
2,0,0,0,0,0,0,0,0,0,0,0,0,0,0,0,0,81,81,0.0,M2019-09-08D,Race(5),,
3,5,2,3,10,4,13,6,23,2,6,5,13,11,21,14,46,9,9,2.0,M2019-09-08D,Race(5),,
3,5,2,3,10,4,13,6,23,2,6,5,13,11,21,14,46,9,9,0.0,M2019-09-08D,Race(5),,
4,2,0,5,7,0,3,1,4,0,5,2,7,2,8,8,18,8,8,0.0,M2019-09-08D,Race(5),,
4,2,0,5,7,0,3,1,4,0,5,2,7,2,8,8,18,8,8,1.0,M2019-09-08D,Race(5),,
5,2,5,3,10,15,3,7,25,13,3,6,22,30,11,16,57,4.8,4.8,0.0,M2019-09-08D,Race(5),,
5,2,5,3,10,15,3,7,25,13,3,6,22,30,11,16,57,4.8,4.8,0.0,M2019-09-08D,Race(5),,
6,5,5,11,21,2,2,1,5,2,2,4,8,9,9,16,34,6,6,0.0,M2019-09-08D,Race(5),,
6,5,5,11,21,2,2,1,5,2,2,4,8,9,9,16,34,6,6,0.0,M2019-09-08D,Race(5),,
7,0,0,0,0,0,0,0,0,0,0,0,0,0,0,0,0,126,126,0.0,M2019-09-08D,Race(5),,
7,0,0,0,0,0,0,0,0,0,0,0,0,0,0,0,0,126,126,0.0,M2019-09-08D,Race(5),,
8,0,9,0,9,0,1,0,1,0,0,0,0,0,10,0,10,12,12,0.0,M2019-09-08D,Race(5),,
8,0,9,0,9,0,1,0,1,0,0,0,0,0,10,0,10,12,12,0.0,M2019-09-08D,Race(5),,
9,3,4,0,7,0,0,1,1,0,1,1,2,3,5,2,10,18,18,0.0,M2019-09-08D,Race(5),,
9,3,4,0,7,0,0,1,1,0,1,1,2,3,5,2,10,18,18,0.0,M2019-09-08D,Race(5),,
10,0,0,0,0,0,0,0,0,0,0,0,0,0,0,0,0,26,26,0.0,M2019-09-08D,Race(5),,
10,0,0,0,0,0,0,0,0,0,0,0,0,0,0,0,0,26,26,0.0,M2019-09-08D,Race(5),,
11,0,2,0,2,1,0,1,2,0,0,4,4,1,2,5,8,7,7,0.0,M2019-09-08D,Race(5),,
11,0,2,0,2,1,0,1,2,0,0,4,4,1,2,5,8,7,7,0.0,M2019-09-08D,Race(5),,
12,0,0,8,8,1,4,1,6,1,6,3,10,2,10,12,24,10,10,0.0,M2019-09-08D,Race(5),,
12,0,0,8,8,1,4,1,6,1,6,3,10,2,10,12,24,10,10,0.0,M2019-09-08D,Race(5),,
1,2,7,6,15,8,13,5,26,9,5,5,19,19,25,16,60,6,6,3.0,M2019-09-08D,Race(6),,
1,2,7,6,15,8,13,5,26,9,5,5,19,19,25,16,60,6,6,0.0,M2019-09-08D,Race(6),,
2,0,3,2,5,0,0,0,0,2,1,0,3,2,4,2,8,51,51,0.0,M2019-09-08D,Race(6),,
2,0,3,2,5,0,0,0,0,2,1,0,3,2,4,2,8,51,51,0.0,M2019-09-08D,Race(6),,
3,0,0,0,0,0,1,0,1,1,2,0,3,1,3,0,4,20,20,2.0,M2019-09-08D,Race(6),,
3,0,0,0,0,0,1,0,1,1,2,0,3,1,3,0,4,20,20,0.0,M2019-09-08D,Race(6),,
4,13,8,0,21,3,2,10,15,4,1,0,5,20,11,10,41,5,5,0.0,M2019-09-08D,Race(6),,
4,13,8,0,21,3,2,10,15,4,1,0,5,20,11,10,41,5,5,0.0,M2019-09-08D,Race(6),,
5,2,8,4,14,1,2,3,6,1,7,3,11,4,17,10,31,8,8,1.0,M2019-09-08D,Race(6),,
5,2,8,4,14,1,2,3,6,1,7,3,11,4,17,10,31,8,8,0.0,M2019-09-08D,Race(6),,
6,0,0,0,0,0,0,0,0,2,0,0,2,2,0,0,2,126,126,0.0,M2019-09-08D,Race(6),,
6,0,0,0,0,0,0,0,0,2,0,0,2,2,0,0,2,126,126,0.0,M2019-09-08D,Race(6),,
7,0,4,0,4,0,0,1,1,1,1,3,5,1,5,4,10,11,11,0.0,M2019-09-08D,Race(6),,
7,0,4,0,4,0,0,1,1,1,1,3,5,1,5,4,10,11,11,0.0,M2019-09-08D,Race(6),,
8,2,0,0,2,0,0,0,0,0,0,1,1,2,0,1,3,34,34,0.0,M2019-09-08D,Race(6),,
8,2,0,0,2,0,0,0,0,0,0,1,1,2,0,1,3,34,34,0.0,M2019-09-08D,Race(6),,
9,3,0,11,14,15,5,2,22,4,5,6,15,22,10,19,51,5,5,0.0,M2019-09-08D,Race(6),,
9,3,0,11,14,15,5,2,22,4,5,6,15,22,10,19,51,5,5,0.0,M2019-09-08D,Race(6),,
10,6,0,7,13,3,3,3,9,2,2,2,6,11,5,12,28,5.5,5.5,0.0,M2019-09-08D,Race(6),,
10,6,0,7,13,3,3,3,9,2,2,2,6,11,5,12,28,5.5,5.5,0.0,M2019-09-08D,Race(6),,
11,0,0,0,0,0,1,3,4,0,0,3,3,0,1,6,7,14,14,0.0,M2019-09-08D,Race(6),,
11,0,0,0,0,0,1,3,4,0,0,3,3,0,1,6,7,14,14,0.0,M2019-09-08D,Race(6),,
12,0,0,0,0,0,0,0,0,0,0,0,0,0,0,0,0,81,81,0.0,M2019-09-08D,Race(6),,
12,0,0,0,0,0,0,0,0,0,0,0,0,0,0,0,0,81,81,0.0,M2019-09-08D,Race(6),,
13,0,0,0,0,0,0,1,1,0,0,1,1,0,0,2,2,21,21,0.0,M2019-09-08D,Race(6),,
13,0,0,0,0,0,0,1,1,0,0,1,1,0,0,2,2,21,21,0.0,M2019-09-08D,Race(6),,
14,2,0,0,2,0,3,2,5,0,2,2,4,2,5,4,11,13,13,0.0,M2019-09-08D,Race(6),,
14,2,0,0,2,0,3,2,5,0,2,2,4,2,5,4,11,13,13,0.0,M2019-09-08D,Race(6),,
1,0,0,3,3,0,0,0,0,0,0,0,0,0,0,3,3,34,34,0.0,M2019-09-08D,Race(7),,
1,0,0,3,3,0,0,0,0,0,0,0,0,0,0,3,3,34,34,3.0,M2019-09-08D,Race(7),,
2,0,3,2,5,0,0,2,2,2,1,2,5,2,4,6,12,19,19,0.0,M2019-09-08D,Race(7),,
2,0,3,2,5,0,0,2,2,2,1,2,5,2,4,6,12,19,19,0.0,M2019-09-08D,Race(7),,
3,0,4,9,13,0,3,4,7,0,2,4,6,0,9,17,26,7,7,0.0,M2019-09-08D,Race(7),,
3,0,4,9,13,0,3,4,7,0,2,4,6,0,9,17,26,7,7,0.0,M2019-09-08D,Race(7),,
4,0,0,2,2,0,2,2,4,0,2,2,4,0,4,6,10,19,19,0.0,M2019-09-08D,Race(7),,
4,0,0,2,2,0,2,2,4,0,2,2,4,0,4,6,10,19,19,1.0,M2019-09-08D,Race(7),,
5,0,3,9,12,1,5,11,17,1,8,4,13,2,16,24,42,7,7,0.0,M2019-09-08D,Race(7),,
5,0,3,9,12,1,5,11,17,1,8,4,13,2,16,24,42,7,7,2.0,M2019-09-08D,Race(7),,
6,15,8,0,23,20,5,5,30,17,3,5,25,52,16,10,78,2.8,2.8,0.0,M2019-09-08D,Race(7),,
6,15,8,0,23,20,5,5,30,17,3,5,25,52,16,10,78,2.8,2.8,0.0,M2019-09-08D,Race(7),,
7,0,0,0,0,0,0,0,0,0,0,0,0,0,0,0,0,101,101,0.0,M2019-09-08D,Race(7),,
7,0,0,0,0,0,0,0,0,0,0,0,0,0,0,0,0,101,101,0.0,M2019-09-08D,Race(7),,
8,13,12,5,30,9,15,4,28,5,10,7,22,27,37,16,80,2.75,2.8,0.0,M2019-09-08D,Race(7),,
8,13,12,5,30,9,15,4,28,5,10,7,22,27,37,16,80,2.75,2.8,0.0,M2019-09-08D,Race(7),,
9,0,0,0,0,0,0,1,1,0,0,1,1,0,0,2,2,31,31,0.0,M2019-09-08D,Race(7),,
9,0,0,0,0,0,0,1,1,0,0,1,1,0,0,2,2,31,31,0.0,M2019-09-08D,Race(7),,
10,0,0,0,0,0,0,0,0,1,0,1,2,1,0,1,2,41,41,0.0,M2019-09-08D,Race(7),,
10,0,0,0,0,0,0,0,0,1,0,1,2,1,0,1,2,41,41,0.0,M2019-09-08D,Race(7),,
11,2,0,0,2,0,0,1,1,0,0,0,0,2,0,1,3,15,15,0.0,M2019-09-08D,Race(7),,
11,2,0,0,2,0,0,1,1,0,0,0,0,2,0,1,3,15,15,0.0,M2019-09-08D,Race(7),,
12,0,0,0,0,0,0,0,0,0,0,0,0,0,0,0,0,101,101,0.0,M2019-09-08D,Race(7),,
12,0,0,0,0,0,0,0,0,0,0,0,0,0,0,0,0,101,101,0.0,M2019-09-08D,Race(7),,
1,0,2,2,4,0,1,1,2,2,2,0,4,2,5,3,10,17,17,0.0,M2019-09-08D,Race(8),,
1,0,2,2,4,0,1,1,2,2,2,0,4,2,5,3,10,17,17,0.0,M2019-09-08D,Race(8),,
2,22,3,2,27,24,6,0,30,18,6,2,26,64,15,4,83,2,2,2.0,M2019-09-08D,Race(8),,
2,22,3,2,27,24,6,0,30,18,6,2,26,64,15,4,83,2,2,0.0,M2019-09-08D,Race(8),,
3,3,0,3,6,1,11,2,14,0,3,4,7,4,14,9,27,7,7,0.0,M2019-09-08D,Race(8),,
3,3,0,3,6,1,11,2,14,0,3,4,7,4,14,9,27,7,7,0.0,M2019-09-08D,Race(8),,
4,0,3,0,3,0,5,16,21,0,6,5,11,0,14,21,35,26,26,1.0,M2019-09-08D,Race(8),,
4,0,3,0,3,0,5,16,21,0,6,5,11,0,14,21,35,26,26,0.0,M2019-09-08D,Race(8),,
5,0,0,6,6,0,0,0,0,0,0,3,3,0,0,9,9,18,18,0.0,M2019-09-08D,Race(8),,
5,0,0,6,6,0,0,0,0,0,0,3,3,0,0,9,9,18,18,0.0,M2019-09-08D,Race(8),,
6,0,0,0,0,0,0,0,0,0,0,0,0,0,0,0,0,41,41,3.0,M2019-09-08D,Race(8),,
6,0,0,0,0,0,0,0,0,0,0,0,0,0,0,0,0,41,41,0.0,M2019-09-08D,Race(8),,
7,0,7,0,7,3,2,3,8,2,2,1,5,5,11,4,20,10,10,0.0,M2019-09-08D,Race(8),,
7,0,7,0,7,3,2,3,8,2,2,1,5,5,11,4,20,10,10,0.0,M2019-09-08D,Race(8),,
8,0,0,0,0,0,0,0,0,0,0,0,0,0,0,0,0,17,17,0.0,M2019-09-08D,Race(8),,
8,0,0,0,0,0,0,0,0,0,0,0,0,0,0,0,0,17,17,0.0,M2019-09-08D,Race(8),,
9,0,3,7,10,0,1,4,5,0,3,7,10,0,7,18,25,14,14,0.0,M2019-09-08D,Race(8),,
9,0,3,7,10,0,1,4,5,0,3,7,10,0,7,18,25,14,14,0.0,M2019-09-08D,Race(8),,
10,0,0,0,0,0,0,0,0,0,0,0,0,0,0,0,0,41,41,0.0,M2019-09-08D,Race(8),,
10,0,0,0,0,0,0,0,0,0,0,0,0,0,0,0,0,41,41,0.0,M2019-09-08D,Race(8),,
11,5,10,2,17,2,4,4,10,4,4,4,12,11,18,10,39,6,6,0.0,M2019-09-08D,Race(8),,
11,5,10,2,17,2,4,4,10,4,4,4,12,11,18,10,39,6,6,0.0,M2019-09-08D,Race(8),,
12,0,2,8,10,0,0,0,0,0,0,0,0,0,2,8,10,26,26,0.0,M2019-09-08D,Race(8),,
12,0,2,8,10,0,0,0,0,0,0,0,0,0,2,8,10,26,26,0.0,M2019-09-08D,Race(8),,
1,0,0,5,5,0,0,1,1,1,1,0,2,1,1,6,8,17,17,0.0,M2019-09-08D,Race(9),,
1,0,0,5,5,0,0,1,1,1,1,0,2,1,1,6,8,17,17,0.0,M2019-09-08D,Race(9),,
2,9,9,0,18,19,3,5,27,14,4,4,22,42,16,9,67,0,0,0.0,M2019-09-08D,Race(9),,
2,9,9,0,18,19,3,5,27,14,4,4,22,42,16,9,67,0,0,3.0,M2019-09-08D,Race(9),,
3,2,3,0,5,2,14,1,17,3,7,0,10,7,24,1,32,6.5,6.5,0.0,M2019-09-08D,Race(9),,
3,2,3,0,5,2,14,1,17,3,7,0,10,7,24,1,32,6.5,6.5,0.0,M2019-09-08D,Race(9),,
4,9,5,8,22,2,6,15,23,3,8,10,21,14,19,33,66,3.6,3.6,0.0,M2019-09-08D,Race(9),,
4,9,5,8,22,2,6,15,23,3,8,10,21,14,19,33,66,3.6,3.6,1.0,M2019-09-08D,Race(9),,
5,2,3,2,7,0,0,1,1,0,1,2,3,2,4,5,11,11,11,2.0,M2019-09-08D,Race(9),,
5,2,3,2,7,0,0,1,1,0,1,2,3,2,4,5,11,11,11,0.0,M2019-09-08D,Race(9),,
6,3,0,5,8,0,2,2,4,0,0,6,6,3,2,13,18,9.5,9.5,0.0,M2019-09-08D,Race(9),,
6,3,0,5,8,0,2,2,4,0,0,6,6,3,2,13,18,9.5,9.5,0.0,M2019-09-08D,Race(9),,
7,0,0,0,0,0,0,0,0,0,0,0,0,0,0,0,0,81,81,0.0,M2019-09-08D,Race(9),,
7,0,0,0,0,0,0,0,0,0,0,0,0,0,0,0,0,81,81,0.0,M2019-09-08D,Race(9),,
8,5,2,5,12,7,3,4,14,4,4,4,12,16,9,13,38,3.4,3.4,0.0,M2019-09-08D,Race(9),,
8,5,2,5,12,7,3,4,14,4,4,4,12,16,9,13,38,3.4,3.4,0.0,M2019-09-08D,Race(9),,
9,0,0,3,3,0,1,0,1,0,0,0,0,0,1,3,4,9.5,9.5,0.0,M2019-09-08D,Race(9),,
9,0,0,3,3,0,1,0,1,0,0,0,0,0,1,3,4,9.5,9.5,0.0,M2019-09-08D,Race(9),,
10,0,0,0,0,0,0,0,0,0,0,0,0,0,0,0,0,20,20,0.0,M2019-09-08D,Race(9),,
10,0,0,0,0,0,0,0,0,0,0,0,0,0,0,0,0,20,20,0.0,M2019-09-08D,Race(9),,
11,0,5,0,5,0,1,1,2,1,0,0,1,1,6,1,8,13,13,0.0,M2019-09-08D,Race(9),,
11,0,5,0,5,0,1,1,2,1,0,0,1,1,6,1,8,13,13,0.0,M2019-09-08D,Race(9),,
12,0,3,2,5,0,0,0,0,0,0,0,0,0,3,2,5,20,20,0.0,M2019-09-08D,Race(9),,
12,0,3,2,5,0,0,0,0,0,0,0,0,0,3,2,5,20,20,0.0,M2019-09-08D,Race(9),,
1,3,8,0,11,3,4,11,18,1,7,2,10,7,19,13,39,10,10,0.0,M2019-09-11D,Race(1),,
1,3,8,0,11,3,4,11,18,1,7,2,10,7,19,13,39,10,10,0.0,M2019-09-11D,Race(1),,
2,7,4,6,17,4,1,2,7,4,1,5,10,15,6,13,34,11,11,0.0,M2019-09-11D,Race(1),,
2,7,4,6,17,4,1,2,7,4,1,5,10,15,6,13,34,11,11,1.0,M2019-09-11D,Race(1),,
3,8,7,7,22,13,7,4,24,5,9,4,18,26,23,15,64,3,3,0.0,M2019-09-11D,Race(1),,
3,8,7,7,22,13,7,4,24,5,9,4,18,26,23,15,64,3,3,3.0,M2019-09-11D,Race(1),,
4,3,8,9,20,3,0,2,5,4,2,1,7,10,10,12,32,6,6,0.0,M2019-09-11D,Race(1),,
4,3,8,9,20,3,0,2,5,4,2,1,7,10,10,12,32,6,6,0.0,M2019-09-11D,Race(1),,
5,0,0,0,0,1,0,2,3,1,0,2,3,2,0,4,6,12,12,2.0,M2019-09-11D,Race(1),,
5,0,0,0,0,1,0,2,3,1,0,2,3,2,0,4,6,12,12,0.0,M2019-09-11D,Race(1),,
6,0,0,0,0,0,1,1,2,0,2,2,4,0,3,3,6,16,16,0.0,M2019-09-11D,Race(1),,
6,0,0,0,0,0,1,1,2,0,2,2,4,0,3,3,6,16,16,0.0,M2019-09-11D,Race(1),,
7,2,0,8,10,6,15,5,26,11,4,6,21,19,19,19,57,4.2,4.2,0.0,M2019-09-11D,Race(1),,
7,2,0,8,10,6,15,5,26,11,4,6,21,19,19,19,57,4.2,4.2,0.0,M2019-09-11D,Race(1),,
8,0,0,0,0,0,0,1,1,0,0,2,2,0,0,3,3,19,19,0.0,M2019-09-11D,Race(1),,
8,0,0,0,0,0,0,1,1,0,0,2,2,0,0,3,3,19,19,0.0,M2019-09-11D,Race(1),,
9,7,3,0,10,0,2,2,4,0,1,2,3,7,6,4,17,7,7,0.0,M2019-09-11D,Race(1),,
9,7,3,0,10,0,2,2,4,0,1,2,3,7,6,4,17,7,7,0.0,M2019-09-11D,Race(1),,
1,0,0,0,0,1,2,0,3,4,1,0,5,5,3,0,8,8,8,0.0,M2019-09-11D,Race(2),,
1,0,0,0,0,1,2,0,3,4,1,0,5,5,3,0,8,8,8,0.0,M2019-09-11D,Race(2),,
2,0,0,0,0,0,0,0,0,0,0,0,0,0,0,0,0,126,126,0.0,M2019-09-11D,Race(2),,
2,0,0,0,0,0,0,0,0,0,0,0,0,0,0,0,0,126,126,1.0,M2019-09-11D,Race(2),,
3,0,0,0,0,0,0,0,0,0,0,0,0,0,0,0,0,51,51,2.0,M2019-09-11D,Race(2),,
3,0,0,0,0,0,0,0,0,0,0,0,0,0,0,0,0,51,51,0.0,M2019-09-11D,Race(2),,
4,0,2,2,4,1,1,1,3,2,1,3,6,3,4,6,13,14,14,0.0,M2019-09-11D,Race(2),,
4,0,2,2,4,1,1,1,3,2,1,3,6,3,4,6,13,14,14,0.0,M2019-09-11D,Race(2),,
5,3,11,12,26,0,2,11,13,0,5,5,10,3,18,28,49,4.2,4.2,0.0,M2019-09-11D,Race(2),,
5,3,11,12,26,0,2,11,13,0,5,5,10,3,18,28,49,4.2,4.2,0.0,M2019-09-11D,Race(2),,
6,5,6,0,11,2,1,0,3,2,2,1,5,9,9,1,19,10,10,3.0,M2019-09-11D,Race(2),,
6,5,6,0,11,2,1,0,3,2,2,1,5,9,9,1,19,10,10,0.0,M2019-09-11D,Race(2),,
7,0,0,2,2,1,2,3,6,1,8,3,12,2,10,8,20,9,9,0.0,M2019-09-11D,Race(2),,
7,0,0,2,2,1,2,3,6,1,8,3,12,2,10,8,20,9,9,0.0,M2019-09-11D,Race(2),,
8,0,0,0,0,0,0,0,0,0,0,0,0,0,0,0,0,51,51,0.0,M2019-09-11D,Race(2),,
8,0,0,0,0,0,0,0,0,0,0,0,0,0,0,0,0,51,51,0.0,M2019-09-11D,Race(2),,
9,0,9,5,14,15,4,6,25,6,1,6,13,21,14,17,52,6,6,0.0,M2019-09-11D,Race(2),,
9,0,9,5,14,15,4,6,25,6,1,6,13,21,14,17,52,6,6,0.0,M2019-09-11D,Race(2),,
10,13,0,3,16,4,2,4,10,4,2,3,9,21,4,10,35,5.5,5.5,0.0,M2019-09-11D,Race(2),,
10,13,0,3,16,4,2,4,10,4,2,3,9,21,4,10,35,5.5,5.5,0.0,M2019-09-11D,Race(2),,
11,9,2,6,17,6,16,5,27,7,6,5,18,22,24,16,62,4.2,4.2,0.0,M2019-09-11D,Race(2),,
11,9,2,6,17,6,16,5,27,7,6,5,18,22,24,16,62,4.2,4.2,0.0,M2019-09-11D,Race(2),,
1,6,2,2,10,4,12,5,21,5,4,4,13,15,18,11,44,5.5,6,0.0,M2019-09-11D,Race(3),,
1,6,2,2,10,4,12,5,21,5,4,4,13,15,18,11,44,5.5,6,2.0,M2019-09-11D,Race(3),,
2,3,7,0,10,4,5,14,23,4,4,6,14,11,16,20,47,7,7,0.0,M2019-09-11D,Race(3),,
2,3,7,0,10,4,5,14,23,4,4,6,14,11,16,20,47,7,7,0.0,M2019-09-11D,Race(3),,
3,3,6,2,11,2,1,3,6,3,2,3,8,8,9,8,25,9,9,3.0,M2019-09-11D,Race(3),,
3,3,6,2,11,2,1,3,6,3,2,3,8,8,9,8,25,9,9,0.0,M2019-09-11D,Race(3),,
4,5,5,7,17,16,8,2,26,7,7,2,16,28,20,11,59,4.8,4.6,0.0,M2019-09-11D,Race(3),,
4,5,5,7,17,16,8,2,26,7,7,2,16,28,20,11,59,4.8,4.6,0.0,M2019-09-11D,Race(3),,
5,8,2,7,17,1,3,2,6,1,2,2,5,10,7,11,28,7.5,7,0.0,M2019-09-11D,Race(3),,
5,8,2,7,17,1,3,2,6,1,2,2,5,10,7,11,28,7.5,7,1.0,M2019-09-11D,Race(3),,
6,0,3,0,3,0,1,0,1,0,0,0,0,0,4,0,4,15,15,0.0,M2019-09-11D,Race(3),,
6,0,3,0,3,0,1,0,1,0,0,0,0,0,4,0,4,15,15,0.0,M2019-09-11D,Race(3),,
7,0,0,3,3,0,0,0,0,0,1,0,1,0,1,3,4,31,31,0.0,M2019-09-11D,Race(3),,
7,0,0,3,3,0,0,0,0,0,1,0,1,0,1,3,4,31,31,0.0,M2019-09-11D,Race(3),,
8,2,0,3,5,1,0,2,3,1,1,4,6,4,1,9,14,9,9,0.0,M2019-09-11D,Race(3),,
8,2,0,3,5,1,0,2,3,1,1,4,6,4,1,9,14,9,9,0.0,M2019-09-11D,Race(3),,
9,0,0,0,0,0,0,0,0,1,1,1,3,1,1,1,3,17,17,0.0,M2019-09-11D,Race(3),,
9,0,0,0,0,0,0,0,0,1,1,1,3,1,1,1,3,17,17,0.0,M2019-09-11D,Race(3),,
10,0,5,3,8,2,0,1,3,4,4,3,11,6,9,7,22,6.5,6.5,0.0,M2019-09-11D,Race(3),,
10,0,5,3,8,2,0,1,3,4,4,3,11,6,9,7,22,6.5,6.5,0.0,M2019-09-11D,Race(3),,
11,0,0,0,0,0,0,0,0,0,0,0,0,0,0,0,0,41,41,0.0,M2019-09-11D,Race(3),,
11,0,0,0,0,0,0,0,0,0,0,0,0,0,0,0,0,41,41,0.0,M2019-09-11D,Race(3),,
12,3,0,3,6,0,0,1,1,0,0,1,1,3,0,5,8,16,16,0.0,M2019-09-11D,Race(3),,
12,3,0,3,6,0,0,1,1,0,0,1,1,3,0,5,8,16,16,0.0,M2019-09-11D,Race(3),,
1,10,8,9,27,18,7,5,30,10,8,6,24,38,23,20,81,3,3,0.0,M2019-09-11D,Race(4),,
1,10,8,9,27,18,7,5,30,10,8,6,24,38,23,20,81,3,3,0.0,M2019-09-11D,Race(4),,
2,5,3,5,13,3,6,14,23,3,8,4,15,11,17,23,51,5.5,5.5,0.0,M2019-09-11D,Race(4),,
2,5,3,5,13,3,6,14,23,3,8,4,15,11,17,23,51,5.5,5.5,0.0,M2019-09-11D,Race(4),,
3,0,0,0,0,0,0,1,1,0,0,2,2,0,0,3,3,26,26,1.0,M2019-09-11D,Race(4),,
3,0,0,0,0,0,0,1,1,0,0,2,2,0,0,3,3,26,26,2.0,M2019-09-11D,Race(4),,
4,2,0,2,4,0,1,4,5,0,3,3,6,2,4,9,15,17,17,0.0,M2019-09-11D,Race(4),,
4,2,0,2,4,0,1,4,5,0,3,3,6,2,4,9,15,17,17,0.0,M2019-09-11D,Race(4),,
5,8,12,5,25,7,16,6,29,11,6,6,23,26,34,17,77,3.5,3.5,3.0,M2019-09-11D,Race(4),,
5,8,12,5,25,7,16,6,29,11,6,6,23,26,34,17,77,3.5,3.5,0.0,M2019-09-11D,Race(4),,
6,0,0,0,0,0,0,0,0,0,0,1,1,0,0,1,1,20,20,0.0,M2019-09-11D,Race(4),,
6,0,0,0,0,0,0,0,0,0,0,1,1,0,0,1,1,20,20,0.0,M2019-09-11D,Race(4),,
7,0,0,0,0,0,0,0,0,0,0,0,0,0,0,0,0,16,16,0.0,M2019-09-11D,Race(4),,
7,0,0,0,0,0,0,0,0,0,0,0,0,0,0,0,0,16,16,0.0,M2019-09-11D,Race(4),,
8,0,0,0,0,0,0,0,0,0,0,0,0,0,0,0,0,21,21,0.0,M2019-09-11D,Race(4),,
8,0,0,0,0,0,0,0,0,0,0,0,0,0,0,0,0,21,21,0.0,M2019-09-11D,Race(4),,
9,5,7,9,21,2,0,0,2,2,1,4,7,9,8,13,30,4.6,4.6,0.0,M2019-09-11D,Race(4),,
9,5,7,9,21,2,0,0,2,2,1,4,7,9,8,13,30,4.6,4.6,0.0,M2019-09-11D,Race(4),,
1,0,4,3,7,3,2,2,7,8,4,1,13,11,10,6,27,12,12,0.0,M2019-09-11D,Race(5),,
1,0,4,3,7,3,2,2,7,8,4,1,13,11,10,6,27,12,12,0.0,M2019-09-11D,Race(5),,
2,0,4,5,9,2,4,3,9,1,3,3,7,3,11,11,25,15,15,2.0,M2019-09-11D,Race(5),,
2,0,4,5,9,2,4,3,9,1,3,3,7,3,11,11,25,15,15,0.0,M2019-09-11D,Race(5),,
3,23,0,5,28,23,3,2,28,16,5,3,24,62,8,10,80,1.95,1.95,0.0,M2019-09-11D,Race(5),,
3,23,0,5,28,23,3,2,28,16,5,3,24,62,8,10,80,1.95,1.95,0.0,M2019-09-11D,Race(5),,
4,2,11,3,16,0,6,12,18,0,8,5,13,2,25,20,47,9.5,9.5,1.0,M2019-09-11D,Race(5),,
4,2,11,3,16,0,6,12,18,0,8,5,13,2,25,20,47,9.5,9.5,3.0,M2019-09-11D,Race(5),,
5,3,9,5,17,1,15,8,24,1,5,7,13,5,29,20,54,4.6,4.6,0.0,M2019-09-11D,Race(5),,
5,3,9,5,17,1,15,8,24,1,5,7,13,5,29,20,54,4.6,4.6,0.0,M2019-09-11D,Race(5),,
6,2,0,0,2,0,0,0,0,0,0,0,0,2,0,0,2,21,21,0.0,M2019-09-11D,Race(5),,
6,2,0,0,2,0,0,0,0,0,0,0,0,2,0,0,2,21,21,0.0,M2019-09-11D,Race(5),,
7,0,2,0,2,0,0,1,1,0,0,3,3,0,2,4,6,41,41,0.0,M2019-09-11D,Race(5),,
7,0,2,0,2,0,0,1,1,0,0,3,3,0,2,4,6,41,41,0.0,M2019-09-11D,Race(5),,
8,0,0,2,2,0,0,0,0,0,1,0,1,0,1,2,3,19,19,0.0,M2019-09-11D,Race(5),,
8,0,0,2,2,0,0,0,0,0,1,0,1,0,1,2,3,19,19,0.0,M2019-09-11D,Race(5),,
9,0,0,4,4,1,0,1,2,0,0,2,2,1,0,7,8,18,18,0.0,M2019-09-11D,Race(5),,
9,0,0,4,4,1,0,1,2,0,0,2,2,1,0,7,8,18,18,0.0,M2019-09-11D,Race(5),,
10,0,0,0,0,0,0,0,0,0,0,1,1,0,0,1,1,51,51,0.0,M2019-09-11D,Race(5),,
10,0,0,0,0,0,0,0,0,0,0,1,1,0,0,1,1,51,51,0.0,M2019-09-11D,Race(5),,
11,0,0,0,0,0,0,1,1,0,0,1,1,0,0,2,2,26,26,0.0,M2019-09-11D,Race(5),,
11,0,0,0,0,0,0,1,1,0,0,1,1,0,0,2,2,26,26,0.0,M2019-09-11D,Race(5),,
12,0,0,3,3,0,0,0,0,0,0,0,0,0,0,3,3,18,18,0.0,M2019-09-11D,Race(5),,
12,0,0,3,3,0,0,0,0,0,0,0,0,0,0,3,3,18,18,0.0,M2019-09-11D,Race(5),,
1,9,6,5,20,16,7,3,26,7,7,4,18,32,20,12,64,3.5,3.5,0.0,M2019-09-11D,Race(6),,
1,9,6,5,20,16,7,3,26,7,7,4,18,32,20,12,64,3.5,3.5,0.0,M2019-09-11D,Race(6),,
2,3,0,2,5,2,2,0,4,2,0,1,3,7,2,3,12,17,17,0.0,M2019-09-11D,Race(6),,
2,3,0,2,5,2,2,0,4,2,0,1,3,7,2,3,12,17,17,2.0,M2019-09-11D,Race(6),,
3,0,0,0,0,0,0,0,0,0,0,1,1,0,0,1,1,41,41,0.0,M2019-09-11D,Race(6),,
3,0,0,0,0,0,0,0,0,0,0,1,1,0,0,1,1,41,41,0.0,M2019-09-11D,Race(6),,
4,0,0,2,2,0,0,1,1,0,0,1,1,0,0,4,4,16,16,0.0,M2019-09-11D,Race(6),,
4,0,0,2,2,0,0,1,1,0,0,1,1,0,0,4,4,16,16,0.0,M2019-09-11D,Race(6),,
5,4,2,3,9,1,1,4,6,0,0,3,3,5,3,10,18,8.5,8.5,0.0,M2019-09-11D,Race(6),,
5,4,2,3,9,1,1,4,6,0,0,3,3,5,3,10,18,8.5,8.5,3.0,M2019-09-11D,Race(6),,
6,0,3,0,3,1,1,0,2,1,2,0,3,2,6,0,8,12,12,1.0,M2019-09-11D,Race(6),,
6,0,3,0,3,1,1,0,2,1,2,0,3,2,6,0,8,12,12,0.0,M2019-09-11D,Race(6),,
7,5,6,2,13,6,13,5,24,9,6,2,17,20,25,9,54,5.5,5.5,0.0,M2019-09-11D,Race(6),,
7,5,6,2,13,6,13,5,24,9,6,2,17,20,25,9,54,5.5,5.5,0.0,M2019-09-11D,Race(6),,
8,0,2,5,7,1,4,13,18,3,2,3,8,4,8,21,33,9.5,9.5,0.0,M2019-09-11D,Race(6),,
8,0,2,5,7,1,4,13,18,3,2,3,8,4,8,21,33,9.5,9.5,0.0,M2019-09-11D,Race(6),,
9,2,0,0,2,0,0,0,0,0,0,0,0,2,0,0,2,26,26,0.0,M2019-09-11D,Race(6),,
9,2,0,0,2,0,0,0,0,0,0,0,0,2,0,0,2,26,26,0.0,M2019-09-11D,Race(6),,
10,5,11,6,22,1,1,1,3,2,6,5,13,8,18,12,38,6,6,0.0,M2019-09-11D,Race(6),,
10,5,11,6,22,1,1,1,3,2,6,5,13,8,18,12,38,6,6,0.0,M2019-09-11D,Race(6),,
11,2,0,5,7,2,1,1,4,2,3,5,10,6,4,11,21,8,8,0.0,M2019-09-11D,Race(6),,
11,2,0,5,7,2,1,1,4,2,3,5,10,6,4,11,21,8,8,0.0,M2019-09-11D,Race(6),,
12,0,0,0,0,0,0,2,2,0,0,1,1,0,0,3,3,34,34,0.0,M2019-09-11D,Race(6),,
12,0,0,0,0,0,0,2,2,0,0,1,1,0,0,3,3,34,34,0.0,M2019-09-11D,Race(6),,
1,5,0,5,10,0,1,0,1,0,1,1,2,5,2,6,13,17,17,0.0,M2019-09-11D,Race(7),,
1,5,0,5,10,0,1,0,1,0,1,1,2,5,2,6,13,17,17,2.0,M2019-09-11D,Race(7),,
2,7,11,2,20,6,13,3,22,3,7,2,12,16,31,7,54,6,6,0.0,M2019-09-11D,Race(7),,
2,7,11,2,20,6,13,3,22,3,7,2,12,16,31,7,54,6,6,0.0,M2019-09-11D,Race(7),,
3,2,0,6,8,3,5,11,19,5,6,4,15,10,11,21,42,11,11,0.0,M2019-09-11D,Race(7),,
3,2,0,6,8,3,5,11,19,5,6,4,15,10,11,21,42,11,11,0.0,M2019-09-11D,Race(7),,
4,5,4,2,11,2,3,4,9,3,2,2,7,10,9,8,27,7,7,0.0,M2019-09-11D,Race(7),,
4,5,4,2,11,2,3,4,9,3,2,2,7,10,9,8,27,7,7,0.0,M2019-09-11D,Race(7),,
5,0,4,7,11,0,2,2,4,0,0,1,1,0,6,10,16,14,14,0.0,M2019-09-11D,Race(7),,
5,0,4,7,11,0,2,2,4,0,0,1,1,0,6,10,16,14,14,3.0,M2019-09-11D,Race(7),,
6,0,0,0,0,0,0,0,0,1,0,0,1,1,0,0,1,26,26,1.0,M2019-09-11D,Race(7),,
6,0,0,0,0,0,0,0,0,1,0,0,1,1,0,0,1,26,26,0.0,M2019-09-11D,Race(7),,
7,0,0,0,0,0,0,1,1,0,1,2,3,0,1,3,4,41,41,0.0,M2019-09-11D,Race(7),,
7,0,0,0,0,0,0,1,1,0,1,2,3,0,1,3,4,41,41,0.0,M2019-09-11D,Race(7),,
8,0,2,0,2,2,0,1,3,2,0,2,4,4,2,3,9,12,12,0.0,M2019-09-11D,Race(7),,
8,0,2,0,2,2,0,1,3,2,0,2,4,4,2,3,9,12,12,0.0,M2019-09-11D,Race(7),,
9,0,0,0,0,0,1,0,1,1,3,0,4,1,4,0,5,26,26,0.0,M2019-09-11D,Race(7),,
9,0,0,0,0,0,1,0,1,1,3,0,4,1,4,0,5,26,26,0.0,M2019-09-11D,Race(7),,
10,5,6,3,14,15,5,6,26,10,6,5,21,30,17,14,61,3.8,3.8,0.0,M2019-09-11D,Race(7),,
10,5,6,3,14,15,5,6,26,10,6,5,21,30,17,14,61,3.8,3.8,0.0,M2019-09-11D,Race(7),,
11,6,3,5,14,2,0,1,3,1,0,5,6,9,3,11,23,4,4,0.0,M2019-09-11D,Race(7),,
11,6,3,5,14,2,0,1,3,1,0,5,6,9,3,11,23,4,4,0.0,M2019-09-11D,Race(7),,
12,0,0,0,0,0,0,1,1,0,0,2,2,0,0,3,3,20,20,0.0,M2019-09-11D,Race(7),,
12,0,0,0,0,0,0,1,1,0,0,2,2,0,0,3,3,20,20,0.0,M2019-09-11D,Race(7),,
1,0,3,0,3,1,0,0,1,2,2,0,4,3,5,0,8,12,12,0.0,M2019-09-11D,Race(8),,
1,0,3,0,3,1,0,0,1,2,2,0,4,3,5,0,8,12,12,0.0,M2019-09-11D,Race(8),,
2,0,0,0,0,1,0,0,1,1,1,0,2,2,1,0,3,51,51,0.0,M2019-09-11D,Race(8),,
2,0,0,0,0,1,0,0,1,1,1,0,2,2,1,0,3,51,51,3.0,M2019-09-11D,Race(8),,
3,0,0,3,3,0,2,3,5,0,0,7,7,0,2,13,15,19,19,0.0,M2019-09-11D,Race(8),,
3,0,0,3,3,0,2,3,5,0,0,7,7,0,2,13,15,19,19,0.0,M2019-09-11D,Race(8),,
4,6,14,0,20,15,4,2,21,9,4,2,15,30,22,4,56,4.8,4.8,1.0,M2019-09-11D,Race(8),,
4,6,14,0,20,15,4,2,21,9,4,2,15,30,22,4,56,4.8,4.8,0.0,M2019-09-11D,Race(8),,
5,0,0,2,2,0,1,1,2,0,0,0,0,0,1,3,4,14,14,0.0,M2019-09-11D,Race(8),,
5,0,0,2,2,0,1,1,2,0,0,0,0,0,1,3,4,14,14,0.0,M2019-09-11D,Race(8),,
6,0,3,12,15,2,6,12,20,3,5,2,10,5,14,26,45,7.5,7.5,2.0,M2019-09-11D,Race(8),,
6,0,3,12,15,2,6,12,20,3,5,2,10,5,14,26,45,7.5,7.5,0.0,M2019-09-11D,Race(8),,
7,18,6,3,27,6,14,8,28,6,7,7,20,30,27,18,75,2.8,2.8,0.0,M2019-09-11D,Race(8),,
7,18,6,3,27,6,14,8,28,6,7,7,20,30,27,18,75,2.8,2.8,0.0,M2019-09-11D,Race(8),,
8,0,0,0,0,0,0,0,0,0,0,0,0,0,0,0,0,26,26,0.0,M2019-09-11D,Race(8),,
8,0,0,0,0,0,0,0,0,0,0,0,0,0,0,0,0,26,26,0.0,M2019-09-11D,Race(8),,
9,6,4,2,12,2,2,4,8,1,5,6,12,9,11,12,32,8.5,8.5,0.0,M2019-09-11D,Race(8),,
9,6,4,2,12,2,2,4,8,1,5,6,12,9,11,12,32,8.5,8.5,0.0,M2019-09-11D,Race(8),,
10,0,0,5,5,3,1,0,4,4,2,1,7,7,3,6,16,12,12,0.0,M2019-09-11D,Race(8),,
10,0,0,5,5,3,1,0,4,4,2,1,7,7,3,6,16,12,12,0.0,M2019-09-11D,Race(8),,
11,0,0,0,0,0,0,0,0,0,0,0,0,0,0,0,0,13,13,0.0,M2019-09-11D,Race(8),,
11,0,0,0,0,0,0,0,0,0,0,0,0,0,0,0,0,13,13,0.0,M2019-09-11D,Race(8),,
12,0,0,3,3,0,0,0,0,0,0,1,1,0,0,4,4,31,31,0.0,M2019-09-11D,Race(8),,
12,0,0,3,3,0,0,0,0,0,0,1,1,0,0,4,4,31,31,0.0,M2019-09-11D,Race(8),,
1,2,0,9,11,1,4,1,6,1,5,2,8,4,9,12,25,11,10,0.0,M2019-09-15D,Race(1),,
1,2,0,9,11,1,4,1,6,1,5,2,8,4,9,12,25,11,10,0.0,M2019-09-15D,Race(1),,
2,0,7,0,7,1,1,13,15,0,2,6,8,1,10,19,30,11,11,1.0,M2019-09-15D,Race(1),,
2,0,7,0,7,1,1,13,15,0,2,6,8,1,10,19,30,11,11,2.0,M2019-09-15D,Race(1),,
3,11,10,2,23,21,5,2,28,17,3,3,23,49,18,7,74,2.25,2.25,0.0,M2019-09-15D,Race(1),,
3,11,10,2,23,21,5,2,28,17,3,3,23,49,18,7,74,2.25,2.25,3.0,M2019-09-15D,Race(1),,
4,8,0,15,23,4,14,4,22,2,6,3,11,14,20,22,56,5,5,0.0,M2019-09-15D,Race(1),,
4,8,0,15,23,4,14,4,22,2,6,3,11,14,20,22,56,5,5,0.0,M2019-09-15D,Race(1),,
5,0,0,0,0,0,0,1,1,1,2,4,7,1,2,5,8,13,12,0.0,M2019-09-15D,Race(1),,
5,0,0,0,0,0,0,1,1,1,2,4,7,1,2,5,8,13,12,0.0,M2019-09-15D,Race(1),,
6,0,5,2,7,0,1,2,3,0,2,2,4,0,8,6,14,7.5,8,0.0,M2019-09-15D,Race(1),,
6,0,5,2,7,0,1,2,3,0,2,2,4,0,8,6,14,7.5,8,0.0,M2019-09-15D,Race(1),,
7,9,8,2,19,2,5,5,12,4,6,3,13,15,19,10,44,5,5,0.0,M2019-09-15D,Race(1),,
7,9,8,2,19,2,5,5,12,4,6,3,13,15,19,10,44,5,5,0.0,M2019-09-15D,Race(1),,
8,0,0,0,0,1,0,2,3,1,0,3,4,2,0,5,7,26,26,0.0,M2019-09-15D,Race(1),,
8,0,0,0,0,1,0,2,3,1,0,3,4,2,0,5,7,26,26,0.0,M2019-09-15D,Race(1),,
1,0,16,9,25,3,6,9,18,4,6,2,12,7,28,20,55,6.5,6.5,0.0,M2019-09-15D,Race(10),,
1,0,16,9,25,3,6,9,18,4,6,2,12,7,28,20,55,6.5,6.5,2.0,M2019-09-15D,Race(10),,
2,0,0,0,0,0,0,0,0,1,0,0,1,1,0,0,1,51,51,1.0,M2019-09-15D,Race(10),,
2,0,0,0,0,0,0,0,0,1,0,0,1,1,0,0,1,51,51,0.0,M2019-09-15D,Race(10),,
3,28,2,0,30,20,5,4,29,13,6,5,24,61,13,9,83,3,3,0.0,M2019-09-15D,Race(10),,
3,28,2,0,30,20,5,4,29,13,6,5,24,61,13,9,83,3,3,0.0,M2019-09-15D,Race(10),,
4,0,3,0,3,2,0,1,3,2,0,0,2,4,3,1,8,19,19,0.0,M2019-09-15D,Race(10),,
4,0,3,0,3,2,0,1,3,2,0,0,2,4,3,1,8,19,19,0.0,M2019-09-15D,Race(10),,
5,0,0,0,0,0,0,0,0,0,0,0,0,0,0,0,0,71,67,3.0,M2019-09-15D,Race(10),,
5,0,0,0,0,0,0,0,0,0,0,0,0,0,0,0,0,71,67,0.0,M2019-09-15D,Race(10),,
6,0,0,0,0,0,0,0,0,0,0,0,0,0,0,0,0,61,61,0.0,M2019-09-15D,Race(10),,
6,0,0,0,0,0,0,0,0,0,0,0,0,0,0,0,0,61,61,0.0,M2019-09-15D,Race(10),,
7,0,0,6,6,2,0,3,5,3,3,5,11,5,3,14,22,15,15,0.0,M2019-09-15D,Race(10),,
7,0,0,6,6,2,0,3,5,3,3,5,11,5,3,14,22,15,15,0.0,M2019-09-15D,Race(10),,
8,0,0,2,2,0,13,4,17,0,4,3,7,0,17,9,26,5.5,5.5,0.0,M2019-09-15D,Race(10),,
8,0,0,2,2,0,13,4,17,0,4,3,7,0,17,9,26,5.5,5.5,0.0,M2019-09-15D,Race(10),,
9,2,7,5,14,1,2,0,3,1,3,1,5,4,12,6,22,11,11,0.0,M2019-09-15D,Race(10),,
9,2,7,5,14,1,2,0,3,1,3,1,5,4,12,6,22,11,11,0.0,M2019-09-15D,Race(10),,
10,0,0,0,0,1,0,1,2,0,1,1,2,1,1,2,4,34,34,0.0,M2019-09-15D,Race(10),,
10,0,0,0,0,1,0,1,2,0,1,1,2,1,1,2,4,34,34,0.0,M2019-09-15D,Race(10),,
11,0,2,8,10,0,3,5,8,0,3,4,7,0,8,17,25,7,7,0.0,M2019-09-15D,Race(10),,
11,0,2,8,10,0,3,5,8,0,3,4,7,0,8,17,25,7,7,0.0,M2019-09-15D,Race(10),,
12,0,0,0,0,0,0,1,1,1,0,1,2,1,0,2,3,13,13,0.0,M2019-09-15D,Race(10),,
12,0,0,0,0,0,0,1,1,1,0,1,2,1,0,2,3,13,13,0.0,M2019-09-15D,Race(10),,
13,0,0,0,0,1,1,2,4,1,0,4,5,2,1,6,9,12,12,0.0,M2019-09-15D,Race(10),,
13,0,0,0,0,1,1,2,4,1,0,4,5,2,1,6,9,12,12,0.0,M2019-09-15D,Race(10),,
14,0,0,0,0,0,0,0,0,0,0,0,0,0,0,0,0,71,67,0.0,M2019-09-15D,Race(10),,
14,0,0,0,0,0,0,0,0,0,0,0,0,0,0,0,0,71,67,0.0,M2019-09-15D,Race(10),,
1,0,3,0,3,1,3,5,9,0,5,4,9,1,11,9,21,12,12,0.0,M2019-09-15D,Race(2),,
1,0,3,0,3,1,3,5,9,0,5,4,9,1,11,9,21,12,12,0.0,M2019-09-15D,Race(2),,
2,0,0,2,2,0,0,0,0,1,0,0,1,1,0,2,3,16,16,2.0,M2019-09-15D,Race(2),,
2,0,0,2,2,0,0,0,0,1,0,0,1,1,0,2,3,16,16,1.0,M2019-09-15D,Race(2),,
3,11,12,7,30,6,17,4,27,2,10,9,21,19,39,20,78,3.3,3.3,0.0,M2019-09-15D,Race(2),,
3,11,12,7,30,6,17,4,27,2,10,9,21,19,39,20,78,3.3,3.3,0.0,M2019-09-15D,Race(2),,
4,15,13,0,28,21,7,2,30,21,4,0,25,57,24,2,83,2.3,2.3,0.0,M2019-09-15D,Race(2),,
4,15,13,0,28,21,7,2,30,21,4,0,25,57,24,2,83,2.3,2.3,3.0,M2019-09-15D,Race(2),,
5,2,0,5,7,0,2,3,5,0,1,1,2,2,3,9,14,9,9,0.0,M2019-09-15D,Race(2),,
5,2,0,5,7,0,2,3,5,0,1,1,2,2,3,9,14,9,9,0.0,M2019-09-15D,Race(2),,
6,0,2,4,6,0,0,2,2,0,1,2,3,0,3,8,11,11,11,0.0,M2019-09-15D,Race(2),,
6,0,2,4,6,0,0,2,2,0,1,2,3,0,3,8,11,11,11,0.0,M2019-09-15D,Race(2),,
7,0,0,0,0,0,1,0,1,0,2,0,2,0,3,0,3,31,31,0.0,M2019-09-15D,Race(2),,
7,0,0,0,0,0,1,0,1,0,2,0,2,0,3,0,3,31,31,0.0,M2019-09-15D,Race(2),,
8,2,0,9,11,2,0,14,16,2,1,9,12,6,1,32,39,9,9,0.0,M2019-09-15D,Race(2),,
8,2,0,9,11,2,0,14,16,2,1,9,12,6,1,32,39,9,9,0.0,M2019-09-15D,Race(2),,
9,0,0,3,3,0,0,0,0,0,2,1,3,0,2,4,6,21,21,0.0,M2019-09-15D,Race(2),,
9,0,0,3,3,0,0,0,0,0,2,1,3,0,2,4,6,21,21,0.0,M2019-09-15D,Race(2),,
1,6,8,5,19,2,5,14,21,1,7,6,14,9,20,25,54,4.8,4.8,1.0,M2019-09-15D,Race(3),,
1,6,8,5,19,2,5,14,21,1,7,6,14,9,20,25,54,4.8,4.8,2.0,M2019-09-15D,Race(3),,
2,16,6,2,24,4,15,10,29,2,10,12,24,22,31,24,77,4,4,0.0,M2019-09-15D,Race(3),,
2,16,6,2,24,4,15,10,29,2,10,12,24,22,31,24,77,4,4,0.0,M2019-09-15D,Race(3),,
3,0,0,0,0,0,2,0,2,0,3,0,3,0,5,0,5,26,26,0.0,M2019-09-15D,Race(3),,
3,0,0,0,0,0,2,0,2,0,3,0,3,0,5,0,5,26,26,3.0,M2019-09-15D,Race(3),,
4,0,2,3,5,0,0,0,0,0,1,0,1,0,3,3,6,26,26,0.0,M2019-09-15D,Race(3),,
4,0,2,3,5,0,0,0,0,0,1,0,1,0,3,3,6,26,26,0.0,M2019-09-15D,Race(3),,
5,0,0,7,7,0,0,4,4,0,0,4,4,0,0,15,15,12,12,0.0,M2019-09-15D,Race(3),,
5,0,0,7,7,0,0,4,4,0,0,4,4,0,0,15,15,12,12,0.0,M2019-09-15D,Race(3),,
6,8,14,8,30,24,6,0,30,23,2,1,26,55,22,9,86,2.4,2.4,0.0,M2019-09-15D,Race(3),,
6,8,14,8,30,24,6,0,30,23,2,1,26,55,22,9,86,2.4,2.4,0.0,M2019-09-15D,Race(3),,
7,0,0,0,0,0,2,1,3,0,1,2,3,0,3,3,6,21,21,0.0,M2019-09-15D,Race(3),,
7,0,0,0,0,0,2,1,3,0,1,2,3,0,3,3,6,21,21,0.0,M2019-09-15D,Race(3),,
8,0,0,0,0,0,0,0,0,0,0,1,1,0,0,1,1,31,31,0.0,M2019-09-15D,Race(3),,
8,0,0,0,0,0,0,0,0,0,0,1,1,0,0,1,1,31,31,0.0,M2019-09-15D,Race(3),,
9,0,0,5,5,0,0,1,1,0,1,0,1,0,1,6,7,11,11,0.0,M2019-09-15D,Race(3),,
9,0,0,5,5,0,0,1,1,0,1,0,1,0,1,6,7,11,11,0.0,M2019-09-15D,Race(3),,
10,0,0,0,0,0,0,0,0,0,1,0,1,0,1,0,1,41,41,0.0,M2019-09-15D,Race(3),,
10,0,0,0,0,0,0,0,0,0,1,0,1,0,1,0,1,41,41,0.0,M2019-09-15D,Race(3),,
11,0,0,0,0,0,0,0,0,0,0,0,0,0,0,0,0,31,31,0.0,M2019-09-15D,Race(3),,
11,0,0,0,0,0,0,0,0,0,0,0,0,0,0,0,0,31,31,0.0,M2019-09-15D,Race(3),,
12,0,0,0,0,0,0,0,0,0,0,0,0,0,0,0,0,61,61,0.0,M2019-09-15D,Race(3),,
12,0,0,0,0,0,0,0,0,0,0,0,0,0,0,0,0,61,61,0.0,M2019-09-15D,Race(3),,
1,2,8,8,18,4,3,3,10,4,2,5,11,10,13,16,39,13,13,3.0,M2019-09-15D,Race(4),,
1,2,8,8,18,4,3,3,10,4,2,5,11,10,13,16,39,13,13,0.0,M2019-09-15D,Race(4),,
2,10,5,0,15,4,4,14,22,5,2,5,12,19,11,19,49,6,6,1.0,M2019-09-15D,Race(4),,
2,10,5,0,15,4,4,14,22,5,2,5,12,19,11,19,49,6,6,0.0,M2019-09-15D,Race(4),,
3,9,2,4,15,3,1,3,7,3,3,4,10,15,6,11,32,6,6,0.0,M2019-09-15D,Race(4),,
3,9,2,4,15,3,1,3,7,3,3,4,10,15,6,11,32,6,6,0.0,M2019-09-15D,Race(4),,
4,0,0,0,0,0,1,0,1,0,1,0,1,0,2,0,2,26,26,0.0,M2019-09-15D,Race(4),,
4,0,0,0,0,0,1,0,1,0,1,0,1,0,2,0,2,26,26,2.0,M2019-09-15D,Race(4),,
5,4,0,3,7,3,3,3,9,6,2,2,10,13,5,8,26,7,7,0.0,M2019-09-15D,Race(4),,
5,4,0,3,7,3,3,3,9,6,2,2,10,13,5,8,26,7,7,0.0,M2019-09-15D,Race(4),,
6,0,2,0,2,1,0,0,1,0,0,0,0,1,2,0,3,18,18,0.0,M2019-09-15D,Race(4),,
6,0,2,0,2,1,0,0,1,0,0,0,0,1,2,0,3,18,18,0.0,M2019-09-15D,Race(4),,
7,0,5,0,5,2,3,2,7,0,4,2,6,2,12,4,18,8,8,0.0,M2019-09-15D,Race(4),,
7,0,5,0,5,2,3,2,7,0,4,2,6,2,12,4,18,8,8,0.0,M2019-09-15D,Race(4),,
8,0,5,8,13,0,11,2,13,1,7,1,9,1,23,11,35,7.5,7.5,0.0,M2019-09-15D,Race(4),,
8,0,5,8,13,0,11,2,13,1,7,1,9,1,23,11,35,7.5,7.5,0.0,M2019-09-15D,Race(4),,
9,5,3,5,13,13,3,2,18,6,4,5,15,24,10,12,46,4.2,4.6,0.0,M2019-09-15D,Race(4),,
9,5,3,5,13,13,3,2,18,6,4,5,15,24,10,12,46,4.2,4.6,0.0,M2019-09-15D,Race(4),,
10,0,0,0,0,0,1,1,2,0,1,0,1,0,2,1,3,19,19,0.0,M2019-09-15D,Race(4),,
10,0,0,0,0,0,1,1,2,0,1,0,1,0,2,1,3,19,19,0.0,M2019-09-15D,Race(4),,
11,0,0,0,0,0,0,0,0,1,0,0,1,1,0,0,1,61,61,0.0,M2019-09-15D,Race(4),,
11,0,0,0,0,0,0,0,0,1,0,0,1,1,0,0,1,61,61,0.0,M2019-09-15D,Race(4),,
12,0,0,0,0,0,0,0,0,0,0,0,0,0,0,0,0,81,81,0.0,M2019-09-15D,Race(4),,
12,0,0,0,0,0,0,0,0,0,0,0,0,0,0,0,0,81,81,0.0,M2019-09-15D,Race(4),,
13,0,0,2,2,0,0,0,0,0,0,1,1,0,0,3,3,18,18,0.0,M2019-09-15D,Race(4),,
13,0,0,2,2,0,0,0,0,0,0,1,1,0,0,3,3,18,18,0.0,M2019-09-15D,Race(4),,
14,0,0,0,0,0,0,0,0,0,0,1,1,0,0,1,1,51,51,0.0,M2019-09-15D,Race(4),,
14,0,0,0,0,0,0,0,0,0,0,1,1,0,0,1,1,51,51,0.0,M2019-09-15D,Race(4),,
1,4,10,10,24,17,6,5,28,8,11,3,22,29,27,18,74,4,4,0.0,M2019-09-15D,Race(5),,
1,4,10,10,24,17,6,5,28,8,11,3,22,29,27,18,74,4,4,0.0,M2019-09-15D,Race(5),,
2,0,0,0,0,0,0,1,1,0,0,1,1,0,0,2,2,51,51,1.0,M2019-09-15D,Race(5),,
2,0,0,0,0,0,0,1,1,0,0,1,1,0,0,2,2,51,51,0.0,M2019-09-15D,Race(5),,
3,6,0,8,14,2,5,4,11,2,5,2,9,10,10,14,34,4.2,4.2,0.0,M2019-09-15D,Race(5),,
3,6,0,8,14,2,5,4,11,2,5,2,9,10,10,14,34,4.2,4.2,3.0,M2019-09-15D,Race(5),,
4,0,3,0,3,0,0,1,1,0,0,1,1,0,3,2,5,26,26,0.0,M2019-09-15D,Race(5),,
4,0,3,0,3,0,0,1,1,0,0,1,1,0,3,2,5,26,26,2.0,M2019-09-15D,Race(5),,
5,0,0,0,0,0,0,0,0,2,0,0,2,2,0,0,2,34,34,0.0,M2019-09-15D,Race(5),,
5,0,0,0,0,0,0,0,0,2,0,0,2,2,0,0,2,34,34,0.0,M2019-09-15D,Race(5),,
6,9,5,5,19,1,3,13,17,2,3,9,14,12,11,27,50,4.8,4.8,0.0,M2019-09-15D,Race(5),,
6,9,5,5,19,1,3,13,17,2,3,9,14,12,11,27,50,4.8,4.8,0.0,M2019-09-15D,Race(5),,
7,0,2,0,2,0,0,0,0,0,0,1,1,0,2,1,3,21,21,0.0,M2019-09-15D,Race(5),,
7,0,2,0,2,0,0,0,0,0,0,1,1,0,2,1,3,21,21,0.0,M2019-09-15D,Race(5),,
8,11,10,5,26,10,16,3,29,12,6,2,20,33,32,10,75,2.7,2.7,0.0,M2019-09-15D,Race(5),,
8,11,10,5,26,10,16,3,29,12,6,2,20,33,32,10,75,2.7,2.7,0.0,M2019-09-15D,Race(5),,
9,0,0,0,0,0,0,0,0,0,0,0,0,0,0,0,0,34,34,0.0,M2019-09-15D,Race(5),,
9,0,0,0,0,0,0,0,0,0,0,0,0,0,0,0,0,34,34,0.0,M2019-09-15D,Race(5),,
10,0,0,2,2,0,0,3,3,0,1,7,8,0,1,12,13,21,21,0.0,M2019-09-15D,Race(5),,
10,0,0,2,2,0,0,3,3,0,1,7,8,0,1,12,13,21,21,0.0,M2019-09-15D,Race(5),,
1,0,0,0,0,0,2,2,4,0,2,3,5,0,4,5,9,16,16,0.0,M2019-09-15D,Race(6),,
1,0,0,0,0,0,2,2,4,0,2,3,5,0,4,5,9,16,16,0.0,M2019-09-15D,Race(6),,
2,5,5,11,21,9,7,13,29,6,5,3,14,20,17,27,64,4.2,4.2,0.0,M2019-09-15D,Race(6),,
2,5,5,11,21,9,7,13,29,6,5,3,14,20,17,27,64,4.2,4.2,0.0,M2019-09-15D,Race(6),,
3,0,0,0,0,0,0,0,0,0,0,0,0,0,0,0,0,101,101,3.0,M2019-09-15D,Race(6),,
3,0,0,0,0,0,0,0,0,0,0,0,0,0,0,0,0,101,101,1.0,M2019-09-15D,Race(6),,
4,2,0,2,4,0,0,1,1,1,3,1,5,3,3,4,10,12,12,0.0,M2019-09-15D,Race(6),,
4,2,0,2,4,0,0,1,1,1,3,1,5,3,3,4,10,12,12,2.0,M2019-09-15D,Race(6),,
5,5,12,6,23,8,16,3,27,4,7,7,18,17,35,16,68,6,6,0.0,M2019-09-15D,Race(6),,
5,5,12,6,23,8,16,3,27,4,7,7,18,17,35,16,68,6,6,0.0,M2019-09-15D,Race(6),,
6,15,8,2,25,9,0,5,14,0,0,0,0,24,8,7,39,2.8,2.8,0.0,M2019-09-15D,Race(6),,
6,15,8,2,25,9,0,5,14,0,0,0,0,24,8,7,39,2.8,2.8,0.0,M2019-09-15D,Race(6),,
7,0,0,4,4,1,1,3,5,0,1,1,2,1,2,8,11,12,12,0.0,M2019-09-15D,Race(6),,
7,0,0,4,4,1,1,3,5,0,1,1,2,1,2,8,11,12,12,0.0,M2019-09-15D,Race(6),,
8,0,0,0,0,0,0,1,1,0,1,1,2,0,1,2,3,13,13,0.0,M2019-09-15D,Race(6),,
8,0,0,0,0,0,0,1,1,0,1,1,2,0,1,2,3,13,13,0.0,M2019-09-15D,Race(6),,
9,0,0,0,0,0,0,0,0,0,0,0,0,0,0,0,0,101,101,0.0,M2019-09-15D,Race(6),,
9,0,0,0,0,0,0,0,0,0,0,0,0,0,0,0,0,101,101,0.0,M2019-09-15D,Race(6),,
10,0,0,0,0,0,0,1,1,1,0,1,2,1,0,2,3,41,41,0.0,M2019-09-15D,Race(6),,
10,0,0,0,0,0,0,1,1,1,0,1,2,1,0,2,3,41,41,0.0,M2019-09-15D,Race(6),,
11,0,2,0,2,0,0,0,0,0,0,0,0,0,2,0,2,31,31,0.0,M2019-09-15D,Race(6),,
11,0,2,0,2,0,0,0,0,0,0,0,0,0,2,0,2,31,31,0.0,M2019-09-15D,Race(6),,
12,3,3,5,11,3,4,1,8,4,2,3,9,10,9,9,28,7.5,7.5,0.0,M2019-09-15D,Race(6),,
12,3,3,5,11,3,4,1,8,4,2,3,9,10,9,9,28,7.5,7.5,0.0,M2019-09-15D,Race(6),,
1,0,0,2,2,5,0,3,8,7,1,2,10,12,1,7,20,0,0,0.0,M2019-09-15D,Race(7),,
1,0,0,2,2,5,0,3,8,7,1,2,10,12,1,7,20,0,0,0.0,M2019-09-15D,Race(7),,
2,5,0,7,12,3,14,6,23,2,5,7,14,10,19,20,49,15,15,0.0,M2019-09-15D,Race(7),,
2,5,0,7,12,3,14,6,23,2,5,7,14,10,19,20,49,15,15,0.0,M2019-09-15D,Race(7),,
3,0,0,0,0,0,0,0,0,0,0,0,0,0,0,0,0,31,31,1.0,M2019-09-15D,Race(7),,
3,0,0,0,0,0,0,0,0,0,0,0,0,0,0,0,0,31,31,0.0,M2019-09-15D,Race(7),,
4,3,4,2,9,1,1,0,2,2,0,0,2,6,5,2,13,8,8,0.0,M2019-09-15D,Race(7),,
4,3,4,2,9,1,1,0,2,2,0,0,2,6,5,2,13,8,8,0.0,M2019-09-15D,Race(7),,
5,0,3,0,3,1,2,12,15,1,7,5,13,2,12,17,31,12,12,0.0,M2019-09-15D,Race(7),,
5,0,3,0,3,1,2,12,15,1,7,5,13,2,12,17,31,12,12,0.0,M2019-09-15D,Race(7),,
6,7,10,3,20,4,6,3,13,5,3,5,13,16,19,11,46,3.4,3.6,2.0,M2019-09-15D,Race(7),,
6,7,10,3,20,4,6,3,13,5,3,5,13,16,19,11,46,3.4,3.6,0.0,M2019-09-15D,Race(7),,
7,0,0,0,0,0,0,0,0,0,0,0,0,0,0,0,0,51,61,0.0,M2019-09-15D,Race(7),,
7,0,0,0,0,0,0,0,0,0,0,0,0,0,0,0,0,51,61,3.0,M2019-09-15D,Race(7),,
8,2,0,0,2,0,0,0,0,0,0,0,0,2,0,0,2,18,18,0.0,M2019-09-15D,Race(7),,
8,2,0,0,2,0,0,0,0,0,0,0,0,2,0,0,2,18,18,0.0,M2019-09-15D,Race(7),,
9,2,2,0,4,0,0,0,0,0,3,0,3,2,5,0,7,21,21,0.0,M2019-09-15D,Race(7),,
9,2,2,0,4,0,0,0,0,0,3,0,3,2,5,0,7,21,21,0.0,M2019-09-15D,Race(7),,
10,0,3,0,3,0,0,0,0,0,0,0,0,0,3,0,3,26,26,0.0,M2019-09-15D,Race(7),,
10,0,3,0,3,0,0,0,0,0,0,0,0,0,3,0,3,26,26,0.0,M2019-09-15D,Race(7),,
11,3,3,3,9,0,2,2,4,0,2,4,6,3,7,9,19,9,9,0.0,M2019-09-15D,Race(7),,
11,3,3,3,9,0,2,2,4,0,2,4,6,3,7,9,19,9,9,0.0,M2019-09-15D,Race(7),,
12,8,5,8,21,14,3,2,19,7,2,0,9,29,10,10,49,3.8,4,0.0,M2019-09-15D,Race(7),,
12,8,5,8,21,14,3,2,19,7,2,0,9,29,10,10,49,3.8,4,0.0,M2019-09-15D,Race(7),,
13,0,0,3,3,2,2,1,5,2,3,0,5,4,5,4,13,17,17,0.0,M2019-09-15D,Race(7),,
13,0,0,3,3,2,2,1,5,2,3,0,5,4,5,4,13,17,17,0.0,M2019-09-15D,Race(7),,
14,0,0,2,2,0,0,1,1,0,0,3,3,0,0,6,6,18,18,0.0,M2019-09-15D,Race(7),,
14,0,0,2,2,0,0,1,1,0,0,3,3,0,0,6,6,18,18,0.0,M2019-09-15D,Race(7),,
1,20,3,0,23,25,3,1,29,22,1,1,24,67,7,2,76,2.3,2.3,1.0,M2019-09-15D,Race(8),,
1,20,3,0,23,25,3,1,29,22,1,1,24,67,7,2,76,2.3,2.3,0.0,M2019-09-15D,Race(8),,
2,0,0,0,0,1,0,0,1,0,1,0,1,1,1,0,2,34,34,0.0,M2019-09-15D,Race(8),,
2,0,0,0,0,1,0,0,1,0,1,0,1,1,1,0,2,34,34,3.0,M2019-09-15D,Race(8),,
3,2,6,6,14,0,3,1,4,1,3,3,7,3,12,10,25,7,7,2.0,M2019-09-15D,Race(8),,
3,2,6,6,14,0,3,1,4,1,3,3,7,3,12,10,25,7,7,0.0,M2019-09-15D,Race(8),,
4,5,12,2,19,2,5,17,24,3,5,6,14,10,22,25,57,6,6,0.0,M2019-09-15D,Race(8),,
4,5,12,2,19,2,5,17,24,3,5,6,14,10,22,25,57,6,6,0.0,M2019-09-15D,Race(8),,
5,0,5,6,11,0,0,1,1,0,0,3,3,0,5,10,15,19,19,0.0,M2019-09-15D,Race(8),,
5,0,5,6,11,0,0,1,1,0,0,3,3,0,5,10,15,19,19,0.0,M2019-09-15D,Race(8),,
6,0,2,0,2,0,0,0,0,0,1,1,2,0,3,1,4,21,21,0.0,M2019-09-15D,Race(8),,
6,0,2,0,2,0,0,0,0,0,1,1,2,0,3,1,4,21,21,0.0,M2019-09-15D,Race(8),,
7,0,0,0,0,0,1,0,1,0,0,0,0,0,1,0,1,51,51,0.0,M2019-09-15D,Race(8),,
7,0,0,0,0,0,1,0,1,0,0,0,0,0,1,0,1,51,51,0.0,M2019-09-15D,Race(8),,
8,0,0,0,0,0,1,2,3,0,2,3,5,0,3,5,8,15,15,0.0,M2019-09-15D,Race(8),,
8,0,0,0,0,0,1,2,3,0,2,3,5,0,3,5,8,15,15,0.0,M2019-09-15D,Race(8),,
9,0,2,5,7,2,4,6,12,0,6,6,12,2,12,17,31,5.5,5.5,0.0,M2019-09-15D,Race(8),,
9,0,2,5,7,2,4,6,12,0,6,6,12,2,12,17,31,5.5,5.5,0.0,M2019-09-15D,Race(8),,
10,0,0,5,5,0,0,0,0,0,0,1,1,0,0,6,6,34,34,0.0,M2019-09-15D,Race(8),,
10,0,0,5,5,0,0,0,0,0,0,1,1,0,0,6,6,34,34,0.0,M2019-09-15D,Race(8),,
11,3,0,6,9,0,13,2,15,0,7,1,8,3,20,9,32,0,0,0.0,M2019-09-15D,Race(8),,
11,3,0,6,9,0,13,2,15,0,7,1,8,3,20,9,32,0,0,0.0,M2019-09-15D,Race(8),,
12,0,0,0,0,0,0,0,0,0,0,1,1,0,0,1,1,41,41,0.0,M2019-09-15D,Race(8),,
12,0,0,0,0,0,0,0,0,0,0,1,1,0,0,1,1,41,41,0.0,M2019-09-15D,Race(8),,
1,0,0,0,0,1,3,2,6,1,6,3,10,2,9,5,16,6.5,6.5,3.0,M2019-09-15D,Race(9),,
1,0,0,0,0,1,3,2,6,1,6,3,10,2,9,5,16,6.5,6.5,0.0,M2019-09-15D,Race(9),,
2,3,3,2,8,2,1,2,5,1,2,2,5,6,6,6,18,7.5,7.5,0.0,M2019-09-15D,Race(9),,
2,3,3,2,8,2,1,2,5,1,2,2,5,6,6,6,18,7.5,7.5,0.0,M2019-09-15D,Race(9),,
3,9,7,3,19,3,5,13,21,2,6,6,14,14,18,22,54,4.8,4.8,1.0,M2019-09-15D,Race(9),,
3,9,7,3,19,3,5,13,21,2,6,6,14,14,18,22,54,4.8,4.8,0.0,M2019-09-15D,Race(9),,
4,6,6,9,21,19,4,3,26,11,3,5,19,36,13,17,66,5.5,5.5,2.0,M2019-09-15D,Race(9),,
4,6,6,9,21,19,4,3,26,11,3,5,19,36,13,17,66,5.5,5.5,0.0,M2019-09-15D,Race(9),,
5,2,0,0,2,0,1,0,1,0,3,1,4,2,4,1,7,26,26,0.0,M2019-09-15D,Race(9),,
5,2,0,0,2,0,1,0,1,0,3,1,4,2,4,1,7,26,26,0.0,M2019-09-15D,Race(9),,
6,2,6,3,11,0,0,0,0,1,0,0,1,3,6,3,12,14,14,0.0,M2019-09-15D,Race(9),,
6,2,6,3,11,0,0,0,0,1,0,0,1,3,6,3,12,14,14,0.0,M2019-09-15D,Race(9),,
7,6,0,4,10,5,14,4,23,8,4,5,17,19,18,13,50,5.5,5.5,0.0,M2019-09-15D,Race(9),,
7,6,0,4,10,5,14,4,23,8,4,5,17,19,18,13,50,5.5,5.5,0.0,M2019-09-15D,Race(9),,
8,0,0,0,0,0,0,0,0,2,0,0,2,2,0,0,2,71,67,0.0,M2019-09-15D,Race(9),,
8,0,0,0,0,0,0,0,0,2,0,0,2,2,0,0,2,71,67,0.0,M2019-09-15D,Race(9),,
9,0,8,6,14,0,0,2,2,0,0,1,1,0,8,9,17,6.5,6.5,0.0,M2019-09-15D,Race(9),,
9,0,8,6,14,0,0,2,2,0,0,1,1,0,8,9,17,6.5,6.5,0.0,M2019-09-15D,Race(9),,
10,2,0,3,5,0,2,3,5,0,2,2,4,2,4,8,14,10,10,0.0,M2019-09-15D,Race(9),,
10,2,0,3,5,0,2,3,5,0,2,2,4,2,4,8,14,10,10,0.0,M2019-09-15D,Race(9),,
11,0,0,0,0,0,0,1,1,0,0,1,1,0,0,2,2,41,41,0.0,M2019-09-15D,Race(9),,
11,0,0,0,0,0,0,1,1,0,0,1,1,0,0,2,2,41,41,0.0,M2019-09-15D,Race(9),,
12,0,0,0,0,0,0,0,0,0,0,0,0,0,0,0,0,81,81,0.0,M2019-09-15D,Race(9),,
12,0,0,0,0,0,0,0,0,0,0,0,0,0,0,0,0,81,81,0.0,M2019-09-15D,Race(9),,
1,3,7,5,15,7,17,5,29,8,6,8,22,18,30,18,66,6.5,6.5,0.0,M2019-09-21D,Race(1),,
1,3,7,5,15,7,17,5,29,8,6,8,22,18,30,18,66,6.5,6.5,1.0,M2019-09-21D,Race(1),,
2,0,0,0,0,0,0,0,0,1,0,0,1,1,0,0,1,34,34,2.0,M2019-09-21D,Race(1),,
2,0,0,0,0,0,0,0,0,1,0,0,1,1,0,0,1,34,34,0.0,M2019-09-21D,Race(1),,
3,5,0,10,15,1,3,7,11,0,4,4,8,6,7,21,34,6,6,0.0,M2019-09-21D,Race(1),,
3,5,0,10,15,1,3,7,11,0,4,4,8,6,7,21,34,6,6,0.0,M2019-09-21D,Race(1),,
4,0,0,0,0,0,0,0,0,0,0,0,0,0,0,0,0,126,126,3.0,M2019-09-21D,Race(1),,
4,0,0,0,0,0,0,0,0,0,0,0,0,0,0,0,0,126,126,0.0,M2019-09-21D,Race(1),,
5,10,13,5,28,21,6,2,29,14,8,2,24,45,27,9,81,2.7,2.7,0.0,M2019-09-21D,Race(1),,
5,10,13,5,28,21,6,2,29,14,8,2,24,45,27,9,81,2.7,2.7,0.0,M2019-09-21D,Race(1),,
6,9,5,5,19,0,4,16,20,3,7,8,18,12,16,29,57,3.5,3.5,0.0,M2019-09-21D,Race(1),,
6,9,5,5,19,0,4,16,20,3,7,8,18,12,16,29,57,3.5,3.5,0.0,M2019-09-21D,Race(1),,
7,0,5,5,10,0,0,0,0,0,0,1,1,0,5,6,11,13,13,0.0,M2019-09-21D,Race(1),,
7,0,5,5,10,0,0,0,0,0,0,1,1,0,5,6,11,13,13,0.0,M2019-09-21D,Race(1),,
8,3,0,0,3,1,0,0,1,0,0,2,2,4,0,2,6,13,13,0.0,M2019-09-21D,Race(1),,
8,3,0,0,3,1,0,0,1,0,0,2,2,4,0,2,6,13,13,0.0,M2019-09-21D,Race(1),,
9,0,0,0,0,0,0,0,0,0,1,1,2,0,1,1,2,17,17,0.0,M2019-09-21D,Race(1),,
9,0,0,0,0,0,0,0,0,0,1,1,2,0,1,1,2,17,17,0.0,M2019-09-21D,Race(1),,
10,0,0,0,0,0,0,0,0,0,0,0,0,0,0,0,0,51,51,0.0,M2019-09-21D,Race(1),,
10,0,0,0,0,0,0,0,0,0,0,0,0,0,0,0,0,51,51,0.0,M2019-09-21D,Race(1),,
11,0,0,0,0,0,0,0,0,0,0,0,0,0,0,0,0,51,51,0.0,M2019-09-21D,Race(1),,
11,0,0,0,0,0,0,0,0,0,0,0,0,0,0,0,0,51,51,0.0,M2019-09-21D,Race(1),,
12,0,0,0,0,0,0,0,0,0,0,0,0,0,0,0,0,81,81,0.0,M2019-09-21D,Race(1),,
12,0,0,0,0,0,0,0,0,0,0,0,0,0,0,0,0,81,81,0.0,M2019-09-21D,Race(1),,
1,8,6,7,21,2,5,3,10,3,7,2,12,13,18,12,43,4.2,4.2,0.0,M2019-09-21D,Race(10),,
1,8,6,7,21,2,5,3,10,3,7,2,12,13,18,12,43,4.2,4.2,0.0,M2019-09-21D,Race(10),,
2,8,3,8,19,19,1,6,26,12,6,4,22,39,10,18,67,5.5,5.5,0.0,M2019-09-21D,Race(10),,
2,8,3,8,19,19,1,6,26,12,6,4,22,39,10,18,67,5.5,5.5,1.0,M2019-09-21D,Race(10),,
3,2,3,2,7,3,1,0,4,2,0,1,3,7,4,3,14,16,16,3.0,M2019-09-21D,Race(10),,
3,2,3,2,7,3,1,0,4,2,0,1,3,7,4,3,14,16,16,0.0,M2019-09-21D,Race(10),,
4,0,2,2,4,0,0,0,0,1,1,0,2,1,3,2,6,12,12,0.0,M2019-09-21D,Race(10),,
4,0,2,2,4,0,0,0,0,1,1,0,2,1,3,2,6,12,12,0.0,M2019-09-21D,Race(10),,
5,2,0,3,5,3,16,4,23,5,6,8,19,10,22,15,47,4.4,4.4,0.0,M2019-09-21D,Race(10),,
5,2,0,3,5,3,16,4,23,5,6,8,19,10,22,15,47,4.4,4.4,0.0,M2019-09-21D,Race(10),,
6,0,0,0,0,0,0,1,1,0,0,2,2,0,0,3,3,26,26,0.0,M2019-09-21D,Race(10),,
6,0,0,0,0,0,0,1,1,0,0,2,2,0,0,3,3,26,26,0.0,M2019-09-21D,Race(10),,
7,0,0,0,0,0,0,0,0,0,1,0,1,0,1,0,1,41,41,0.0,M2019-09-21D,Race(10),,
7,0,0,0,0,0,0,0,0,0,1,0,1,0,1,0,1,41,41,2.0,M2019-09-21D,Race(10),,
8,4,0,0,4,2,3,3,8,2,2,4,8,8,5,7,20,11,11,0.0,M2019-09-21D,Race(10),,
8,4,0,0,4,2,3,3,8,2,2,4,8,8,5,7,20,11,11,0.0,M2019-09-21D,Race(10),,
9,0,2,0,2,1,0,0,1,0,0,0,0,1,2,0,3,16,16,0.0,M2019-09-21D,Race(10),,
9,0,2,0,2,1,0,0,1,0,0,0,0,1,2,0,3,16,16,0.0,M2019-09-21D,Race(10),,
10,0,0,0,0,0,1,0,1,0,2,1,3,0,3,1,4,17,17,0.0,M2019-09-21D,Race(10),,
10,0,0,0,0,0,1,0,1,0,2,1,3,0,3,1,4,17,17,0.0,M2019-09-21D,Race(10),,
11,6,0,2,8,0,0,1,1,0,1,1,2,6,1,4,11,26,26,0.0,M2019-09-21D,Race(10),,
11,6,0,2,8,0,0,1,1,0,1,1,2,6,1,4,11,26,26,0.0,M2019-09-21D,Race(10),,
12,0,0,0,0,0,0,0,0,0,0,0,0,0,0,0,0,101,101,0.0,M2019-09-21D,Race(10),,
12,0,0,0,0,0,0,0,0,0,0,0,0,0,0,0,0,101,101,0.0,M2019-09-21D,Race(10),,
13,0,11,3,14,0,3,12,15,1,0,3,4,1,14,18,33,9,9,0.0,M2019-09-21D,Race(10),,
13,0,11,3,14,0,3,12,15,1,0,3,4,1,14,18,33,9,9,0.0,M2019-09-21D,Race(10),,
14,0,3,3,6,0,0,0,0,0,0,0,0,0,3,3,6,19,19,0.0,M2019-09-21D,Race(10),,
14,0,3,3,6,0,0,0,0,0,0,0,0,0,3,3,6,19,19,0.0,M2019-09-21D,Race(10),,
1,0,0,0,0,0,0,0,0,0,0,0,0,0,0,0,0,61,61,0.0,M2019-09-21D,Race(2),,
1,0,0,0,0,0,0,0,0,0,0,0,0,0,0,0,0,61,61,1.0,M2019-09-21D,Race(2),,
2,10,3,9,22,4,15,6,25,4,8,5,17,18,26,20,64,5,5,0.0,M2019-09-21D,Race(2),,
2,10,3,9,22,4,15,6,25,4,8,5,17,18,26,20,64,5,5,0.0,M2019-09-21D,Race(2),,
3,14,0,14,28,20,6,3,29,13,8,4,25,47,14,21,82,3.4,3.4,0.0,M2019-09-21D,Race(2),,
3,14,0,14,28,20,6,3,29,13,8,4,25,47,14,21,82,3.4,3.4,0.0,M2019-09-21D,Race(2),,
4,2,5,3,10,2,4,17,23,4,2,9,15,8,11,29,48,9,9,3.0,M2019-09-21D,Race(2),,
4,2,5,3,10,2,4,17,23,4,2,9,15,8,11,29,48,9,9,2.0,M2019-09-21D,Race(2),,
5,0,0,0,0,0,0,0,0,0,0,0,0,0,0,0,0,101,101,0.0,M2019-09-21D,Race(2),,
5,0,0,0,0,0,0,0,0,0,0,0,0,0,0,0,0,101,101,0.0,M2019-09-21D,Race(2),,
6,0,0,0,0,0,2,0,2,0,2,0,2,0,4,0,4,26,26,0.0,M2019-09-21D,Race(2),,
6,0,0,0,0,0,2,0,2,0,2,0,2,0,4,0,4,26,26,0.0,M2019-09-21D,Race(2),,
7,2,5,2,9,1,2,0,3,2,3,3,8,5,10,5,20,9,9,0.0,M2019-09-21D,Race(2),,
7,2,5,2,9,1,2,0,3,2,3,3,8,5,10,5,20,9,9,0.0,M2019-09-21D,Race(2),,
8,0,13,2,15,2,0,3,5,3,1,3,7,5,14,8,27,3.4,3.4,0.0,M2019-09-21D,Race(2),,
8,0,13,2,15,2,0,3,5,3,1,3,7,5,14,8,27,3.4,3.4,0.0,M2019-09-21D,Race(2),,
9,0,0,0,0,0,0,0,0,0,0,0,0,0,0,0,0,126,126,0.0,M2019-09-21D,Race(2),,
9,0,0,0,0,0,0,0,0,0,0,0,0,0,0,0,0,126,126,0.0,M2019-09-21D,Race(2),,
10,0,0,0,0,0,0,0,0,0,0,0,0,0,0,0,0,81,81,0.0,M2019-09-21D,Race(2),,
10,0,0,0,0,0,0,0,0,0,0,0,0,0,0,0,0,81,81,0.0,M2019-09-21D,Race(2),,
11,0,2,0,2,1,0,0,1,0,0,0,0,1,2,0,3,13,13,0.0,M2019-09-21D,Race(2),,
11,0,2,0,2,1,0,0,1,0,0,0,0,1,2,0,3,13,13,0.0,M2019-09-21D,Race(2),,
12,0,2,0,2,0,1,0,1,0,1,0,1,0,4,0,4,51,51,0.0,M2019-09-21D,Race(2),,
12,0,2,0,2,0,1,0,1,0,1,0,1,0,4,0,4,51,51,0.0,M2019-09-21D,Race(2),,
13,0,0,0,0,0,0,0,0,0,0,1,1,0,0,1,1,41,41,0.0,M2019-09-21D,Race(2),,
13,0,0,0,0,0,0,0,0,0,0,1,1,0,0,1,1,41,41,0.0,M2019-09-21D,Race(2),,
14,2,0,0,2,0,0,1,1,0,1,1,2,2,1,2,5,16,17,0.0,M2019-09-21D,Race(2),,
14,2,0,0,2,0,0,1,1,0,1,1,2,2,1,2,5,16,17,0.0,M2019-09-21D,Race(2),,
1,0,0,0,0,0,1,1,2,0,1,2,3,0,2,3,5,41,41,0.0,M2019-09-21D,Race(3),,
1,0,0,0,0,0,1,1,2,0,1,2,3,0,2,3,5,41,41,0.0,M2019-09-21D,Race(3),,
2,3,4,0,7,2,3,1,6,2,1,1,4,7,8,2,17,9.5,9.5,0.0,M2019-09-21D,Race(3),,
2,3,4,0,7,2,3,1,6,2,1,1,4,7,8,2,17,9.5,9.5,0.0,M2019-09-21D,Race(3),,
3,4,0,14,18,6,11,5,22,4,2,1,7,14,13,20,47,10,10,0.0,M2019-09-21D,Race(3),,
3,4,0,14,18,6,11,5,22,4,2,1,7,14,13,20,47,10,10,0.0,M2019-09-21D,Race(3),,
4,2,0,0,2,0,2,2,4,0,4,3,7,2,6,5,13,15,15,2.0,M2019-09-21D,Race(3),,
4,2,0,0,2,0,2,2,4,0,4,3,7,2,6,5,13,15,15,0.0,M2019-09-21D,Race(3),,
5,0,0,0,0,0,0,0,0,0,0,0,0,0,0,0,0,21,21,0.0,M2019-09-21D,Race(3),,
5,0,0,0,0,0,0,0,0,0,0,0,0,0,0,0,0,21,21,0.0,M2019-09-21D,Race(3),,
6,0,3,0,3,0,0,0,0,1,0,0,1,1,3,0,4,31,31,0.0,M2019-09-21D,Race(3),,
6,0,3,0,3,0,0,0,0,1,0,0,1,1,3,0,4,31,31,0.0,M2019-09-21D,Race(3),,
7,6,10,5,21,15,5,4,24,8,4,4,16,29,19,13,61,3.4,3.4,1.0,M2019-09-21D,Race(3),,
7,6,10,5,21,15,5,4,24,8,4,4,16,29,19,13,61,3.4,3.4,3.0,M2019-09-21D,Race(3),,
8,0,0,0,0,0,0,0,0,0,0,0,0,0,0,0,0,151,151,0.0,M2019-09-21D,Race(3),,
8,0,0,0,0,0,0,0,0,0,0,0,0,0,0,0,0,151,151,0.0,M2019-09-21D,Race(3),,
9,3,3,6,12,2,3,12,17,5,5,4,14,10,11,22,43,15,15,0.0,M2019-09-21D,Race(3),,
9,3,3,6,12,2,3,12,17,5,5,4,14,10,11,22,43,15,15,0.0,M2019-09-21D,Race(3),,
10,0,0,0,0,0,0,0,0,0,0,0,0,0,0,0,0,101,101,0.0,M2019-09-21D,Race(3),,
10,0,0,0,0,0,0,0,0,0,0,0,0,0,0,0,0,101,101,0.0,M2019-09-21D,Race(3),,
11,0,0,5,5,2,0,1,3,2,2,4,8,4,2,10,16,8.5,8.5,0.0,M2019-09-21D,Race(3),,
11,0,0,5,5,2,0,1,3,2,2,4,8,4,2,10,16,8.5,8.5,0.0,M2019-09-21D,Race(3),,
12,2,3,0,5,0,1,1,2,0,1,2,3,2,5,3,10,17,17,0.0,M2019-09-21D,Race(3),,
12,2,3,0,5,0,1,1,2,0,1,2,3,2,5,3,10,17,17,0.0,M2019-09-21D,Race(3),,
13,2,2,0,4,0,0,0,0,0,0,1,1,2,2,1,5,12,12,0.0,M2019-09-21D,Race(3),,
13,2,2,0,4,0,0,0,0,0,0,1,1,2,2,1,5,12,12,0.0,M2019-09-21D,Race(3),,
14,8,5,0,13,3,4,3,10,4,6,4,14,15,15,7,37,3.8,3.8,0.0,M2019-09-21D,Race(3),,
14,8,5,0,13,3,4,3,10,4,6,4,14,15,15,7,37,3.8,3.8,0.0,M2019-09-21D,Race(3),,
1,8,2,8,18,0,3,5,8,1,2,8,11,9,7,21,37,5.5,5.5,0.0,M2019-09-21D,Race(4),,
1,8,2,8,18,0,3,5,8,1,2,8,11,9,7,21,37,5.5,5.5,2.0,M2019-09-21D,Race(4),,
2,13,10,2,25,24,3,2,29,18,5,1,24,55,18,5,78,2.8,2.8,0.0,M2019-09-21D,Race(4),,
2,13,10,2,25,24,3,2,29,18,5,1,24,55,18,5,78,2.8,2.8,0.0,M2019-09-21D,Race(4),,
3,0,0,2,2,0,4,15,19,2,3,7,12,2,7,24,33,9.5,9.5,1.0,M2019-09-21D,Race(4),,
3,0,0,2,2,0,4,15,19,2,3,7,12,2,7,24,33,9.5,9.5,0.0,M2019-09-21D,Race(4),,
4,3,16,5,24,5,18,5,28,5,12,4,21,13,46,14,73,4,4,0.0,M2019-09-21D,Race(4),,
4,3,16,5,24,5,18,5,28,5,12,4,21,13,46,14,73,4,4,0.0,M2019-09-21D,Race(4),,
5,0,0,2,2,0,0,1,1,0,0,1,1,0,0,4,4,11,11,0.0,M2019-09-21D,Race(4),,
5,0,0,2,2,0,0,1,1,0,0,1,1,0,0,4,4,11,11,0.0,M2019-09-21D,Race(4),,
6,0,0,5,5,1,1,1,3,0,0,1,1,1,1,7,9,15,15,0.0,M2019-09-21D,Race(4),,
6,0,0,5,5,1,1,1,3,0,0,1,1,1,1,7,9,15,15,3.0,M2019-09-21D,Race(4),,
7,0,0,0,0,0,0,0,0,0,0,0,0,0,0,0,0,91,101,0.0,M2019-09-21D,Race(4),,
7,0,0,0,0,0,0,0,0,0,0,0,0,0,0,0,0,91,101,0.0,M2019-09-21D,Race(4),,
8,0,2,3,5,0,0,0,0,0,0,2,2,0,2,5,7,21,21,0.0,M2019-09-21D,Race(4),,
8,0,2,3,5,0,0,0,0,0,0,2,2,0,2,5,7,21,21,0.0,M2019-09-21D,Race(4),,
9,2,0,0,2,0,0,0,0,0,0,0,0,2,0,0,2,21,21,0.0,M2019-09-21D,Race(4),,
9,2,0,0,2,0,0,0,0,0,0,0,0,2,0,0,2,21,21,0.0,M2019-09-21D,Race(4),,
10,2,0,0,2,0,0,0,0,0,0,0,0,2,0,0,2,81,81,0.0,M2019-09-21D,Race(4),,
10,2,0,0,2,0,0,0,0,0,0,0,0,2,0,0,2,81,81,0.0,M2019-09-21D,Race(4),,
11,0,0,0,0,0,0,1,1,0,1,2,3,0,1,3,4,26,26,0.0,M2019-09-21D,Race(4),,
11,0,0,0,0,0,0,1,1,0,1,2,3,0,1,3,4,26,26,0.0,M2019-09-21D,Race(4),,
12,2,0,3,5,0,1,0,1,0,3,0,3,2,4,3,9,12,12,0.0,M2019-09-21D,Race(4),,
12,2,0,3,5,0,1,0,1,0,3,0,3,2,4,3,9,12,12,0.0,M2019-09-21D,Race(4),,
1,7,2,2,11,5,3,3,11,0,2,5,7,12,7,10,29,6.5,6.5,3.0,M2019-09-21D,Race(5),,
1,7,2,2,11,5,3,3,11,0,2,5,7,12,7,10,29,6.5,6.5,2.0,M2019-09-21D,Race(5),,
2,13,10,4,27,3,2,2,7,2,4,4,10,18,16,10,44,4,4,0.0,M2019-09-21D,Race(5),,
2,13,10,4,27,3,2,2,7,2,4,4,10,18,16,10,44,4,4,0.0,M2019-09-21D,Race(5),,
3,2,10,3,15,21,4,3,28,18,3,1,22,41,17,7,65,5,5,0.0,M2019-09-21D,Race(5),,
3,2,10,3,15,21,4,3,28,18,3,1,22,41,17,7,65,5,5,0.0,M2019-09-21D,Race(5),,
4,3,0,7,10,0,0,2,2,0,2,1,3,3,2,10,15,7.5,7.5,0.0,M2019-09-21D,Race(5),,
4,3,0,7,10,0,0,2,2,0,2,1,3,3,2,10,15,7.5,7.5,0.0,M2019-09-21D,Race(5),,
5,0,0,0,0,0,0,0,0,1,0,0,1,1,0,0,1,41,41,0.0,M2019-09-21D,Race(5),,
5,0,0,0,0,0,0,0,0,1,0,0,1,1,0,0,1,41,41,0.0,M2019-09-21D,Race(5),,
6,3,0,3,6,1,4,13,18,4,5,6,15,8,9,22,39,8,8,0.0,M2019-09-21D,Race(5),,
6,3,0,3,6,1,4,13,18,4,5,6,15,8,9,22,39,8,8,1.0,M2019-09-21D,Race(5),,
7,0,2,3,5,0,0,0,0,0,0,0,0,0,2,3,5,11,11,0.0,M2019-09-21D,Race(5),,
7,0,2,3,5,0,0,0,0,0,0,0,0,0,2,3,5,11,11,0.0,M2019-09-21D,Race(5),,
8,0,0,0,0,0,0,1,1,0,1,0,1,0,1,1,2,13,13,0.0,M2019-09-21D,Race(5),,
8,0,0,0,0,0,0,1,1,0,1,0,1,0,1,1,2,13,13,0.0,M2019-09-21D,Race(5),,
9,0,0,0,0,0,0,0,0,0,0,0,0,0,0,0,0,151,151,0.0,M2019-09-21D,Race(5),,
9,0,0,0,0,0,0,0,0,0,0,0,0,0,0,0,0,151,151,0.0,M2019-09-21D,Race(5),,
10,0,0,0,0,0,0,0,0,0,1,0,1,0,1,0,1,41,41,0.0,M2019-09-21D,Race(5),,
10,0,0,0,0,0,0,0,0,0,1,0,1,0,1,0,1,41,41,0.0,M2019-09-21D,Race(5),,
11,0,6,8,14,0,17,6,23,1,8,8,17,1,31,22,54,9,9,0.0,M2019-09-21D,Race(5),,
11,0,6,8,14,0,17,6,23,1,8,8,17,1,31,22,54,9,9,0.0,M2019-09-21D,Race(5),,
12,2,0,0,2,0,0,0,0,0,0,0,0,2,0,0,2,17,17,0.0,M2019-09-21D,Race(5),,
12,2,0,0,2,0,0,0,0,0,0,0,0,2,0,0,2,17,17,0.0,M2019-09-21D,Race(5),,
13,0,0,0,0,0,0,0,0,0,0,0,0,0,0,0,0,81,81,0.0,M2019-09-21D,Race(5),,
13,0,0,0,0,0,0,0,0,0,0,0,0,0,0,0,0,81,81,0.0,M2019-09-21D,Race(5),,
14,0,0,0,0,0,0,0,0,0,0,1,1,0,0,1,1,81,81,0.0,M2019-09-21D,Race(5),,
14,0,0,0,0,0,0,0,0,0,0,1,1,0,0,1,1,81,81,0.0,M2019-09-21D,Race(5),,
1,7,7,7,21,3,1,4,8,5,0,8,13,15,8,19,42,6.5,6.5,0.0,M2019-09-21D,Race(6),,
1,7,7,7,21,3,1,4,8,5,0,8,13,15,8,19,42,6.5,6.5,0.0,M2019-09-21D,Race(6),,
2,0,0,0,0,0,0,0,0,0,0,0,0,0,0,0,0,81,81,0.0,M2019-09-21D,Race(6),,
2,0,0,0,0,0,0,0,0,0,0,0,0,0,0,0,0,81,81,0.0,M2019-09-21D,Race(6),,
3,0,2,6,8,16,6,4,26,8,7,0,15,24,15,10,49,3.8,3.8,0.0,M2019-09-21D,Race(6),,
3,0,2,6,8,16,6,4,26,8,7,0,15,24,15,10,49,3.8,3.8,3.0,M2019-09-21D,Race(6),,
4,0,0,0,0,0,0,0,0,0,0,0,0,0,0,0,0,101,101,2.0,M2019-09-21D,Race(6),,
4,0,0,0,0,0,0,0,0,0,0,0,0,0,0,0,0,101,101,0.0,M2019-09-21D,Race(6),,
5,3,3,3,9,0,0,4,4,2,1,4,7,5,4,11,20,8.5,8.5,0.0,M2019-09-21D,Race(6),,
5,3,3,3,9,0,0,4,4,2,1,4,7,5,4,11,20,8.5,8.5,0.0,M2019-09-21D,Race(6),,
6,0,0,3,3,0,0,2,2,0,0,2,2,0,0,7,7,26,26,0.0,M2019-09-21D,Race(6),,
6,0,0,3,3,0,0,2,2,0,0,2,2,0,0,7,7,26,26,1.0,M2019-09-21D,Race(6),,
7,2,6,2,10,2,2,9,13,1,2,2,5,5,10,13,28,9,9,0.0,M2019-09-21D,Race(6),,
7,2,6,2,10,2,2,9,13,1,2,2,5,5,10,13,28,9,9,0.0,M2019-09-21D,Race(6),,
8,2,2,0,4,0,1,1,2,2,3,1,6,4,6,2,12,26,26,0.0,M2019-09-21D,Race(6),,
8,2,2,0,4,0,1,1,2,2,3,1,6,4,6,2,12,26,26,0.0,M2019-09-21D,Race(6),,
9,13,10,4,27,8,19,1,28,7,11,2,20,28,40,7,75,3.8,3.8,0.0,M2019-09-21D,Race(6),,
9,13,10,4,27,8,19,1,28,7,11,2,20,28,40,7,75,3.8,3.8,0.0,M2019-09-21D,Race(6),,
10,0,0,0,0,0,0,0,0,0,0,1,1,0,0,1,1,151,151,0.0,M2019-09-21D,Race(6),,
10,0,0,0,0,0,0,0,0,0,0,1,1,0,0,1,1,151,151,0.0,M2019-09-21D,Race(6),,
11,0,0,0,0,1,0,1,2,0,0,0,0,1,0,1,2,0,0,0.0,M2019-09-21D,Race(6),,
11,0,0,0,0,1,0,1,2,0,0,0,0,1,0,1,2,0,0,0.0,M2019-09-21D,Race(6),,
12,0,0,0,0,0,0,0,0,0,0,0,0,0,0,0,0,21,21,0.0,M2019-09-21D,Race(6),,
12,0,0,0,0,0,0,0,0,0,0,0,0,0,0,0,0,21,21,0.0,M2019-09-21D,Race(6),,
13,3,0,5,8,0,1,4,5,1,1,5,7,4,2,14,20,4.8,4.8,0.0,M2019-09-21D,Race(6),,
13,3,0,5,8,0,1,4,5,1,1,5,7,4,2,14,20,4.8,4.8,0.0,M2019-09-21D,Race(6),,
14,0,0,0,0,0,0,0,0,0,0,0,0,0,0,0,0,126,126,0.0,M2019-09-21D,Race(6),,
14,0,0,0,0,0,0,0,0,0,0,0,0,0,0,0,0,126,126,0.0,M2019-09-21D,Race(6),,
1,14,10,2,26,21,5,2,28,13,6,2,21,48,21,6,75,3.2,3.2,0.0,M2019-09-21D,Race(7),,
1,14,10,2,26,21,5,2,28,13,6,2,21,48,21,6,75,3.2,3.2,0.0,M2019-09-21D,Race(7),,
2,2,0,3,5,0,0,0,0,0,0,1,1,2,0,4,6,11,11,0.0,M2019-09-21D,Race(7),,
2,2,0,3,5,0,0,0,0,0,0,1,1,2,0,4,6,11,11,0.0,M2019-09-21D,Race(7),,
3,0,0,11,11,1,5,3,9,1,5,0,6,2,10,14,26,13,13,1.0,M2019-09-21D,Race(7),,
3,0,0,11,11,1,5,3,9,1,5,0,6,2,10,14,26,13,13,0.0,M2019-09-21D,Race(7),,
4,0,0,0,0,0,0,0,0,0,0,0,0,0,0,0,0,81,81,2.0,M2019-09-21D,Race(7),,
4,0,0,0,0,0,0,0,0,0,0,0,0,0,0,0,0,81,81,0.0,M2019-09-21D,Race(7),,
5,0,2,5,7,1,2,4,7,3,3,5,11,4,7,14,25,9,9,3.0,M2019-09-21D,Race(7),,
5,0,2,5,7,1,2,4,7,3,3,5,11,4,7,14,25,9,9,0.0,M2019-09-21D,Race(7),,
6,0,2,0,2,0,0,2,2,0,1,3,4,0,3,5,8,19,19,0.0,M2019-09-21D,Race(7),,
6,0,2,0,2,0,0,2,2,0,1,3,4,0,3,5,8,19,19,0.0,M2019-09-21D,Race(7),,
7,2,2,7,11,0,3,12,15,0,0,10,10,2,5,29,36,6,6,0.0,M2019-09-21D,Race(7),,
7,2,2,7,11,0,3,12,15,0,0,10,10,2,5,29,36,6,6,0.0,M2019-09-21D,Race(7),,
8,2,3,0,5,0,1,2,3,1,3,2,6,3,7,4,14,10,10,0.0,M2019-09-21D,Race(7),,
8,2,3,0,5,0,1,2,3,1,3,2,6,3,7,4,14,10,10,0.0,M2019-09-21D,Race(7),,
9,10,11,2,23,7,14,5,26,8,8,3,19,25,33,10,68,2.8,2.8,0.0,M2019-09-21D,Race(7),,
9,10,11,2,23,7,14,5,26,8,8,3,19,25,33,10,68,2.8,2.8,0.0,M2019-09-21D,Race(7),,
1,3,0,0,3,0,0,0,0,0,0,0,0,3,0,0,3,41,41,0.0,M2019-09-21D,Race(8),,
1,3,0,0,3,0,0,0,0,0,0,0,0,3,0,0,3,41,41,1.0,M2019-09-21D,Race(8),,
2,5,0,0,5,2,5,2,9,4,5,2,11,11,10,4,25,11,11,0.0,M2019-09-21D,Race(8),,
2,5,0,0,5,2,5,2,9,4,5,2,11,11,10,4,25,11,11,0.0,M2019-09-21D,Race(8),,
3,4,8,3,15,22,1,3,26,9,5,5,19,35,14,11,60,4,4,3.0,M2019-09-21D,Race(8),,
3,4,8,3,15,22,1,3,26,9,5,5,19,35,14,11,60,4,4,0.0,M2019-09-21D,Race(8),,
4,0,0,0,0,0,0,0,0,0,0,0,0,0,0,0,0,41,41,0.0,M2019-09-21D,Race(8),,
4,0,0,0,0,0,0,0,0,0,0,0,0,0,0,0,0,41,41,0.0,M2019-09-21D,Race(8),,
5,0,7,0,7,0,1,0,1,1,0,0,1,1,8,0,9,10,10,0.0,M2019-09-21D,Race(8),,
5,0,7,0,7,0,1,0,1,1,0,0,1,1,8,0,9,10,10,0.0,M2019-09-21D,Race(8),,
6,3,7,10,20,1,2,2,5,3,2,1,6,7,11,13,31,5.5,5.5,0.0,M2019-09-21D,Race(8),,
6,3,7,10,20,1,2,2,5,3,2,1,6,7,11,13,31,5.5,5.5,0.0,M2019-09-21D,Race(8),,
7,0,0,0,0,0,0,0,0,0,0,0,0,0,0,0,0,126,126,2.0,M2019-09-21D,Race(8),,
7,0,0,0,0,0,0,0,0,0,0,0,0,0,0,0,0,126,126,0.0,M2019-09-21D,Race(8),,
8,0,0,0,0,0,0,0,0,0,0,0,0,0,0,0,0,151,151,0.0,M2019-09-21D,Race(8),,
8,0,0,0,0,0,0,0,0,0,0,0,0,0,0,0,0,151,151,0.0,M2019-09-21D,Race(8),,
9,0,0,5,5,0,4,0,4,0,3,0,3,0,7,5,12,21,21,0.0,M2019-09-21D,Race(8),,
9,0,0,5,5,0,4,0,4,0,3,0,3,0,7,5,12,21,21,0.0,M2019-09-21D,Race(8),,
10,11,3,4,18,4,15,10,29,7,8,6,21,22,26,20,68,2.6,2.6,0.0,M2019-09-21D,Race(8),,
10,11,3,4,18,4,15,10,29,7,8,6,21,22,26,20,68,2.6,2.6,0.0,M2019-09-21D,Race(8),,
11,0,2,0,2,0,0,0,0,0,0,0,0,0,2,0,2,51,51,0.0,M2019-09-21D,Race(8),,
11,0,2,0,2,0,0,0,0,0,0,0,0,0,2,0,2,51,51,0.0,M2019-09-21D,Race(8),,
12,0,3,5,8,1,0,3,4,1,0,3,4,2,3,11,16,21,21,0.0,M2019-09-21D,Race(8),,
12,0,3,5,8,1,0,3,4,1,0,3,4,2,3,11,16,21,21,0.0,M2019-09-21D,Race(8),,
13,4,0,3,7,0,2,10,12,1,3,8,12,5,5,21,31,12,12,0.0,M2019-09-21D,Race(8),,
13,4,0,3,7,0,2,10,12,1,3,8,12,5,5,21,31,12,12,0.0,M2019-09-21D,Race(8),,
14,0,0,0,0,0,0,0,0,0,0,1,1,0,0,1,1,101,101,0.0,M2019-09-21D,Race(8),,
14,0,0,0,0,0,0,0,0,0,0,1,1,0,0,1,1,101,101,0.0,M2019-09-21D,Race(8),,
1,0,0,0,0,0,1,0,1,1,0,0,1,1,1,0,2,21,21,0.0,M2019-09-21D,Race(9),,
1,0,0,0,0,0,1,0,1,1,0,0,1,1,1,0,2,21,21,0.0,M2019-09-21D,Race(9),,
2,0,2,5,7,0,0,1,1,1,0,2,3,1,2,8,11,9.5,9.5,0.0,M2019-09-21D,Race(9),,
2,0,2,5,7,0,0,1,1,1,0,2,3,1,2,8,11,9.5,9.5,1.0,M2019-09-21D,Race(9),,
3,10,7,10,27,17,6,6,29,9,5,5,19,36,18,21,75,2.8,2.8,0.0,M2019-09-21D,Race(9),,
3,10,7,10,27,17,6,6,29,9,5,5,19,36,18,21,75,2.8,2.8,0.0,M2019-09-21D,Race(9),,
4,6,7,2,15,7,13,4,24,7,11,3,21,20,31,9,60,4.8,4.8,0.0,M2019-09-21D,Race(9),,
4,6,7,2,15,7,13,4,24,7,11,3,21,20,31,9,60,4.8,4.8,3.0,M2019-09-21D,Race(9),,
5,0,0,0,0,0,0,0,0,0,0,0,0,0,0,0,0,51,51,2.0,M2019-09-21D,Race(9),,
5,0,0,0,0,0,0,0,0,0,0,0,0,0,0,0,0,51,51,0.0,M2019-09-21D,Race(9),,
6,0,0,0,0,0,0,0,0,1,0,0,1,1,0,0,1,34,34,0.0,M2019-09-21D,Race(9),,
6,0,0,0,0,0,0,0,0,1,0,0,1,1,0,0,1,34,34,0.0,M2019-09-21D,Race(9),,
7,0,0,0,0,0,0,0,0,0,0,0,0,0,0,0,0,51,51,0.0,M2019-09-21D,Race(9),,
7,0,0,0,0,0,0,0,0,0,0,0,0,0,0,0,0,51,51,0.0,M2019-09-21D,Race(9),,
8,9,3,5,17,1,4,3,8,2,4,4,10,12,11,12,35,6.5,6.5,0.0,M2019-09-21D,Race(9),,
8,9,3,5,17,1,4,3,8,2,4,4,10,12,11,12,35,6.5,6.5,0.0,M2019-09-21D,Race(9),,
9,0,6,8,14,4,2,14,20,2,3,7,12,6,11,29,46,7,8,0.0,M2019-09-21D,Race(9),,
9,0,6,8,14,4,2,14,20,2,3,7,12,6,11,29,46,7,8,0.0,M2019-09-21D,Race(9),,
10,0,2,0,2,0,0,0,0,0,0,0,0,0,2,0,2,31,31,0.0,M2019-09-21D,Race(9),,
10,0,2,0,2,0,0,0,0,0,0,0,0,0,2,0,2,31,31,0.0,M2019-09-21D,Race(9),,
11,0,0,0,0,0,0,1,1,0,0,0,0,0,0,1,1,26,26,0.0,M2019-09-21D,Race(9),,
11,0,0,0,0,0,0,1,1,0,0,0,0,0,0,1,1,26,26,0.0,M2019-09-21D,Race(9),,
12,5,3,0,8,1,4,1,6,3,3,5,11,9,10,6,25,7,7,0.0,M2019-09-21D,Race(9),,
12,5,3,0,8,1,4,1,6,3,3,5,11,9,10,6,25,7,7,0.0,M2019-09-21D,Race(9),,
1,13,11,6,30,21,4,3,28,13,2,5,20,47,17,14,78,3.5,3.5,0.0,M2019-09-25D,Race(1),,
1,13,11,6,30,21,4,3,28,13,2,5,20,47,17,14,78,3.5,3.5,3.0,M2019-09-25D,Race(1),,
2,2,2,3,7,0,0,1,1,0,2,0,2,2,4,4,10,14,14,0.0,M2019-09-25D,Race(1),,
2,2,2,3,7,0,0,1,1,0,2,0,2,2,4,4,10,14,14,1.0,M2019-09-25D,Race(1),,
3,5,5,5,15,0,1,3,4,0,1,2,3,5,7,10,22,3.9,3.9,0.0,M2019-09-25D,Race(1),,
3,5,5,5,15,0,1,3,4,0,1,2,3,5,7,10,22,3.9,3.9,2.0,M2019-09-25D,Race(1),,
4,5,2,11,18,3,17,7,27,6,9,7,22,14,28,25,67,4.8,4.8,0.0,M2019-09-25D,Race(1),,
4,5,2,11,18,3,17,7,27,6,9,7,22,14,28,25,67,4.8,4.8,0.0,M2019-09-25D,Race(1),,
5,0,2,3,5,0,0,2,2,1,0,5,6,1,2,10,13,8.5,8.5,0.0,M2019-09-25D,Race(1),,
5,0,2,3,5,0,0,2,2,1,0,5,6,1,2,10,13,8.5,8.5,0.0,M2019-09-25D,Race(1),,
6,5,8,0,13,5,7,13,25,5,9,4,18,15,24,17,56,4,4,0.0,M2019-09-25D,Race(1),,
6,5,8,0,13,5,7,13,25,5,9,4,18,15,24,17,56,4,4,0.0,M2019-09-25D,Race(1),,
7,0,0,2,2,1,1,1,3,1,3,3,7,2,4,6,12,10,10,0.0,M2019-09-25D,Race(1),,
7,0,0,2,2,1,1,1,3,1,3,3,7,2,4,6,12,10,10,0.0,M2019-09-25D,Race(1),,
1,5,6,8,19,4,17,6,27,2,8,8,18,11,31,22,64,5,5,1.0,M2019-09-25D,Race(2),,
1,5,6,8,19,4,17,6,27,2,8,8,18,11,31,22,64,5,5,0.0,M2019-09-25D,Race(2),,
2,0,3,0,3,1,3,3,7,1,4,6,11,2,10,9,21,26,26,0.0,M2019-09-25D,Race(2),,
2,0,3,0,3,1,3,3,7,1,4,6,11,2,10,9,21,26,26,3.0,M2019-09-25D,Race(2),,
3,2,0,0,2,1,5,2,8,4,5,2,11,7,10,4,21,11,11,2.0,M2019-09-25D,Race(2),,
3,2,0,0,2,1,5,2,8,4,5,2,11,7,10,4,21,11,11,0.0,M2019-09-25D,Race(2),,
4,3,3,10,16,0,0,2,2,0,1,3,4,3,4,15,22,6,6,0.0,M2019-09-25D,Race(2),,
4,3,3,10,16,0,0,2,2,0,1,3,4,3,4,15,22,6,6,0.0,M2019-09-25D,Race(2),,
5,11,11,2,24,23,2,2,27,16,6,0,22,50,19,4,73,3.4,3.4,0.0,M2019-09-25D,Race(2),,
5,11,11,2,24,23,2,2,27,16,6,0,22,50,19,4,73,3.4,3.4,0.0,M2019-09-25D,Race(2),,
6,9,3,10,22,1,3,12,16,2,2,4,8,12,8,26,46,3,3,0.0,M2019-09-25D,Race(2),,
6,9,3,10,22,1,3,12,16,2,2,4,8,12,8,26,46,3,3,0.0,M2019-09-25D,Race(2),,
7,0,2,0,2,0,0,0,0,0,0,0,0,0,2,0,2,26,26,0.0,M2019-09-25D,Race(2),,
7,0,2,0,2,0,0,0,0,0,0,0,0,0,2,0,2,26,26,0.0,M2019-09-25D,Race(2),,
8,0,0,0,0,0,0,1,1,1,0,1,2,1,0,2,3,61,61,0.0,M2019-09-25D,Race(2),,
8,0,0,0,0,0,0,1,1,1,0,1,2,1,0,2,3,61,61,0.0,M2019-09-25D,Race(2),,
9,0,0,0,0,0,0,1,1,0,0,0,0,0,0,1,1,26,26,0.0,M2019-09-25D,Race(2),,
9,0,0,0,0,0,0,1,1,0,0,0,0,0,0,1,1,26,26,0.0,M2019-09-25D,Race(2),,
10,0,2,0,2,0,0,1,1,0,0,0,0,0,2,1,3,26,26,0.0,M2019-09-25D,Race(2),,
10,0,2,0,2,0,0,1,1,0,0,0,0,0,2,1,3,26,26,0.0,M2019-09-25D,Race(2),,
11,0,0,0,0,0,0,0,0,0,0,2,2,0,0,2,2,71,67,0.0,M2019-09-25D,Race(2),,
11,0,0,0,0,0,0,0,0,0,0,2,2,0,0,2,2,71,67,0.0,M2019-09-25D,Race(2),,
12,0,0,0,0,0,0,0,0,0,0,0,0,0,0,0,0,101,101,0.0,M2019-09-25D,Race(2),,
12,0,0,0,0,0,0,0,0,0,0,0,0,0,0,0,0,101,101,0.0,M2019-09-25D,Race(2),,
1,4,3,2,9,3,0,3,6,4,2,4,10,11,5,9,25,9,9,2.0,M2019-09-25D,Race(3),,
1,4,3,2,9,3,0,3,6,4,2,4,10,11,5,9,25,9,9,0.0,M2019-09-25D,Race(3),,
2,0,2,10,12,0,1,14,15,1,4,8,13,1,7,32,40,7,7,3.0,M2019-09-25D,Race(3),,
2,0,2,10,12,0,1,14,15,1,4,8,13,1,7,32,40,7,7,0.0,M2019-09-25D,Race(3),,
3,5,3,10,18,3,17,4,24,1,10,6,17,9,30,20,59,5,5,0.0,M2019-09-25D,Race(3),,
3,5,3,10,18,3,17,4,24,1,10,6,17,9,30,20,59,5,5,0.0,M2019-09-25D,Race(3),,
4,0,0,0,0,0,0,0,0,0,0,0,0,0,0,0,0,71,67,0.0,M2019-09-25D,Race(3),,
4,0,0,0,0,0,0,0,0,0,0,0,0,0,0,0,0,71,67,0.0,M2019-09-25D,Race(3),,
5,3,3,0,6,1,1,2,4,2,1,2,5,6,5,4,15,10,10,1.0,M2019-09-25D,Race(3),,
5,3,3,0,6,1,1,2,4,2,1,2,5,6,5,4,15,10,10,0.0,M2019-09-25D,Race(3),,
6,16,7,2,25,21,7,1,29,14,4,5,23,51,18,8,77,3.1,3.1,0.0,M2019-09-25D,Race(3),,
6,16,7,2,25,21,7,1,29,14,4,5,23,51,18,8,77,3.1,3.1,0.0,M2019-09-25D,Race(3),,
7,0,0,0,0,0,0,0,0,2,0,0,2,2,0,0,2,31,31,0.0,M2019-09-25D,Race(3),,
7,0,0,0,0,0,0,0,0,2,0,0,2,2,0,0,2,31,31,0.0,M2019-09-25D,Race(3),,
8,2,4,3,9,2,2,1,5,1,3,0,4,5,9,4,18,10,10,0.0,M2019-09-25D,Race(3),,
8,2,4,3,9,2,2,1,5,1,3,0,4,5,9,4,18,10,10,0.0,M2019-09-25D,Race(3),,
9,0,8,3,11,0,2,4,6,0,2,0,2,0,12,7,19,7.5,7.5,0.0,M2019-09-25D,Race(3),,
9,0,8,3,11,0,2,4,6,0,2,0,2,0,12,7,19,7.5,7.5,0.0,M2019-09-25D,Race(3),,
10,0,0,0,0,0,0,1,1,0,0,1,1,0,0,2,2,13,13,0.0,M2019-09-25D,Race(3),,
10,0,0,0,0,0,0,1,1,0,0,1,1,0,0,2,2,13,13,0.0,M2019-09-25D,Race(3),,
11,0,0,0,0,0,0,0,0,1,0,0,1,1,0,0,1,61,61,0.0,M2019-09-25D,Race(3),,
11,0,0,0,0,0,0,0,0,1,0,0,1,1,0,0,1,61,61,0.0,M2019-09-25D,Race(3),,
12,0,0,0,0,0,0,0,0,0,0,0,0,0,0,0,0,34,34,0.0,M2019-09-25D,Race(3),,
12,0,0,0,0,0,0,0,0,0,0,0,0,0,0,0,0,34,34,0.0,M2019-09-25D,Race(3),,
1,8,11,8,27,3,16,2,21,1,8,3,12,12,35,13,60,5,5,0.0,M2019-09-25D,Race(4),,
1,8,11,8,27,3,16,2,21,1,8,3,12,12,35,13,60,5,5,0.0,M2019-09-25D,Race(4),,
2,0,0,0,0,1,3,3,7,0,1,3,4,1,4,6,11,15,15,0.0,M2019-09-25D,Race(4),,
2,0,0,0,0,1,3,3,7,0,1,3,4,1,4,6,11,15,15,0.0,M2019-09-25D,Race(4),,
3,17,3,8,28,20,5,4,29,16,5,4,25,53,13,16,82,3,3,3.0,M2019-09-25D,Race(4),,
3,17,3,8,28,20,5,4,29,16,5,4,25,53,13,16,82,3,3,2.0,M2019-09-25D,Race(4),,
4,0,2,0,2,0,0,0,0,1,1,0,2,1,3,0,4,41,41,0.0,M2019-09-25D,Race(4),,
4,0,2,0,2,0,0,0,0,1,1,0,2,1,3,0,4,41,41,1.0,M2019-09-25D,Race(4),,
5,0,7,6,13,0,2,3,5,3,2,4,9,3,11,13,27,11,11,0.0,M2019-09-25D,Race(4),,
5,0,7,6,13,0,2,3,5,3,2,4,9,3,11,13,27,11,11,0.0,M2019-09-25D,Race(4),,
6,0,0,3,3,2,2,2,6,1,5,3,9,3,7,8,18,7,7,0.0,M2019-09-25D,Race(4),,
6,0,0,3,3,2,2,2,6,1,5,3,9,3,7,8,18,7,7,0.0,M2019-09-25D,Race(4),,
7,0,0,2,2,0,0,1,1,0,0,0,0,0,0,3,3,26,26,0.0,M2019-09-25D,Race(4),,
7,0,0,2,2,0,0,1,1,0,0,0,0,0,0,3,3,26,26,0.0,M2019-09-25D,Race(4),,
8,5,5,3,13,2,1,14,17,3,2,5,10,10,8,22,40,7.5,7.5,0.0,M2019-09-25D,Race(4),,
8,5,5,3,13,2,1,14,17,3,2,5,10,10,8,22,40,7.5,7.5,0.0,M2019-09-25D,Race(4),,
9,0,0,0,0,0,1,0,1,0,0,0,0,0,1,0,1,41,41,0.0,M2019-09-25D,Race(4),,
9,0,0,0,0,0,1,0,1,0,0,0,0,0,1,0,1,41,41,0.0,M2019-09-25D,Race(4),,
10,0,0,0,0,0,0,0,0,0,0,0,0,0,0,0,0,26,26,0.0,M2019-09-25D,Race(4),,
10,0,0,0,0,0,0,0,0,0,0,0,0,0,0,0,0,26,26,0.0,M2019-09-25D,Race(4),,
11,0,2,0,2,2,0,1,3,1,2,3,6,3,4,4,11,14,14,0.0,M2019-09-25D,Race(4),,
11,0,2,0,2,2,0,1,3,1,2,3,6,3,4,4,11,14,14,0.0,M2019-09-25D,Race(4),,
12,0,0,0,0,0,0,0,0,0,0,0,0,0,0,0,0,8.5,8.5,0.0,M2019-09-25D,Race(4),,
12,0,0,0,0,0,0,0,0,0,0,0,0,0,0,0,0,8.5,8.5,0.0,M2019-09-25D,Race(4),,
1,0,0,0,0,0,0,0,0,0,0,0,0,0,0,0,0,41,41,0.0,M2019-09-25D,Race(5),,
1,0,0,0,0,0,0,0,0,0,0,0,0,0,0,0,0,41,41,2.0,M2019-09-25D,Race(5),,
2,16,6,8,30,19,2,5,26,15,2,5,22,50,10,18,78,3.7,3.7,3.0,M2019-09-25D,Race(5),,
2,16,6,8,30,19,2,5,26,15,2,5,22,50,10,18,78,3.7,3.7,0.0,M2019-09-25D,Race(5),,
3,0,4,6,10,1,2,3,6,1,7,4,12,2,13,13,28,12,12,0.0,M2019-09-25D,Race(5),,
3,0,4,6,10,1,2,3,6,1,7,4,12,2,13,13,28,12,12,0.0,M2019-09-25D,Race(5),,
4,0,0,0,0,0,0,1,1,0,0,0,0,0,0,1,1,17,17,0.0,M2019-09-25D,Race(5),,
4,0,0,0,0,0,0,1,1,0,0,0,0,0,0,1,1,17,17,0.0,M2019-09-25D,Race(5),,
5,0,2,5,7,2,1,0,3,0,2,0,2,2,5,5,12,10,10,1.0,M2019-09-25D,Race(5),,
5,0,2,5,7,2,1,0,3,0,2,0,2,2,5,5,12,10,10,0.0,M2019-09-25D,Race(5),,
6,0,0,0,0,0,3,1,4,0,3,3,6,0,6,4,10,26,26,0.0,M2019-09-25D,Race(5),,
6,0,0,0,0,0,3,1,4,0,3,3,6,0,6,4,10,26,26,0.0,M2019-09-25D,Race(5),,
7,5,6,9,20,6,4,12,22,8,3,7,18,19,13,28,60,5,5,0.0,M2019-09-25D,Race(5),,
7,5,6,9,20,6,4,12,22,8,3,7,18,19,13,28,60,5,5,0.0,M2019-09-25D,Race(5),,
8,0,0,2,2,0,0,2,2,0,0,1,1,0,0,5,5,15,15,0.0,M2019-09-25D,Race(5),,
8,0,0,2,2,0,0,2,2,0,0,1,1,0,0,5,5,15,15,0.0,M2019-09-25D,Race(5),,
9,9,12,0,21,1,18,4,23,2,9,5,16,12,39,9,60,4,4,0.0,M2019-09-25D,Race(5),,
9,9,12,0,21,1,18,4,23,2,9,5,16,12,39,9,60,4,4,0.0,M2019-09-25D,Race(5),,
10,0,0,0,0,0,0,0,0,0,0,0,0,0,0,0,0,21,21,0.0,M2019-09-25D,Race(5),,
10,0,0,0,0,0,0,0,0,0,0,0,0,0,0,0,0,21,21,0.0,M2019-09-25D,Race(5),,
11,0,0,0,0,1,0,2,3,0,0,1,1,1,0,3,4,8,8,0.0,M2019-09-25D,Race(5),,
11,0,0,0,0,1,0,2,3,0,0,1,1,1,0,3,4,8,8,0.0,M2019-09-25D,Race(5),,
12,0,0,0,0,0,0,0,0,0,0,0,0,0,0,0,0,71,67,0.0,M2019-09-25D,Race(5),,
12,0,0,0,0,0,0,0,0,0,0,0,0,0,0,0,0,71,67,0.0,M2019-09-25D,Race(5),,
1,0,0,0,0,0,0,0,0,0,0,0,0,0,0,0,0,61,61,0.0,M2019-09-25D,Race(6),,
1,0,0,0,0,0,0,0,0,0,0,0,0,0,0,0,0,61,61,0.0,M2019-09-25D,Race(6),,
2,0,2,2,4,0,0,4,4,1,0,5,6,1,2,11,14,12,12,0.0,M2019-09-25D,Race(6),,
2,0,2,2,4,0,0,4,4,1,0,5,6,1,2,11,14,12,12,0.0,M2019-09-25D,Race(6),,
3,0,3,0,3,0,0,0,0,0,0,0,0,0,3,0,3,34,34,0.0,M2019-09-25D,Race(6),,
3,0,3,0,3,0,0,0,0,0,0,0,0,0,3,0,3,34,34,2.0,M2019-09-25D,Race(6),,
4,0,8,0,8,1,0,1,2,0,0,3,3,1,8,4,13,6,6,0.0,M2019-09-25D,Race(6),,
4,0,8,0,8,1,0,1,2,0,0,3,3,1,8,4,13,6,6,3.0,M2019-09-25D,Race(6),,
5,0,0,0,0,0,0,0,0,0,0,0,0,0,0,0,0,41,41,0.0,M2019-09-25D,Race(6),,
5,0,0,0,0,0,0,0,0,0,0,0,0,0,0,0,0,41,41,0.0,M2019-09-25D,Race(6),,
6,4,0,5,9,4,8,15,27,4,9,6,19,12,17,26,55,7,7,0.0,M2019-09-25D,Race(6),,
6,4,0,5,9,4,8,15,27,4,9,6,19,12,17,26,55,7,7,1.0,M2019-09-25D,Race(6),,
7,0,4,0,4,0,0,0,0,0,0,1,1,0,4,1,5,15,15,0.0,M2019-09-25D,Race(6),,
7,0,4,0,4,0,0,0,0,0,0,1,1,0,4,1,5,15,15,0.0,M2019-09-25D,Race(6),,
8,0,5,8,13,0,16,5,21,1,12,4,17,1,33,17,51,12,12,0.0,M2019-09-25D,Race(6),,
8,0,5,8,13,0,16,5,21,1,12,4,17,1,33,17,51,12,12,0.0,M2019-09-25D,Race(6),,
9,0,0,0,0,0,0,0,0,0,0,0,0,0,0,0,0,51,51,0.0,M2019-09-25D,Race(6),,
9,0,0,0,0,0,0,0,0,0,0,0,0,0,0,0,0,51,51,0.0,M2019-09-25D,Race(6),,
10,0,0,0,0,0,0,0,0,0,0,1,1,0,0,1,1,81,81,0.0,M2019-09-25D,Race(6),,
10,0,0,0,0,0,0,0,0,0,0,1,1,0,0,1,1,81,81,0.0,M2019-09-25D,Race(6),,
11,18,5,5,28,23,5,2,30,19,3,3,25,60,13,10,83,2.3,2.3,0.0,M2019-09-25D,Race(6),,
11,18,5,5,28,23,5,2,30,19,3,3,25,60,13,10,83,2.3,2.3,0.0,M2019-09-25D,Race(6),,
12,8,3,10,21,2,1,3,6,1,2,3,6,11,6,16,33,5,5,0.0,M2019-09-25D,Race(6),,
12,8,3,10,21,2,1,3,6,1,2,3,6,11,6,16,33,5,5,0.0,M2019-09-25D,Race(6),,
1,0,0,0,0,0,0,1,1,0,0,0,0,0,0,1,1,71,67,0.0,M2019-09-25D,Race(7),,
1,0,0,0,0,0,0,1,1,0,0,0,0,0,0,1,1,71,67,1.0,M2019-09-25D,Race(7),,
2,0,6,2,8,2,1,2,5,1,0,4,5,3,7,8,18,8.5,8.5,2.0,M2019-09-25D,Race(7),,
2,0,6,2,8,2,1,2,5,1,0,4,5,3,7,8,18,8.5,8.5,3.0,M2019-09-25D,Race(7),,
3,0,2,0,2,5,11,2,18,7,8,0,15,12,21,2,35,17,17,0.0,M2019-09-25D,Race(7),,
3,0,2,0,2,5,11,2,18,7,8,0,15,12,21,2,35,17,17,0.0,M2019-09-25D,Race(7),,
4,8,9,7,24,3,4,15,22,4,1,9,14,15,14,31,60,4,4,0.0,M2019-09-25D,Race(7),,
4,8,9,7,24,3,4,15,22,4,1,9,14,15,14,31,60,4,4,0.0,M2019-09-25D,Race(7),,
5,9,6,13,28,18,6,3,27,11,4,5,20,38,16,21,75,4.8,4.8,0.0,M2019-09-25D,Race(7),,
5,9,6,13,28,18,6,3,27,11,4,5,20,38,16,21,75,4.8,4.8,0.0,M2019-09-25D,Race(7),,
6,0,0,0,0,0,0,0,0,1,0,0,1,1,0,0,1,26,26,0.0,M2019-09-25D,Race(7),,
6,0,0,0,0,0,0,0,0,1,0,0,1,1,0,0,1,26,26,0.0,M2019-09-25D,Race(7),,
7,0,0,0,0,0,0,0,0,0,0,0,0,0,0,0,0,13,13,0.0,M2019-09-25D,Race(7),,
7,0,0,0,0,0,0,0,0,0,0,0,0,0,0,0,0,13,13,0.0,M2019-09-25D,Race(7),,
8,0,0,0,0,0,0,0,0,0,0,0,0,0,0,0,0,81,81,0.0,M2019-09-25D,Race(7),,
8,0,0,0,0,0,0,0,0,0,0,0,0,0,0,0,0,81,81,0.0,M2019-09-25D,Race(7),,
9,13,0,3,16,1,3,2,6,2,4,5,11,16,7,10,33,4,4,0.0,M2019-09-25D,Race(7),,
9,13,0,3,16,1,3,2,6,2,4,5,11,16,7,10,33,4,4,0.0,M2019-09-25D,Race(7),,
10,0,2,2,4,1,2,1,4,0,2,1,3,1,6,4,11,14,14,0.0,M2019-09-25D,Race(7),,
10,0,2,2,4,1,2,1,4,0,2,1,3,1,6,4,11,14,14,0.0,M2019-09-25D,Race(7),,
11,0,0,0,0,0,0,1,1,0,2,1,3,0,2,2,4,41,41,0.0,M2019-09-25D,Race(7),,
11,0,0,0,0,0,0,1,1,0,2,1,3,0,2,2,4,41,41,0.0,M2019-09-25D,Race(7),,
12,0,5,3,8,0,3,3,6,0,0,1,1,0,8,7,15,6.5,6.5,0.0,M2019-09-25D,Race(7),,
12,0,5,3,8,0,3,3,6,0,0,1,1,0,8,7,15,6.5,6.5,0.0,M2019-09-25D,Race(7),,
1,10,0,0,10,1,1,1,3,1,1,2,4,12,2,3,17,12,12,0.0,M2019-09-25D,Race(8),,
1,10,0,0,10,1,1,1,3,1,1,2,4,12,2,3,17,12,12,0.0,M2019-09-25D,Race(8),,
2,0,13,0,13,0,4,2,6,0,4,0,4,0,21,2,23,8.5,8.5,0.0,M2019-09-25D,Race(8),,
2,0,13,0,13,0,4,2,6,0,4,0,4,0,21,2,23,8.5,8.5,0.0,M2019-09-25D,Race(8),,
3,5,5,4,14,5,18,2,25,9,9,4,22,19,32,10,61,6.5,6.5,0.0,M2019-09-25D,Race(8),,
3,5,5,4,14,5,18,2,25,9,9,4,22,19,32,10,61,6.5,6.5,0.0,M2019-09-25D,Race(8),,
4,0,0,0,0,0,0,0,0,0,0,1,1,0,0,1,1,26,26,0.0,M2019-09-25D,Race(8),,
4,0,0,0,0,0,0,0,0,0,0,1,1,0,0,1,1,26,26,0.0,M2019-09-25D,Race(8),,
5,13,2,5,20,20,4,3,27,11,7,3,21,44,13,11,68,3.4,3.4,2.0,M2019-09-25D,Race(8),,
5,13,2,5,20,20,4,3,27,11,7,3,21,44,13,11,68,3.4,3.4,1.0,M2019-09-25D,Race(8),,
6,0,0,2,2,0,0,1,1,0,1,1,2,0,1,4,5,16,16,3.0,M2019-09-25D,Race(8),,
6,0,0,2,2,0,0,1,1,0,1,1,2,0,1,4,5,16,16,0.0,M2019-09-25D,Race(8),,
7,0,5,5,10,2,3,6,11,2,3,5,10,4,11,16,31,5.5,5.5,0.0,M2019-09-25D,Race(8),,
7,0,5,5,10,2,3,6,11,2,3,5,10,4,11,16,31,5.5,5.5,0.0,M2019-09-25D,Race(8),,
8,0,0,0,0,0,0,0,0,0,0,0,0,0,0,0,0,41,41,0.0,M2019-09-25D,Race(8),,
8,0,0,0,0,0,0,0,0,0,0,0,0,0,0,0,0,41,41,0.0,M2019-09-25D,Race(8),,
9,2,3,14,19,1,0,15,16,1,1,10,12,4,4,39,47,4.4,4.4,0.0,M2019-09-25D,Race(8),,
9,2,3,14,19,1,0,15,16,1,1,10,12,4,4,39,47,4.4,4.4,0.0,M2019-09-25D,Race(8),,
10,0,0,0,0,1,0,0,1,2,0,0,2,3,0,0,3,26,26,0.0,M2019-09-25D,Race(8),,
10,0,0,0,0,1,0,0,1,2,0,0,2,3,0,0,3,26,26,0.0,M2019-09-25D,Race(8),,
11,0,2,0,2,0,0,0,0,0,0,0,0,0,2,0,2,26,26,0.0,M2019-09-25D,Race(8),,
11,0,2,0,2,0,0,0,0,0,0,0,0,0,2,0,2,26,26,0.0,M2019-09-25D,Race(8),,
12,0,0,0,0,0,0,0,0,0,0,0,0,0,0,0,0,51,51,0.0,M2019-09-25D,Race(8),,
12,0,0,0,0,0,0,0,0,0,0,0,0,0,0,0,0,51,51,0.0,M2019-09-25D,Race(8),,
1,0,0,0,0,0,4,17,21,0,3,11,14,0,7,28,35,14,14,0.0,M2019-09-25D,Race(9),,
1,0,0,0,0,0,4,17,21,0,3,11,14,0,7,28,35,14,14,0.0,M2019-09-25D,Race(9),,
2,0,0,3,3,1,0,3,4,1,0,3,4,2,0,9,11,26,26,0.0,M2019-09-25D,Race(9),,
2,0,0,3,3,1,0,3,4,1,0,3,4,2,0,9,11,26,26,2.0,M2019-09-25D,Race(9),,
3,0,0,0,0,0,0,0,0,0,2,2,4,0,2,2,4,15,15,0.0,M2019-09-25D,Race(9),,
3,0,0,0,0,0,0,0,0,0,2,2,4,0,2,2,4,15,15,0.0,M2019-09-25D,Race(9),,
4,4,3,5,12,0,2,3,5,0,2,3,5,4,7,11,22,10,10,0.0,M2019-09-25D,Race(9),,
4,4,3,5,12,0,2,3,5,0,2,3,5,4,7,11,22,10,10,0.0,M2019-09-25D,Race(9),,
5,0,0,0,0,0,0,0,0,0,0,0,0,0,0,0,0,31,31,0.0,M2019-09-25D,Race(9),,
5,0,0,0,0,0,0,0,0,0,0,0,0,0,0,0,0,31,31,0.0,M2019-09-25D,Race(9),,
6,19,9,0,28,18,9,3,30,16,8,2,26,53,26,5,84,1.9,1.9,3.0,M2019-09-25D,Race(9),,
6,19,9,0,28,18,9,3,30,16,8,2,26,53,26,5,84,1.9,1.9,1.0,M2019-09-25D,Race(9),,
7,0,0,0,0,0,0,0,0,0,0,0,0,0,0,0,0,41,41,0.0,M2019-09-25D,Race(9),,
7,0,0,0,0,0,0,0,0,0,0,0,0,0,0,0,0,41,41,0.0,M2019-09-25D,Race(9),,
8,0,5,2,7,0,0,0,0,0,1,1,2,0,6,3,9,12,12,0.0,M2019-09-25D,Race(9),,
8,0,5,2,7,0,0,0,0,0,1,1,2,0,6,3,9,12,12,0.0,M2019-09-25D,Race(9),,
9,0,2,2,4,1,0,1,2,0,0,1,1,1,2,4,7,16,16,0.0,M2019-09-25D,Race(9),,
9,0,2,2,4,1,0,1,2,0,0,1,1,1,2,4,7,16,16,0.0,M2019-09-25D,Race(9),,
10,0,0,3,3,0,0,0,0,0,0,0,0,0,0,3,3,41,41,0.0,M2019-09-25D,Race(9),,
10,0,0,3,3,0,0,0,0,0,0,0,0,0,0,3,3,41,41,0.0,M2019-09-25D,Race(9),,
11,0,0,3,3,0,1,0,1,0,0,0,0,0,1,3,4,34,34,0.0,M2019-09-25D,Race(9),,
11,0,0,3,3,0,1,0,1,0,0,0,0,0,1,3,4,34,34,0.0,M2019-09-25D,Race(9),,
12,7,11,12,30,10,14,3,27,9,10,3,22,26,35,18,79,4.6,4.6,0.0,M2019-09-25D,Race(9),,
12,7,11,12,30,10,14,3,27,9,10,3,22,26,35,18,79,4.6,4.6,0.0,M2019-09-25D,Race(9),,
1,5,7,5,17,6,11,3,20,4,9,4,17,15,27,12,54,5.5,5.5,1.0,M2019-10-01D,Race(1),,
1,5,7,5,17,6,11,3,20,4,9,4,17,15,27,12,54,5.5,5.5,0.0,M2019-10-01D,Race(1),,
2,0,0,0,0,0,0,0,0,0,0,1,1,0,0,1,1,31,31,0.0,M2019-10-01D,Race(1),,
2,0,0,0,0,0,0,0,0,0,0,1,1,0,0,1,1,31,31,0.0,M2019-10-01D,Race(1),,
3,0,5,0,5,0,2,2,4,0,3,1,4,0,10,3,13,6.5,6.5,0.0,M2019-10-01D,Race(1),,
3,0,5,0,5,0,2,2,4,0,3,1,4,0,10,3,13,6.5,6.5,0.0,M2019-10-01D,Race(1),,
4,0,0,0,0,0,0,0,0,0,0,0,0,0,0,0,0,51,51,0.0,M2019-10-01D,Race(1),,
4,0,0,0,0,0,0,0,0,0,0,0,0,0,0,0,0,51,51,2.0,M2019-10-01D,Race(1),,
5,2,5,8,15,3,1,5,9,2,1,3,6,7,7,16,30,6.5,6.5,0.0,M2019-10-01D,Race(1),,
5,2,5,8,15,3,1,5,9,2,1,3,6,7,7,16,30,6.5,6.5,0.0,M2019-10-01D,Race(1),,
6,0,0,3,3,0,0,0,0,1,0,0,1,1,0,3,4,101,101,0.0,M2019-10-01D,Race(1),,
6,0,0,3,3,0,0,0,0,1,0,0,1,1,0,3,4,101,101,0.0,M2019-10-01D,Race(1),,
7,0,0,0,0,0,0,0,0,0,0,0,0,0,0,0,0,101,101,0.0,M2019-10-01D,Race(1),,
7,0,0,0,0,0,0,0,0,0,0,0,0,0,0,0,0,101,101,3.0,M2019-10-01D,Race(1),,
8,10,8,7,25,12,8,2,22,15,8,3,26,37,24,12,73,2.4,2.4,0.0,M2019-10-01D,Race(1),,
8,10,8,7,25,12,8,2,22,15,8,3,26,37,24,12,73,2.4,2.4,0.0,M2019-10-01D,Race(1),,
9,3,0,0,3,0,8,1,9,1,2,1,4,4,10,2,16,34,34,0.0,M2019-10-01D,Race(1),,
9,3,0,0,3,0,8,1,9,1,2,1,4,4,10,2,16,34,34,0.0,M2019-10-01D,Race(1),,
10,0,0,2,2,0,0,10,10,0,1,3,4,0,1,15,16,15,15,0.0,M2019-10-01D,Race(1),,
10,0,0,2,2,0,0,10,10,0,1,3,4,0,1,15,16,15,15,0.0,M2019-10-01D,Race(1),,
11,0,0,2,2,0,0,0,0,0,0,0,0,0,0,2,2,101,101,0.0,M2019-10-01D,Race(1),,
11,0,0,2,2,0,0,0,0,0,0,0,0,0,0,2,2,101,101,0.0,M2019-10-01D,Race(1),,
12,10,0,3,13,9,0,7,16,3,2,8,13,22,2,18,42,9,9,0.0,M2019-10-01D,Race(1),,
12,10,0,3,13,9,0,7,16,3,2,8,13,22,2,18,42,9,9,0.0,M2019-10-01D,Race(1),,
13,0,0,0,0,0,0,0,0,0,0,0,0,0,0,0,0,101,101,0.0,M2019-10-01D,Race(1),,
13,0,0,0,0,0,0,0,0,0,0,0,0,0,0,0,0,101,101,0.0,M2019-10-01D,Race(1),,
14,0,5,0,5,0,0,0,0,0,0,2,2,0,5,2,7,14,14,0.0,M2019-10-01D,Race(1),,
14,0,5,0,5,0,0,0,0,0,0,2,2,0,5,2,7,14,14,0.0,M2019-10-01D,Race(1),,
1,0,4,15,19,8,1,6,15,0,3,5,8,8,8,26,42,16,16,2.0,M2019-10-01D,Race(10),,
1,0,4,15,19,8,1,6,15,0,3,5,8,8,8,26,42,16,16,0.0,M2019-10-01D,Race(10),,
2,0,0,3,3,0,0,2,2,0,0,0,0,0,0,5,5,21,21,0.0,M2019-10-01D,Race(10),,
2,0,0,3,3,0,0,2,2,0,0,0,0,0,0,5,5,21,21,3.0,M2019-10-01D,Race(10),,
3,0,0,0,0,0,0,0,0,0,0,0,0,0,0,0,0,51,51,0.0,M2019-10-01D,Race(10),,
3,0,0,0,0,0,0,0,0,0,0,0,0,0,0,0,0,51,51,0.0,M2019-10-01D,Race(10),,
4,28,2,0,30,18,4,0,22,24,2,0,26,70,8,0,78,1.8,1.8,1.0,M2019-10-01D,Race(10),,
4,28,2,0,30,18,4,0,22,24,2,0,26,70,8,0,78,1.8,1.8,0.0,M2019-10-01D,Race(10),,
5,0,0,0,0,0,8,0,8,0,2,0,2,0,10,0,10,26,26,0.0,M2019-10-01D,Race(10),,
5,0,0,0,0,0,8,0,8,0,2,0,2,0,10,0,10,26,26,0.0,M2019-10-01D,Race(10),,
6,0,0,0,0,0,0,0,0,0,0,0,0,0,0,0,0,81,81,0.0,M2019-10-01D,Race(10),,
6,0,0,0,0,0,0,0,0,0,0,0,0,0,0,0,0,81,81,0.0,M2019-10-01D,Race(10),,
7,2,24,2,28,4,16,3,23,2,17,6,25,8,57,11,76,3.7,3.7,0.0,M2019-10-01D,Race(10),,
7,2,24,2,28,4,16,3,23,2,17,6,25,8,57,11,76,3.7,3.7,0.0,M2019-10-01D,Race(10),,
8,0,0,3,3,0,0,8,8,0,1,3,4,0,1,14,15,26,26,0.0,M2019-10-01D,Race(10),,
8,0,0,3,3,0,0,8,8,0,1,3,4,0,1,14,15,26,26,0.0,M2019-10-01D,Race(10),,
9,0,0,7,7,0,1,11,12,0,1,13,14,0,2,31,33,7.5,7.5,0.0,M2019-10-01D,Race(10),,
9,0,0,7,7,0,1,11,12,0,1,13,14,0,2,31,33,7.5,7.5,0.0,M2019-10-01D,Race(10),,
10,0,0,0,0,0,0,0,0,0,0,0,0,0,0,0,0,51,51,0.0,M2019-10-01D,Race(10),,
10,0,0,0,0,0,0,0,0,0,0,0,0,0,0,0,0,51,51,0.0,M2019-10-01D,Race(10),,
11,0,0,0,0,0,0,0,0,0,0,0,0,0,0,0,0,41,41,0.0,M2019-10-01D,Race(10),,
11,0,0,0,0,0,0,0,0,0,0,0,0,0,0,0,0,41,41,0.0,M2019-10-01D,Race(10),,
12,0,0,0,0,0,0,0,0,0,0,0,0,0,0,0,0,41,41,0.0,M2019-10-01D,Race(10),,
12,0,0,0,0,0,0,0,0,0,0,0,0,0,0,0,0,41,41,0.0,M2019-10-01D,Race(10),,
13,0,0,0,0,0,0,0,0,0,0,0,0,0,0,0,0,71,67,0.0,M2019-10-01D,Race(10),,
13,0,0,0,0,0,0,0,0,0,0,0,0,0,0,0,0,71,67,0.0,M2019-10-01D,Race(10),,
14,0,0,0,0,0,0,0,0,0,0,0,0,0,0,0,0,61,61,0.0,M2019-10-01D,Race(10),,
14,0,0,0,0,0,0,0,0,0,0,0,0,0,0,0,0,61,61,0.0,M2019-10-01D,Race(10),,
1,5,2,13,20,0,3,2,5,2,2,3,7,7,7,18,32,9.5,9.5,0.0,M2019-10-01D,Race(2),,
1,5,2,13,20,0,3,2,5,2,2,3,7,7,7,18,32,9.5,9.5,0.0,M2019-10-01D,Race(2),,
2,8,10,2,20,9,3,11,23,1,5,8,14,18,18,21,57,6,6,0.0,M2019-10-01D,Race(2),,
2,8,10,2,20,9,3,11,23,1,5,8,14,18,18,21,57,6,6,0.0,M2019-10-01D,Race(2),,
3,0,3,2,5,0,0,0,0,2,0,0,2,2,3,2,7,17,17,0.0,M2019-10-01D,Race(2),,
3,0,3,2,5,0,0,0,0,2,0,0,2,2,3,2,7,17,17,0.0,M2019-10-01D,Race(2),,
4,0,0,0,0,0,0,0,0,0,0,0,0,0,0,0,0,81,81,0.0,M2019-10-01D,Race(2),,
4,0,0,0,0,0,0,0,0,0,0,0,0,0,0,0,0,81,81,2.0,M2019-10-01D,Race(2),,
5,0,0,0,0,0,0,0,0,0,0,0,0,0,0,0,0,101,101,1.0,M2019-10-01D,Race(2),,
5,0,0,0,0,0,0,0,0,0,0,0,0,0,0,0,0,101,101,3.0,M2019-10-01D,Race(2),,
6,15,3,2,20,16,5,2,23,13,7,4,24,44,15,8,67,2.3,2.3,0.0,M2019-10-01D,Race(2),,
6,15,3,2,20,16,5,2,23,13,7,4,24,44,15,8,67,2.3,2.3,0.0,M2019-10-01D,Race(2),,
7,0,0,0,0,0,0,0,0,0,0,0,0,0,0,0,0,126,126,0.0,M2019-10-01D,Race(2),,
7,0,0,0,0,0,0,0,0,0,0,0,0,0,0,0,0,126,126,0.0,M2019-10-01D,Race(2),,
8,0,0,3,3,0,0,0,0,0,0,0,0,0,0,3,3,61,61,0.0,M2019-10-01D,Race(2),,
8,0,0,3,3,0,0,0,0,0,0,0,0,0,0,3,3,61,61,0.0,M2019-10-01D,Race(2),,
9,0,5,8,13,3,10,5,18,5,10,5,20,8,25,18,51,5.5,5.5,0.0,M2019-10-01D,Race(2),,
9,0,5,8,13,3,10,5,18,5,10,5,20,8,25,18,51,5.5,5.5,0.0,M2019-10-01D,Race(2),,
10,0,2,0,2,0,9,2,11,0,2,4,6,0,13,6,19,9,9,0.0,M2019-10-01D,Race(2),,
10,0,2,0,2,0,9,2,11,0,2,4,6,0,13,6,19,9,9,0.0,M2019-10-01D,Race(2),,
11,0,0,0,0,0,0,0,0,0,0,0,0,0,0,0,0,15,15,0.0,M2019-10-01D,Race(2),,
11,0,0,0,0,0,0,0,0,0,0,0,0,0,0,0,0,15,15,0.0,M2019-10-01D,Race(2),,
12,2,3,0,5,1,0,0,1,1,0,2,3,4,3,2,9,17,17,0.0,M2019-10-01D,Race(2),,
12,2,3,0,5,1,0,0,1,1,0,2,3,4,3,2,9,17,17,0.0,M2019-10-01D,Race(2),,
13,0,0,0,0,0,0,0,0,0,0,0,0,0,0,0,0,41,41,0.0,M2019-10-01D,Race(2),,
13,0,0,0,0,0,0,0,0,0,0,0,0,0,0,0,0,41,41,0.0,M2019-10-01D,Race(2),,
14,0,2,0,2,1,0,8,9,2,0,0,2,3,2,8,13,51,51,0.0,M2019-10-01D,Race(2),,
14,0,2,0,2,1,0,8,9,2,0,0,2,3,2,8,13,51,51,0.0,M2019-10-01D,Race(2),,
1,17,6,4,27,13,5,3,21,15,1,7,23,45,12,14,71,3.1,3.1,0.0,M2019-10-01D,Race(3),,
1,17,6,4,27,13,5,3,21,15,1,7,23,45,12,14,71,3.1,3.1,0.0,M2019-10-01D,Race(3),,
2,3,5,9,17,9,10,6,25,3,14,2,19,15,29,17,61,5.5,5.5,3.0,M2019-10-01D,Race(3),,
2,3,5,9,17,9,10,6,25,3,14,2,19,15,29,17,61,5.5,5.5,0.0,M2019-10-01D,Race(3),,
3,3,10,0,13,0,8,7,15,0,4,5,9,3,22,12,37,6,6,1.0,M2019-10-01D,Race(3),,
3,3,10,0,13,0,8,7,15,0,4,5,9,3,22,12,37,6,6,2.0,M2019-10-01D,Race(3),,
4,0,0,0,0,0,0,0,0,0,0,1,1,0,0,1,1,14,14,0.0,M2019-10-01D,Race(3),,
4,0,0,0,0,0,0,0,0,0,0,1,1,0,0,1,1,14,14,0.0,M2019-10-01D,Race(3),,
5,5,6,17,28,8,7,5,20,8,4,7,19,21,17,29,67,2.9,2.9,0.0,M2019-10-01D,Race(3),,
5,5,6,17,28,8,7,5,20,8,4,7,19,21,17,29,67,2.9,2.9,0.0,M2019-10-01D,Race(3),,
6,2,0,0,2,0,0,1,1,0,2,2,4,2,2,3,7,10,10,0.0,M2019-10-01D,Race(3),,
6,2,0,0,2,0,0,1,1,0,2,2,4,2,2,3,7,10,10,0.0,M2019-10-01D,Race(3),,
7,0,3,0,3,0,0,8,8,0,1,2,3,0,4,10,14,9.5,9.5,0.0,M2019-10-01D,Race(3),,
7,0,3,0,3,0,0,8,8,0,1,2,3,0,4,10,14,9.5,9.5,0.0,M2019-10-01D,Race(3),,
1,7,3,5,15,3,4,5,12,2,4,4,10,12,11,14,37,7,7,1.0,M2019-10-01D,Race(4),,
1,7,3,5,15,3,4,5,12,2,4,4,10,12,11,14,37,7,7,0.0,M2019-10-01D,Race(4),,
2,0,0,0,0,0,0,0,0,0,0,0,0,0,0,0,0,81,81,0.0,M2019-10-01D,Race(4),,
2,0,0,0,0,0,0,0,0,0,0,0,0,0,0,0,0,81,81,0.0,M2019-10-01D,Race(4),,
3,7,3,6,16,1,8,3,12,1,8,3,12,9,19,12,40,5.5,5.5,0.0,M2019-10-01D,Race(4),,
3,7,3,6,16,1,8,3,12,1,8,3,12,9,19,12,40,5.5,5.5,0.0,M2019-10-01D,Race(4),,
4,0,3,0,3,0,8,2,10,0,0,0,0,0,11,2,13,13,13,0.0,M2019-10-01D,Race(4),,
4,0,3,0,3,0,8,2,10,0,0,0,0,0,11,2,13,13,13,2.0,M2019-10-01D,Race(4),,
5,3,8,8,19,1,3,7,11,1,1,10,12,5,12,25,42,7.5,7.5,0.0,M2019-10-01D,Race(4),,
5,3,8,8,19,1,3,7,11,1,1,10,12,5,12,25,42,7.5,7.5,0.0,M2019-10-01D,Race(4),,
6,0,0,3,3,0,1,8,9,0,2,0,2,0,3,11,14,13,13,0.0,M2019-10-01D,Race(4),,
6,0,0,3,3,0,1,8,9,0,2,0,2,0,3,11,14,13,13,0.0,M2019-10-01D,Race(4),,
7,0,0,0,0,0,0,0,0,1,0,0,1,1,0,0,1,81,81,0.0,M2019-10-01D,Race(4),,
7,0,0,0,0,0,0,0,0,1,0,0,1,1,0,0,1,81,81,3.0,M2019-10-01D,Race(4),,
8,11,7,5,23,17,3,1,21,21,4,0,25,49,14,6,69,2.9,2.9,0.0,M2019-10-01D,Race(4),,
8,11,7,5,23,17,3,1,21,21,4,0,25,49,14,6,69,2.9,2.9,0.0,M2019-10-01D,Race(4),,
9,0,0,0,0,0,0,0,0,0,1,0,1,0,1,0,1,19,19,0.0,M2019-10-01D,Race(4),,
9,0,0,0,0,0,0,0,0,0,1,0,1,0,1,0,1,19,19,0.0,M2019-10-01D,Race(4),,
10,0,0,0,0,0,0,0,0,0,0,0,0,0,0,0,0,71,67,0.0,M2019-10-01D,Race(4),,
10,0,0,0,0,0,0,0,0,0,0,0,0,0,0,0,0,71,67,0.0,M2019-10-01D,Race(4),,
11,0,0,0,0,0,0,0,0,0,0,0,0,0,0,0,0,81,81,0.0,M2019-10-01D,Race(4),,
11,0,0,0,0,0,0,0,0,0,0,0,0,0,0,0,0,81,81,0.0,M2019-10-01D,Race(4),,
12,0,0,3,3,0,1,2,3,0,1,6,7,0,2,11,13,12,12,0.0,M2019-10-01D,Race(4),,
12,0,0,3,3,0,1,2,3,0,1,6,7,0,2,11,13,12,12,0.0,M2019-10-01D,Race(4),,
13,0,0,0,0,0,0,0,0,0,0,0,0,0,0,0,0,71,67,0.0,M2019-10-01D,Race(4),,
13,0,0,0,0,0,0,0,0,0,0,0,0,0,0,0,0,71,67,0.0,M2019-10-01D,Race(4),,
14,2,6,0,8,8,2,2,12,0,5,3,8,10,13,5,28,8.5,8.5,0.0,M2019-10-01D,Race(4),,
14,2,6,0,8,8,2,2,12,0,5,3,8,10,13,5,28,8.5,8.5,0.0,M2019-10-01D,Race(4),,
1,0,2,0,2,1,1,2,4,1,1,3,5,2,4,5,11,18,18,0.0,M2019-10-01D,Race(5),,
1,0,2,0,2,1,1,2,4,1,1,3,5,2,4,5,11,18,18,3.0,M2019-10-01D,Race(5),,
2,14,6,2,22,14,4,3,21,14,4,4,22,42,14,9,65,4.8,4.8,0.0,M2019-10-01D,Race(5),,
2,14,6,2,22,14,4,3,21,14,4,4,22,42,14,9,65,4.8,4.8,0.0,M2019-10-01D,Race(5),,
3,4,3,10,17,3,7,3,13,3,8,1,12,10,18,14,42,4.8,4.8,1.0,M2019-10-01D,Race(5),,
3,4,3,10,17,3,7,3,13,3,8,1,12,10,18,14,42,4.8,4.8,0.0,M2019-10-01D,Race(5),,
4,0,0,0,0,0,0,0,0,0,0,0,0,0,0,0,0,51,51,0.0,M2019-10-01D,Race(5),,
4,0,0,0,0,0,0,0,0,0,0,0,0,0,0,0,0,51,51,2.0,M2019-10-01D,Race(5),,
5,9,8,10,27,4,7,7,18,6,6,6,18,19,21,23,63,2.6,2.6,0.0,M2019-10-01D,Race(5),,
5,9,8,10,27,4,7,7,18,6,6,6,18,19,21,23,63,2.6,2.6,0.0,M2019-10-01D,Race(5),,
6,0,2,0,2,0,10,4,14,0,0,0,0,0,12,4,16,51,51,0.0,M2019-10-01D,Race(5),,
6,0,2,0,2,0,10,4,14,0,0,0,0,0,12,4,16,51,51,0.0,M2019-10-01D,Race(5),,
7,0,3,0,3,0,0,0,0,0,0,0,0,0,3,0,3,11,11,0.0,M2019-10-01D,Race(5),,
7,0,3,0,3,0,0,0,0,0,0,0,0,0,3,0,3,11,11,0.0,M2019-10-01D,Race(5),,
8,3,6,8,17,8,1,3,12,1,4,3,8,12,11,14,37,7,7,0.0,M2019-10-01D,Race(5),,
8,3,6,8,17,8,1,3,12,1,4,3,8,12,11,14,37,7,7,0.0,M2019-10-01D,Race(5),,
9,0,0,0,0,0,0,0,0,0,0,0,0,0,0,0,0,101,101,0.0,M2019-10-01D,Race(5),,
9,0,0,0,0,0,0,0,0,0,0,0,0,0,0,0,0,101,101,0.0,M2019-10-01D,Race(5),,
10,0,0,0,0,0,0,0,0,0,0,0,0,0,0,0,0,51,51,0.0,M2019-10-01D,Race(5),,
10,0,0,0,0,0,0,0,0,0,0,0,0,0,0,0,0,51,51,0.0,M2019-10-01D,Race(5),,
11,0,0,0,0,0,0,0,0,0,0,0,0,0,0,0,0,19,19,0.0,M2019-10-01D,Race(5),,
11,0,0,0,0,0,0,0,0,0,0,0,0,0,0,0,0,19,19,0.0,M2019-10-01D,Race(5),,
12,0,0,0,0,0,0,8,8,0,0,3,3,0,0,11,11,26,26,0.0,M2019-10-01D,Race(5),,
12,0,0,0,0,0,0,8,8,0,0,3,3,0,0,11,11,26,26,0.0,M2019-10-01D,Race(5),,
13,0,0,0,0,0,0,0,0,0,0,0,0,0,0,0,0,41,41,0.0,M2019-10-01D,Race(5),,
13,0,0,0,0,0,0,0,0,0,0,0,0,0,0,0,0,41,41,0.0,M2019-10-01D,Race(5),,
14,0,0,0,0,0,0,0,0,0,0,0,0,0,0,0,0,151,201,0.0,M2019-10-01D,Race(5),,
14,0,0,0,0,0,0,0,0,0,0,0,0,0,0,0,0,151,201,0.0,M2019-10-01D,Race(5),,
1,3,5,5,13,5,8,1,14,5,0,1,6,13,13,7,33,8.5,8.5,0.0,M2019-10-01D,Race(6),,
1,3,5,5,13,5,8,1,14,5,0,1,6,13,13,7,33,8.5,8.5,0.0,M2019-10-01D,Race(6),,
2,2,0,0,2,0,0,8,8,0,0,2,2,2,0,10,12,14,14,2.0,M2019-10-01D,Race(6),,
2,2,0,0,2,0,0,8,8,0,0,2,2,2,0,10,12,14,14,0.0,M2019-10-01D,Race(6),,
3,0,0,2,2,0,0,0,0,0,0,0,0,0,0,2,2,41,41,0.0,M2019-10-01D,Race(6),,
3,0,0,2,2,0,0,0,0,0,0,0,0,0,0,2,2,41,41,0.0,M2019-10-01D,Race(6),,
4,5,5,7,17,7,9,3,19,8,3,7,18,20,17,17,54,4.6,4.6,0.0,M2019-10-01D,Race(6),,
4,5,5,7,17,7,9,3,19,8,3,7,18,20,17,17,54,4.6,4.6,1.0,M2019-10-01D,Race(6),,
5,0,0,0,0,0,0,0,0,0,0,0,0,0,0,0,0,71,67,0.0,M2019-10-01D,Race(6),,
5,0,0,0,0,0,0,0,0,0,0,0,0,0,0,0,0,71,67,0.0,M2019-10-01D,Race(6),,
6,0,0,0,0,0,0,0,0,1,1,0,2,1,1,0,2,51,51,3.0,M2019-10-01D,Race(6),,
6,0,0,0,0,0,0,0,0,1,1,0,2,1,1,0,2,51,51,0.0,M2019-10-01D,Race(6),,
7,0,5,0,5,9,1,1,11,2,1,0,3,11,7,1,19,13,13,0.0,M2019-10-01D,Race(6),,
7,0,5,0,5,9,1,1,11,2,1,0,3,11,7,1,19,13,13,0.0,M2019-10-01D,Race(6),,
8,2,10,3,15,2,3,6,11,2,5,4,11,6,18,13,37,6,6,0.0,M2019-10-01D,Race(6),,
8,2,10,3,15,2,3,6,11,2,5,4,11,6,18,13,37,6,6,0.0,M2019-10-01D,Race(6),,
9,0,0,0,0,0,0,0,0,0,0,0,0,0,0,0,0,31,31,0.0,M2019-10-01D,Race(6),,
9,0,0,0,0,0,0,0,0,0,0,0,0,0,0,0,0,31,31,0.0,M2019-10-01D,Race(6),,
10,5,0,5,10,2,2,4,8,5,4,4,13,12,6,13,31,4.2,4.2,0.0,M2019-10-01D,Race(6),,
10,5,0,5,10,2,2,4,8,5,4,4,13,12,6,13,31,4.2,4.2,0.0,M2019-10-01D,Race(6),,
11,13,5,6,24,5,7,5,17,3,12,5,20,21,24,16,61,4.4,4.4,0.0,M2019-10-01D,Race(6),,
11,13,5,6,24,5,7,5,17,3,12,5,20,21,24,16,61,4.4,4.4,0.0,M2019-10-01D,Race(6),,
12,0,0,0,0,0,0,0,0,0,0,1,1,0,0,1,1,101,101,0.0,M2019-10-01D,Race(6),,
12,0,0,0,0,0,0,0,0,0,0,1,1,0,0,1,1,101,101,0.0,M2019-10-01D,Race(6),,
13,0,0,0,0,0,0,0,0,0,0,0,0,0,0,0,0,34,34,0.0,M2019-10-01D,Race(6),,
13,0,0,0,0,0,0,0,0,0,0,0,0,0,0,0,0,34,34,0.0,M2019-10-01D,Race(6),,
14,0,0,2,2,0,0,9,9,0,0,2,2,0,0,13,13,34,34,0.0,M2019-10-01D,Race(6),,
14,0,0,2,2,0,0,9,9,0,0,2,2,0,0,13,13,34,34,0.0,M2019-10-01D,Race(6),,
1,30,0,0,30,22,1,0,23,19,2,0,21,71,3,0,74,1.3,1.3,1.0,M2019-10-01D,Race(7),,
1,30,0,0,30,22,1,0,23,19,2,0,21,71,3,0,74,1.3,1.3,0.0,M2019-10-01D,Race(7),,
2,0,6,6,12,0,4,3,7,0,5,3,8,0,15,12,27,31,31,0.0,M2019-10-01D,Race(7),,
2,0,6,6,12,0,4,3,7,0,5,3,8,0,15,12,27,31,31,0.0,M2019-10-01D,Race(7),,
3,0,5,6,11,0,0,9,9,0,0,4,4,0,5,19,24,19,19,2.0,M2019-10-01D,Race(7),,
3,0,5,6,11,0,0,9,9,0,0,4,4,0,5,19,24,19,19,0.0,M2019-10-01D,Race(7),,
4,0,2,7,9,0,5,2,7,0,8,2,10,0,15,11,26,13,13,3.0,M2019-10-01D,Race(7),,
4,0,2,7,9,0,5,2,7,0,8,2,10,0,15,11,26,13,13,0.0,M2019-10-01D,Race(7),,
5,0,10,3,13,0,2,5,7,0,4,4,8,0,16,12,28,10,10,0.0,M2019-10-01D,Race(7),,
5,0,10,3,13,0,2,5,7,0,4,4,8,0,16,12,28,10,10,0.0,M2019-10-01D,Race(7),,
6,0,2,4,6,0,3,2,5,0,2,5,7,0,7,11,18,26,26,0.0,M2019-10-01D,Race(7),,
6,0,2,4,6,0,3,2,5,0,2,5,7,0,7,11,18,26,26,0.0,M2019-10-01D,Race(7),,
7,0,5,4,9,8,7,9,24,2,5,7,14,10,17,20,47,6.5,6.5,0.0,M2019-10-01D,Race(7),,
7,0,5,4,9,8,7,9,24,2,5,7,14,10,17,20,47,6.5,6.5,0.0,M2019-10-01D,Race(7),,
8,0,0,0,0,0,0,0,0,0,0,0,0,0,0,0,0,71,67,0.0,M2019-10-01D,Race(7),,
8,0,0,0,0,0,0,0,0,0,0,0,0,0,0,0,0,71,67,0.0,M2019-10-01D,Race(7),,
9,0,0,0,0,0,8,0,8,0,0,1,1,0,8,1,9,41,41,0.0,M2019-10-01D,Race(7),,
9,0,0,0,0,0,8,0,8,0,0,1,1,0,8,1,9,41,41,0.0,M2019-10-01D,Race(7),,
10,0,0,0,0,0,0,0,0,0,0,0,0,0,0,0,0,71,67,0.0,M2019-10-01D,Race(7),,
10,0,0,0,0,0,0,0,0,0,0,0,0,0,0,0,0,71,67,0.0,M2019-10-01D,Race(7),,
1,0,0,0,0,0,0,0,0,0,0,0,0,0,0,0,0,34,34,0.0,M2019-10-01D,Race(8),,
1,0,0,0,0,0,0,0,0,0,0,0,0,0,0,0,0,34,34,1.0,M2019-10-01D,Race(8),,
2,21,5,4,30,19,3,1,23,23,2,0,25,63,10,5,78,1.9,1.9,0.0,M2019-10-01D,Race(8),,
2,21,5,4,30,19,3,1,23,23,2,0,25,63,10,5,78,1.9,1.9,0.0,M2019-10-01D,Race(8),,
3,0,5,2,7,0,8,3,11,0,2,7,9,0,15,12,27,13,13,0.0,M2019-10-01D,Race(8),,
3,0,5,2,7,0,8,3,11,0,2,7,9,0,15,12,27,13,13,3.0,M2019-10-01D,Race(8),,
4,0,0,0,0,0,0,3,3,0,0,2,2,0,0,5,5,41,41,0.0,M2019-10-01D,Race(8),,
4,0,0,0,0,0,0,3,3,0,0,2,2,0,0,5,5,41,41,0.0,M2019-10-01D,Race(8),,
5,0,0,0,0,0,0,0,0,0,0,0,0,0,0,0,0,21,21,0.0,M2019-10-01D,Race(8),,
5,0,0,0,0,0,0,0,0,0,0,0,0,0,0,0,0,21,21,0.0,M2019-10-01D,Race(8),,
6,0,4,14,18,0,1,9,10,0,2,4,6,0,7,27,34,8.5,8.5,0.0,M2019-10-01D,Race(8),,
6,0,4,14,18,0,1,9,10,0,2,4,6,0,7,27,34,8.5,8.5,2.0,M2019-10-01D,Race(8),,
7,0,0,0,0,0,0,0,0,0,0,0,0,0,0,0,0,34,34,0.0,M2019-10-01D,Race(8),,
7,0,0,0,0,0,0,0,0,0,0,0,0,0,0,0,0,34,34,0.0,M2019-10-01D,Race(8),,
8,0,0,0,0,0,0,8,8,0,0,4,4,0,0,12,12,34,34,0.0,M2019-10-01D,Race(8),,
8,0,0,0,0,0,0,8,8,0,0,4,4,0,0,12,12,34,34,0.0,M2019-10-01D,Race(8),,
9,7,11,5,23,11,16,2,29,3,18,3,24,21,45,10,76,5,5,0.0,M2019-10-01D,Race(8),,
9,7,11,5,23,11,16,2,29,3,18,3,24,21,45,10,76,5,5,0.0,M2019-10-01D,Race(8),,
10,0,0,0,0,0,0,0,0,0,0,0,0,0,0,0,0,101,101,0.0,M2019-10-01D,Race(8),,
10,0,0,0,0,0,0,0,0,0,0,0,0,0,0,0,0,101,101,0.0,M2019-10-01D,Race(8),,
11,2,0,3,5,0,2,2,4,0,2,3,5,2,4,8,14,17,17,0.0,M2019-10-01D,Race(8),,
11,2,0,3,5,0,2,2,4,0,2,3,5,2,4,8,14,17,17,0.0,M2019-10-01D,Race(8),,
12,0,0,0,0,0,0,2,2,0,0,2,2,0,0,4,4,12,12,0.0,M2019-10-01D,Race(8),,
12,0,0,0,0,0,0,2,2,0,0,2,2,0,0,4,4,12,12,0.0,M2019-10-01D,Race(8),,
13,0,5,2,7,0,0,0,0,0,0,1,1,0,5,3,8,26,26,0.0,M2019-10-01D,Race(8),,
13,0,5,2,7,0,0,0,0,0,0,1,1,0,5,3,8,26,26,0.0,M2019-10-01D,Race(8),,
14,0,0,0,0,0,0,0,0,0,0,0,0,0,0,0,0,126,126,0.0,M2019-10-01D,Race(8),,
14,0,0,0,0,0,0,0,0,0,0,0,0,0,0,0,0,126,126,0.0,M2019-10-01D,Race(8),,
1,2,0,3,5,0,8,0,8,0,3,1,4,2,11,4,17,9,9,0.0,M2019-10-01D,Race(9),,
1,2,0,3,5,0,8,0,8,0,3,1,4,2,11,4,17,9,9,0.0,M2019-10-01D,Race(9),,
2,5,8,8,21,7,6,7,20,7,7,9,23,19,21,24,64,6,6,2.0,M2019-10-01D,Race(9),,
2,5,8,8,21,7,6,7,20,7,7,9,23,19,21,24,64,6,6,1.0,M2019-10-01D,Race(9),,
3,11,11,4,26,10,6,5,21,10,6,4,20,31,23,13,67,4,4,3.0,M2019-10-01D,Race(9),,
3,11,11,4,26,10,6,5,21,10,6,4,20,31,23,13,67,4,4,0.0,M2019-10-01D,Race(9),,
4,7,5,8,20,4,8,8,20,8,8,7,23,19,21,23,63,3,3,0.0,M2019-10-01D,Race(9),,
4,7,5,8,20,4,8,8,20,8,8,7,23,19,21,23,63,3,3,0.0,M2019-10-01D,Race(9),,
5,0,0,0,0,0,0,0,0,0,0,0,0,0,0,0,0,21,21,0.0,M2019-10-01D,Race(9),,
5,0,0,0,0,0,0,0,0,0,0,0,0,0,0,0,0,21,21,0.0,M2019-10-01D,Race(9),,
6,3,0,5,8,1,2,1,4,1,2,0,3,5,4,6,15,7.5,7.5,0.0,M2019-10-01D,Race(9),,
6,3,0,5,8,1,2,1,4,1,2,0,3,5,4,6,15,7.5,7.5,0.0,M2019-10-01D,Race(9),,
7,0,0,2,2,8,0,1,9,0,0,2,2,8,0,5,13,21,21,0.0,M2019-10-01D,Race(9),,
7,0,0,2,2,8,0,1,9,0,0,2,2,8,0,5,13,21,21,0.0,M2019-10-01D,Race(9),,
8,0,2,0,2,0,0,0,0,0,0,1,1,0,2,1,3,26,26,0.0,M2019-10-01D,Race(9),,
8,0,2,0,2,0,0,0,0,0,0,1,1,0,2,1,3,26,26,0.0,M2019-10-01D,Race(9),,
9,0,2,0,2,0,0,0,0,0,0,0,0,0,2,0,2,81,81,0.0,M2019-10-01D,Race(9),,
9,0,2,0,2,0,0,0,0,0,0,0,0,0,2,0,2,81,81,0.0,M2019-10-01D,Race(9),,
10,2,2,0,4,0,0,8,8,0,0,2,2,2,2,10,14,14,14,0.0,M2019-10-01D,Race(9),,
10,2,2,0,4,0,0,8,8,0,0,2,2,2,2,10,14,14,14,0.0,M2019-10-01D,Race(9),,
11,0,0,0,0,0,0,0,0,0,0,0,0,0,0,0,0,41,41,0.0,M2019-10-01D,Race(9),,
11,0,0,0,0,0,0,0,0,0,0,0,0,0,0,0,0,41,41,0.0,M2019-10-01D,Race(9),,
12,0,0,0,0,0,0,0,0,0,0,0,0,0,0,0,0,101,101,0.0,M2019-10-01D,Race(9),,
12,0,0,0,0,0,0,0,0,0,0,0,0,0,0,0,0,101,101,0.0,M2019-10-01D,Race(9),,
13,0,0,0,0,0,0,0,0,0,0,0,0,0,0,0,0,71,67,0.0,M2019-10-01D,Race(9),,
13,0,0,0,0,0,0,0,0,0,0,0,0,0,0,0,0,71,67,0.0,M2019-10-01D,Race(9),,
14,0,0,0,0,0,0,0,0,0,0,0,0,0,0,0,0,61,61,0.0,M2019-10-01D,Race(9),,
14,0,0,0,0,0,0,0,0,0,0,0,0,0,0,0,0,61,61,0.0,M2019-10-01D,Race(9),,
1,0,2,3,5,3,1,4,8,4,3,5,12,7,6,12,25,15,15,0.0,M2019-10-16D,Race(1),,
1,0,2,3,5,3,1,4,8,4,3,5,12,7,6,12,25,15,15,0.0,M2019-10-16D,Race(1),,
2,15,0,11,26,8,9,2,19,7,12,3,22,30,21,16,67,2.5,2.5,3.0,M2019-10-16D,Race(1),,
2,15,0,11,26,8,9,2,19,7,12,3,22,30,21,16,67,2.5,2.5,0.0,M2019-10-16D,Race(1),,
3,0,10,2,12,4,5,4,13,8,7,3,18,12,22,9,43,6.5,6.5,1.0,M2019-10-16D,Race(1),,
3,0,10,2,12,4,5,4,13,8,7,3,18,12,22,9,43,6.5,6.5,0.0,M2019-10-16D,Race(1),,
4,0,10,5,15,7,4,3,14,4,3,5,12,11,17,13,41,12,12,0.0,M2019-10-16D,Race(1),,
4,0,10,5,15,7,4,3,14,4,3,5,12,11,17,13,41,12,12,0.0,M2019-10-16D,Race(1),,
5,7,2,0,9,0,0,8,8,0,0,3,3,7,2,11,20,17,17,0.0,M2019-10-16D,Race(1),,
5,7,2,0,9,0,0,8,8,0,0,3,3,7,2,11,20,17,17,0.0,M2019-10-16D,Race(1),,
6,2,0,0,2,0,0,0,0,2,0,0,2,4,0,0,4,71,67,2.0,M2019-10-16D,Race(1),,
6,2,0,0,2,0,0,0,0,2,0,0,2,4,0,0,4,71,67,0.0,M2019-10-16D,Race(1),,
7,0,0,3,3,0,9,0,9,0,0,1,1,0,9,4,13,12,12,0.0,M2019-10-16D,Race(1),,
7,0,0,3,3,0,9,0,9,0,0,1,1,0,9,4,13,12,12,0.0,M2019-10-16D,Race(1),,
8,6,3,6,15,0,2,9,11,1,1,6,8,7,6,21,34,5,5,0.0,M2019-10-16D,Race(1),,
8,6,3,6,15,0,2,9,11,1,1,6,8,7,6,21,34,5,5,0.0,M2019-10-16D,Race(1),,
9,0,0,0,0,0,0,0,0,0,0,0,0,0,0,0,0,21,21,0.0,M2019-10-16D,Race(1),,
9,0,0,0,0,0,0,0,0,0,0,0,0,0,0,0,0,21,21,0.0,M2019-10-16D,Race(1),,
10,0,3,0,3,8,0,0,8,0,0,0,0,8,3,0,11,7.5,7.5,0.0,M2019-10-16D,Race(1),,
10,0,3,0,3,8,0,0,8,0,0,0,0,8,3,0,11,7.5,7.5,0.0,M2019-10-16D,Race(1),,
11,0,0,0,0,0,0,0,0,0,0,0,0,0,0,0,0,26,26,0.0,M2019-10-16D,Race(1),,
11,0,0,0,0,0,0,0,0,0,0,0,0,0,0,0,0,26,26,0.0,M2019-10-16D,Race(1),,
12,0,0,0,0,0,0,0,0,0,0,0,0,0,0,0,0,0,0,0.0,M2019-10-16D,Race(1),,
12,0,0,0,0,0,0,0,0,0,0,0,0,0,0,0,0,0,0,0.0,M2019-10-16D,Race(1),,
1,20,3,7,30,22,1,0,23,17,3,2,22,59,7,9,75,2.1,2.1,0.0,M2019-10-16D,Race(2),,
1,20,3,7,30,22,1,0,23,17,3,2,22,59,7,9,75,2.1,2.1,0.0,M2019-10-16D,Race(2),,
2,2,5,3,10,8,2,3,13,0,4,3,7,10,11,9,30,6.5,6.5,0.0,M2019-10-16D,Race(2),,
2,2,5,3,10,8,2,3,13,0,4,3,7,10,11,9,30,6.5,6.5,0.0,M2019-10-16D,Race(2),,
3,0,0,2,2,0,0,0,0,0,0,0,0,0,0,2,2,51,51,0.0,M2019-10-16D,Race(2),,
3,0,0,2,2,0,0,0,0,0,0,0,0,0,0,2,2,51,51,0.0,M2019-10-16D,Race(2),,
4,0,4,0,4,0,0,0,0,4,2,1,7,4,6,1,11,13,13,1.0,M2019-10-16D,Race(2),,
4,0,4,0,4,0,0,0,0,4,2,1,7,4,6,1,11,13,13,0.0,M2019-10-16D,Race(2),,
5,0,0,0,0,0,0,0,0,0,0,0,0,0,0,0,0,81,81,2.0,M2019-10-16D,Race(2),,
5,0,0,0,0,0,0,0,0,0,0,0,0,0,0,0,0,81,81,0.0,M2019-10-16D,Race(2),,
6,0,2,3,5,0,9,4,13,3,13,3,19,3,24,10,37,13,13,3.0,M2019-10-16D,Race(2),,
6,0,2,3,5,0,9,4,13,3,13,3,19,3,24,10,37,13,13,0.0,M2019-10-16D,Race(2),,
7,0,0,0,0,0,0,0,0,0,0,0,0,0,0,0,0,15,15,0.0,M2019-10-16D,Race(2),,
7,0,0,0,0,0,0,0,0,0,0,0,0,0,0,0,0,15,15,0.0,M2019-10-16D,Race(2),,
8,0,0,0,0,0,0,8,8,0,0,0,0,0,0,8,8,41,41,0.0,M2019-10-16D,Race(2),,
8,0,0,0,0,0,0,8,8,0,0,0,0,0,0,8,8,41,41,0.0,M2019-10-16D,Race(2),,
9,2,0,0,2,0,0,4,4,0,1,5,6,2,1,9,12,8.5,8.5,0.0,M2019-10-16D,Race(2),,
9,2,0,0,2,0,0,4,4,0,1,5,6,2,1,9,12,8.5,8.5,0.0,M2019-10-16D,Race(2),,
10,3,0,8,11,0,8,2,10,0,0,3,3,3,8,13,24,17,17,0.0,M2019-10-16D,Race(2),,
10,3,0,8,11,0,8,2,10,0,0,3,3,3,8,13,24,17,17,0.0,M2019-10-16D,Race(2),,
11,0,0,0,0,0,0,0,0,0,0,0,0,0,0,0,0,81,81,0.0,M2019-10-16D,Race(2),,
11,0,0,0,0,0,0,0,0,0,0,0,0,0,0,0,0,81,81,0.0,M2019-10-16D,Race(2),,
12,3,16,7,26,0,10,9,19,2,3,9,14,5,29,25,59,5.5,5.5,0.0,M2019-10-16D,Race(2),,
12,3,16,7,26,0,10,9,19,2,3,9,14,5,29,25,59,5.5,5.5,0.0,M2019-10-16D,Race(2),,
1,0,0,0,0,0,2,0,2,1,1,1,3,1,3,1,5,21,21,0.0,M2019-10-16D,Race(3),,
1,0,0,0,0,0,2,0,2,1,1,1,3,1,3,1,5,21,21,0.0,M2019-10-16D,Race(3),,
2,0,5,3,8,0,0,0,0,1,0,0,1,1,5,3,9,21,21,2.0,M2019-10-16D,Race(3),,
2,0,5,3,8,0,0,0,0,1,0,0,1,1,5,3,9,21,21,0.0,M2019-10-16D,Race(3),,
3,0,2,2,4,3,2,0,5,2,2,1,5,5,6,3,14,9.5,9.5,0.0,M2019-10-16D,Race(3),,
3,0,2,2,4,3,2,0,5,2,2,1,5,5,6,3,14,9.5,9.5,3.0,M2019-10-16D,Race(3),,
4,2,5,3,10,7,5,4,16,8,5,2,15,17,15,9,41,8,8,0.0,M2019-10-16D,Race(3),,
4,2,5,3,10,7,5,4,16,8,5,2,15,17,15,9,41,8,8,0.0,M2019-10-16D,Race(3),,
5,0,0,0,0,0,8,1,9,0,1,1,2,0,9,2,11,41,41,0.0,M2019-10-16D,Race(3),,
5,0,0,0,0,0,8,1,9,0,1,1,2,0,9,2,11,41,41,0.0,M2019-10-16D,Race(3),,
6,17,5,4,26,2,6,3,11,6,8,1,15,25,19,8,52,5,5,1.0,M2019-10-16D,Race(3),,
6,17,5,4,26,2,6,3,11,6,8,1,15,25,19,8,52,5,5,4.0,M2019-10-16D,Race(3),,
7,0,0,0,0,0,0,0,0,0,0,0,0,0,0,0,0,41,41,0.0,M2019-10-16D,Race(3),,
7,0,0,0,0,0,0,0,0,0,0,0,0,0,0,0,0,41,41,0.0,M2019-10-16D,Race(3),,
8,0,0,0,0,0,0,8,8,1,0,1,2,1,0,9,10,26,26,0.0,M2019-10-16D,Race(3),,
8,0,0,0,0,0,0,8,8,1,0,1,2,1,0,9,10,26,26,0.0,M2019-10-16D,Race(3),,
9,0,3,0,3,0,0,0,0,0,0,1,1,0,3,1,4,21,21,0.0,M2019-10-16D,Race(3),,
9,0,3,0,3,0,0,0,0,0,0,1,1,0,3,1,4,21,21,0.0,M2019-10-16D,Race(3),,
10,7,5,6,18,7,2,7,16,4,3,10,17,18,10,23,51,5.5,5.5,0.0,M2019-10-16D,Race(3),,
10,7,5,6,18,7,2,7,16,4,3,10,17,18,10,23,51,5.5,5.5,0.0,M2019-10-16D,Race(3),,
11,0,2,0,2,8,0,1,9,1,0,1,2,9,2,2,13,13,13,0.0,M2019-10-16D,Race(3),,
11,0,2,0,2,8,0,1,9,1,0,1,2,9,2,2,13,13,13,0.0,M2019-10-16D,Race(3),,
12,4,3,12,19,3,5,6,14,2,5,7,14,9,13,25,47,2.8,2.8,0.0,M2019-10-16D,Race(3),,
12,4,3,12,19,3,5,6,14,2,5,7,14,9,13,25,47,2.8,2.8,0.0,M2019-10-16D,Race(3),,
1,0,0,0,0,8,0,0,8,0,0,0,0,8,0,0,8,34,34,0.0,M2019-10-16D,Race(4),,
1,0,0,0,0,8,0,0,8,0,0,0,0,8,0,0,8,34,34,0.0,M2019-10-16D,Race(4),,
2,8,9,8,25,14,2,4,20,15,5,4,24,37,16,16,69,4,4,0.0,M2019-10-16D,Race(4),,
2,8,9,8,25,14,2,4,20,15,5,4,24,37,16,16,69,4,4,0.0,M2019-10-16D,Race(4),,
3,10,12,2,24,2,7,3,12,2,9,3,14,14,28,8,50,4.8,4.8,1.0,M2019-10-16D,Race(4),,
3,10,12,2,24,2,7,3,12,2,9,3,14,14,28,8,50,4.8,4.8,0.0,M2019-10-16D,Race(4),,
4,3,2,7,12,2,10,6,18,0,5,12,17,5,17,25,47,4,4,0.0,M2019-10-16D,Race(4),,
4,3,2,7,12,2,10,6,18,0,5,12,17,5,17,25,47,4,4,2.0,M2019-10-16D,Race(4),,
5,4,0,8,12,4,3,9,16,8,4,3,15,16,7,20,43,7,7,3.0,M2019-10-16D,Race(4),,
5,4,0,8,12,4,3,9,16,8,4,3,15,16,7,20,43,7,7,0.0,M2019-10-16D,Race(4),,
6,2,5,2,9,0,0,0,0,0,1,0,1,2,6,2,10,19,19,0.0,M2019-10-16D,Race(4),,
6,2,5,2,9,0,0,0,0,0,1,0,1,2,6,2,10,19,19,0.0,M2019-10-16D,Race(4),,
7,0,0,0,0,0,0,0,0,0,0,0,0,0,0,0,0,81,81,0.0,M2019-10-16D,Race(4),,
7,0,0,0,0,0,0,0,0,0,0,0,0,0,0,0,0,81,81,0.0,M2019-10-16D,Race(4),,
8,0,0,0,0,0,0,0,0,0,0,0,0,0,0,0,0,11,11,0.0,M2019-10-16D,Race(4),,
8,0,0,0,0,0,0,0,0,0,0,0,0,0,0,0,0,11,11,0.0,M2019-10-16D,Race(4),,
9,0,0,0,0,0,0,8,8,0,0,0,0,0,0,8,8,17,17,0.0,M2019-10-16D,Race(4),,
9,0,0,0,0,0,0,8,8,0,0,0,0,0,0,8,8,17,17,0.0,M2019-10-16D,Race(4),,
10,3,2,3,8,0,8,0,8,0,1,3,4,3,11,6,20,8,8,0.0,M2019-10-16D,Race(4),,
10,3,2,3,8,0,8,0,8,0,1,3,4,3,11,6,20,8,8,0.0,M2019-10-16D,Race(4),,
11,0,0,0,0,0,0,0,0,1,1,1,3,1,1,1,3,17,17,0.0,M2019-10-16D,Race(4),,
11,0,0,0,0,0,0,0,0,1,1,1,3,1,1,1,3,17,17,0.0,M2019-10-16D,Race(4),,
1,0,0,0,0,0,0,0,0,0,0,0,0,0,0,0,0,51,51,0.0,M2019-10-16D,Race(5),,
1,0,0,0,0,0,0,0,0,0,0,0,0,0,0,0,0,51,51,0.0,M2019-10-16D,Race(5),,
2,12,8,2,22,7,6,5,18,11,3,5,19,30,17,12,59,3,3,0.0,M2019-10-16D,Race(5),,
2,12,8,2,22,7,6,5,18,11,3,5,19,30,17,12,59,3,3,0.0,M2019-10-16D,Race(5),,
3,0,2,2,4,0,0,8,8,0,1,0,1,0,3,10,13,16,16,0.0,M2019-10-16D,Race(5),,
3,0,2,2,4,0,0,8,8,0,1,0,1,0,3,10,13,16,16,0.0,M2019-10-16D,Race(5),,
4,5,9,12,26,8,12,2,22,5,14,3,22,18,35,17,70,2.4,2.4,3.0,M2019-10-16D,Race(5),,
4,5,9,12,26,8,12,2,22,5,14,3,22,18,35,17,70,2.4,2.4,1.0,M2019-10-16D,Race(5),,
5,0,0,0,0,0,0,0,0,0,0,0,0,0,0,0,0,15,15,2.0,M2019-10-16D,Race(5),,
5,0,0,0,0,0,0,0,0,0,0,0,0,0,0,0,0,15,15,0.0,M2019-10-16D,Race(5),,
6,0,0,0,0,0,0,0,0,0,0,0,0,0,0,0,0,41,41,0.0,M2019-10-16D,Race(5),,
6,0,0,0,0,0,0,0,0,0,0,0,0,0,0,0,0,41,41,0.0,M2019-10-16D,Race(5),,
7,0,0,0,0,0,0,0,0,0,0,1,1,0,0,1,1,34,34,0.0,M2019-10-16D,Race(5),,
7,0,0,0,0,0,0,0,0,0,0,1,1,0,0,1,1,34,34,0.0,M2019-10-16D,Race(5),,
8,0,0,0,0,0,0,0,0,0,0,1,1,0,0,1,1,34,34,0.0,M2019-10-16D,Race(5),,
8,0,0,0,0,0,0,0,0,0,0,1,1,0,0,1,1,34,34,0.0,M2019-10-16D,Race(5),,
9,6,0,10,16,3,8,6,17,4,2,5,11,13,10,21,44,12,12,0.0,M2019-10-16D,Race(5),,
9,6,0,10,16,3,8,6,17,4,2,5,11,13,10,21,44,12,12,0.0,M2019-10-16D,Race(5),,
10,0,0,0,0,0,0,0,0,0,0,1,1,0,0,1,1,101,101,0.0,M2019-10-16D,Race(5),,
10,0,0,0,0,0,0,0,0,0,0,1,1,0,0,1,1,101,101,0.0,M2019-10-16D,Race(5),,
11,2,8,0,10,8,2,7,17,2,4,6,12,12,14,13,39,13,13,0.0,M2019-10-16D,Race(5),,
11,2,8,0,10,8,2,7,17,2,4,6,12,12,14,13,39,13,13,0.0,M2019-10-16D,Race(5),,
12,2,3,4,9,4,2,2,8,3,2,4,9,9,7,10,26,8,8,0.0,M2019-10-16D,Race(5),,
12,2,3,4,9,4,2,2,8,3,2,4,9,9,7,10,26,8,8,0.0,M2019-10-16D,Race(5),,
1,15,4,4,23,13,4,3,20,12,3,5,20,40,11,12,63,3.6,3.6,0.0,M2019-10-16D,Race(6),,
1,15,4,4,23,13,4,3,20,12,3,5,20,40,11,12,63,3.6,3.6,0.0,M2019-10-16D,Race(6),,
2,5,10,6,21,3,9,5,17,2,8,4,14,10,27,15,52,5,5,1.0,M2019-10-16D,Race(6),,
2,5,10,6,21,3,9,5,17,2,8,4,14,10,27,15,52,5,5,0.0,M2019-10-16D,Race(6),,
3,0,0,0,0,1,0,0,1,1,0,1,2,2,0,1,3,21,21,0.0,M2019-10-16D,Race(6),,
3,0,0,0,0,1,0,0,1,1,0,1,2,2,0,1,3,21,21,0.0,M2019-10-16D,Race(6),,
4,0,5,4,9,0,1,2,3,7,0,2,9,7,6,8,21,11,11,0.0,M2019-10-16D,Race(6),,
4,0,5,4,9,0,1,2,3,7,0,2,9,7,6,8,21,11,11,0.0,M2019-10-16D,Race(6),,
5,0,0,0,0,0,0,8,8,0,0,0,0,0,0,8,8,31,31,3.0,M2019-10-16D,Race(6),,
5,0,0,0,0,0,0,8,8,0,0,0,0,0,0,8,8,31,31,0.0,M2019-10-16D,Race(6),,
6,0,0,0,0,0,0,0,0,0,1,0,1,0,1,0,1,51,51,0.0,M2019-10-16D,Race(6),,
6,0,0,0,0,0,0,0,0,0,1,0,1,0,1,0,1,51,51,2.0,M2019-10-16D,Race(6),,
7,2,6,5,13,8,0,1,9,0,1,2,3,10,7,8,25,11,11,0.0,M2019-10-16D,Race(6),,
7,2,6,5,13,8,0,1,9,0,1,2,3,10,7,8,25,11,11,0.0,M2019-10-16D,Race(6),,
8,0,0,3,3,0,0,1,1,0,0,0,0,0,0,4,4,26,26,0.0,M2019-10-16D,Race(6),,
8,0,0,3,3,0,0,1,1,0,0,0,0,0,0,4,4,26,26,0.0,M2019-10-16D,Race(6),,
9,2,3,8,13,3,7,5,15,1,7,4,12,6,17,17,40,4.6,4.5,0.0,M2019-10-16D,Race(6),,
9,2,3,8,13,3,7,5,15,1,7,4,12,6,17,17,40,4.6,4.5,0.0,M2019-10-16D,Race(6),,
10,0,0,0,0,0,8,1,9,1,1,3,5,1,9,4,14,7,7,0.0,M2019-10-16D,Race(6),,
10,0,0,0,0,0,8,1,9,1,1,3,5,1,9,4,14,7,7,0.0,M2019-10-16D,Race(6),,
11,4,0,0,4,2,1,4,7,2,3,4,9,8,4,8,20,15,15,0.0,M2019-10-16D,Race(6),,
11,4,0,0,4,2,1,4,7,2,3,4,9,8,4,8,20,15,15,0.0,M2019-10-16D,Race(6),,
12,2,2,0,4,0,0,0,0,0,2,1,3,2,4,1,7,21,21,0.0,M2019-10-16D,Race(6),,
12,2,2,0,4,0,0,0,0,0,2,1,3,2,4,1,7,21,21,0.0,M2019-10-16D,Race(6),,
1,0,0,0,0,0,0,0,0,0,0,0,0,0,0,0,0,4.4,4.4,2.0,M2019-10-16D,Race(7),,
1,0,0,0,0,0,0,0,0,0,0,0,0,0,0,0,0,4.4,4.4,0.0,M2019-10-16D,Race(7),,
2,15,3,8,26,18,3,2,23,20,4,1,25,53,10,11,74,3.4,3.4,0.0,M2019-10-16D,Race(7),,
2,15,3,8,26,18,3,2,23,20,4,1,25,53,10,11,74,3.4,3.4,0.0,M2019-10-16D,Race(7),,
3,0,0,3,3,0,1,0,1,0,0,0,0,0,1,3,4,21,21,0.0,M2019-10-16D,Race(7),,
3,0,0,3,3,0,1,0,1,0,0,0,0,0,1,3,4,21,21,0.0,M2019-10-16D,Race(7),,
4,0,0,2,2,0,1,2,3,0,1,4,5,0,2,8,10,4.2,4.2,0.0,M2019-10-16D,Race(7),,
4,0,0,2,2,0,1,2,3,0,1,4,5,0,2,8,10,4.2,4.2,3.0,M2019-10-16D,Race(7),,
5,0,0,0,0,0,0,0,0,0,1,0,1,0,1,0,1,101,101,0.0,M2019-10-16D,Race(7),,
5,0,0,0,0,0,0,0,0,0,1,0,1,0,1,0,1,101,101,0.0,M2019-10-16D,Race(7),,
6,0,0,0,0,0,0,0,0,0,0,0,0,0,0,0,0,101,101,0.0,M2019-10-16D,Race(7),,
6,0,0,0,0,0,0,0,0,0,0,0,0,0,0,0,0,101,101,1.0,M2019-10-16D,Race(7),,
7,0,0,0,0,0,0,0,0,0,0,0,0,0,0,0,0,26,26,0.0,M2019-10-16D,Race(7),,
7,0,0,0,0,0,0,0,0,0,0,0,0,0,0,0,0,26,26,0.0,M2019-10-16D,Race(7),,
8,3,5,10,18,2,8,4,14,4,4,4,12,9,17,18,44,5.5,5.5,0.0,M2019-10-16D,Race(7),,
8,3,5,10,18,2,8,4,14,4,4,4,12,9,17,18,44,5.5,5.5,0.0,M2019-10-16D,Race(7),,
9,0,2,0,2,0,0,0,0,0,0,0,0,0,2,0,2,34,34,0.0,M2019-10-16D,Race(7),,
9,0,2,0,2,0,0,0,0,0,0,0,0,0,2,0,2,34,34,0.0,M2019-10-16D,Race(7),,
10,0,0,0,0,0,8,0,8,0,3,1,4,0,11,1,12,34,34,0.0,M2019-10-16D,Race(7),,
10,0,0,0,0,0,8,0,8,0,3,1,4,0,11,1,12,34,34,0.0,M2019-10-16D,Race(7),,
11,0,0,0,0,0,0,8,8,0,0,0,0,0,0,8,8,71,67,0.0,M2019-10-16D,Race(7),,
11,0,0,0,0,0,0,8,8,0,0,0,0,0,0,8,8,71,67,0.0,M2019-10-16D,Race(7),,
12,5,7,5,17,2,7,7,16,0,9,8,17,7,23,20,50,6.5,6.5,0.0,M2019-10-16D,Race(7),,
12,5,7,5,17,2,7,7,16,0,9,8,17,7,23,20,50,6.5,6.5,0.0,M2019-10-16D,Race(7),,
1,8,2,0,10,8,2,6,16,4,3,3,10,20,7,9,36,5.5,5.5,0.0,M2019-10-16D,Race(8),,
1,8,2,0,10,8,2,6,16,4,3,3,10,20,7,9,36,5.5,5.5,0.0,M2019-10-16D,Race(8),,
2,0,0,7,7,1,4,0,5,1,3,0,4,2,7,7,16,14,14,0.0,M2019-10-16D,Race(8),,
2,0,0,7,7,1,4,0,5,1,3,0,4,2,7,7,16,14,14,3.0,M2019-10-16D,Race(8),,
3,0,0,2,2,0,0,0,0,0,1,0,1,0,1,2,3,19,19,0.0,M2019-10-16D,Race(8),,
3,0,0,2,2,0,0,0,0,0,1,0,1,0,1,2,3,19,19,0.0,M2019-10-16D,Race(8),,
4,0,0,0,0,0,0,0,0,1,0,0,1,1,0,0,1,31,31,1.0,M2019-10-16D,Race(8),,
4,0,0,0,0,0,0,0,0,1,0,0,1,1,0,0,1,31,31,0.0,M2019-10-16D,Race(8),,
5,0,0,0,0,1,0,0,1,0,3,0,3,1,3,0,4,81,81,2.0,M2019-10-16D,Race(8),,
5,0,0,0,0,1,0,0,1,0,3,0,3,1,3,0,4,81,81,0.0,M2019-10-16D,Race(8),,
6,2,6,3,11,5,5,4,14,2,1,5,8,9,12,12,33,9,9,0.0,M2019-10-16D,Race(8),,
6,2,6,3,11,5,5,4,14,2,1,5,8,9,12,12,33,9,9,0.0,M2019-10-16D,Race(8),,
7,15,5,7,27,12,5,4,21,15,2,6,23,42,12,17,71,2.4,2.4,0.0,M2019-10-16D,Race(8),,
7,15,5,7,27,12,5,4,21,15,2,6,23,42,12,17,71,2.4,2.4,0.0,M2019-10-16D,Race(8),,
8,0,0,3,3,1,1,3,5,1,4,2,7,2,5,8,15,13,13,0.0,M2019-10-16D,Race(8),,
8,0,0,3,3,1,1,3,5,1,4,2,7,2,5,8,15,13,13,0.0,M2019-10-16D,Race(8),,
9,0,9,3,12,1,5,3,9,1,8,3,12,2,22,9,33,10,10,0.0,M2019-10-16D,Race(8),,
9,0,9,3,12,1,5,3,9,1,8,3,12,2,22,9,33,10,10,0.0,M2019-10-16D,Race(8),,
10,5,8,3,16,0,8,10,18,1,1,6,8,6,17,19,42,8,8,0.0,M2019-10-16D,Race(8),,
10,5,8,3,16,0,8,10,18,1,1,6,8,6,17,19,42,8,8,0.0,M2019-10-16D,Race(8),,
11,0,0,0,0,0,0,0,0,0,0,0,0,0,0,0,0,41,41,0.0,M2019-10-16D,Race(8),,
11,0,0,0,0,0,0,0,0,0,0,0,0,0,0,0,0,41,41,0.0,M2019-10-16D,Race(8),,
12,0,0,2,2,1,0,0,1,0,0,1,1,1,0,3,4,14,14,0.0,M2019-10-16D,Race(8),,
12,0,0,2,2,1,0,0,1,0,0,1,1,1,0,3,4,14,14,0.0,M2019-10-16D,Race(8),,
1,11,3,5,19,2,1,3,6,1,2,3,6,14,6,11,31,4.4,4.4,0.0,M2019-10-20D,Race(1),,
1,11,3,5,19,2,1,3,6,1,2,3,6,14,6,11,31,4.4,4.4,0.0,M2019-10-20D,Race(1),,
2,0,0,0,0,0,0,0,0,0,0,0,0,0,0,0,0,34,34,0.0,M2019-10-20D,Race(1),,
2,0,0,0,0,0,0,0,0,0,0,0,0,0,0,0,0,34,34,0.0,M2019-10-20D,Race(1),,
3,7,5,0,12,5,6,3,14,5,3,6,14,17,14,9,40,15,15,3.0,M2019-10-20D,Race(1),,
3,7,5,0,12,5,6,3,14,5,3,6,14,17,14,9,40,15,15,0.0,M2019-10-20D,Race(1),,
4,3,2,7,12,1,8,3,12,1,2,2,5,5,12,12,29,12,12,0.0,M2019-10-20D,Race(1),,
4,3,2,7,12,1,8,3,12,1,2,2,5,5,12,12,29,12,12,0.0,M2019-10-20D,Race(1),,
5,0,0,2,2,0,0,1,1,1,0,0,1,1,0,3,4,26,26,1.0,M2019-10-20D,Race(1),,
5,0,0,2,2,0,0,1,1,1,0,0,1,1,0,3,4,26,26,0.0,M2019-10-20D,Race(1),,
6,0,0,5,5,8,4,1,13,0,6,1,7,8,10,7,25,12,12,0.0,M2019-10-20D,Race(1),,
6,0,0,5,5,8,4,1,13,0,6,1,7,8,10,7,25,12,12,0.0,M2019-10-20D,Race(1),,
7,0,0,0,0,0,0,0,0,0,0,1,1,0,0,1,1,81,81,0.0,M2019-10-20D,Race(1),,
7,0,0,0,0,0,0,0,0,0,0,1,1,0,0,1,1,81,81,2.0,M2019-10-20D,Race(1),,
8,2,0,0,2,2,4,3,9,3,4,1,8,7,8,4,19,19,19,0.0,M2019-10-20D,Race(1),,
8,2,0,0,2,2,4,3,9,3,4,1,8,7,8,4,19,19,19,0.0,M2019-10-20D,Race(1),,
9,3,2,5,10,0,0,2,2,0,1,2,3,3,3,9,15,7,7,0.0,M2019-10-20D,Race(1),,
9,3,2,5,10,0,0,2,2,0,1,2,3,3,3,9,15,7,7,0.0,M2019-10-20D,Race(1),,
10,0,0,0,0,2,0,0,2,2,0,0,2,4,0,0,4,14,14,0.0,M2019-10-20D,Race(1),,
10,0,0,0,0,2,0,0,2,2,0,0,2,4,0,0,4,14,14,0.0,M2019-10-20D,Race(1),,
11,4,10,3,17,9,5,5,19,10,6,5,21,23,21,13,57,5,5,0.0,M2019-10-20D,Race(1),,
11,4,10,3,17,9,5,5,19,10,6,5,21,23,21,13,57,5,5,0.0,M2019-10-20D,Race(1),,
12,0,2,0,2,1,2,1,4,1,1,2,4,2,5,3,10,21,21,0.0,M2019-10-20D,Race(1),,
12,0,2,0,2,1,2,1,4,1,1,2,4,2,5,3,10,21,21,0.0,M2019-10-20D,Race(1),,
13,0,0,0,0,0,0,0,0,0,0,0,0,0,0,0,0,61,61,0.0,M2019-10-20D,Race(1),,
13,0,0,0,0,0,0,0,0,0,0,0,0,0,0,0,0,61,61,0.0,M2019-10-20D,Race(1),,
14,0,6,3,9,0,0,8,8,0,1,3,4,0,7,14,21,4.8,4.8,0.0,M2019-10-20D,Race(1),,
14,0,6,3,9,0,0,8,8,0,1,3,4,0,7,14,21,4.8,4.8,0.0,M2019-10-20D,Race(1),,
1,8,10,0,18,8,6,5,19,9,6,4,19,25,22,9,56,7.5,7.5,2.0,M2019-10-20D,Race(10),,
1,8,10,0,18,8,6,5,19,9,6,4,19,25,22,9,56,7.5,7.5,0.0,M2019-10-20D,Race(10),,
2,0,0,0,0,0,0,0,0,0,0,0,0,0,0,0,0,81,81,0.0,M2019-10-20D,Race(10),,
2,0,0,0,0,0,0,0,0,0,0,0,0,0,0,0,0,81,81,0.0,M2019-10-20D,Race(10),,
3,0,0,2,2,2,1,2,5,1,1,4,6,3,2,8,13,21,21,0.0,M2019-10-20D,Race(10),,
3,0,0,2,2,2,1,2,5,1,1,4,6,3,2,8,13,21,21,1.0,M2019-10-20D,Race(10),,
4,5,2,3,10,3,3,2,8,4,3,3,10,12,8,8,28,6.5,6.5,0.0,M2019-10-20D,Race(10),,
4,5,2,3,10,3,3,2,8,4,3,3,10,12,8,8,28,6.5,6.5,3.0,M2019-10-20D,Race(10),,
5,4,0,8,12,5,3,4,12,6,4,5,15,15,7,17,39,7,7,0.0,M2019-10-20D,Race(10),,
5,4,0,8,12,5,3,4,12,6,4,5,15,15,7,17,39,7,7,0.0,M2019-10-20D,Race(10),,
6,0,3,0,3,8,1,0,9,1,0,0,1,9,4,0,13,21,21,0.0,M2019-10-20D,Race(10),,
6,0,3,0,3,8,1,0,9,1,0,0,1,9,4,0,13,21,21,0.0,M2019-10-20D,Race(10),,
7,0,4,6,10,1,1,8,10,0,2,2,4,1,7,16,24,7,7,0.0,M2019-10-20D,Race(10),,
7,0,4,6,10,1,1,8,10,0,2,2,4,1,7,16,24,7,7,0.0,M2019-10-20D,Race(10),,
8,8,0,5,13,0,0,2,2,1,1,2,4,9,1,9,19,6,6,0.0,M2019-10-20D,Race(10),,
8,8,0,5,13,0,0,2,2,1,1,2,4,9,1,9,19,6,6,0.0,M2019-10-20D,Race(10),,
9,2,0,2,4,0,1,2,3,0,1,3,4,2,2,7,11,12,12,0.0,M2019-10-20D,Race(10),,
9,2,0,2,4,0,1,2,3,0,1,3,4,2,2,7,11,12,12,0.0,M2019-10-20D,Race(10),,
10,0,0,0,0,0,0,0,0,0,0,0,0,0,0,0,0,61,61,0.0,M2019-10-20D,Race(10),,
10,0,0,0,0,0,0,0,0,0,0,0,0,0,0,0,0,61,61,0.0,M2019-10-20D,Race(10),,
11,0,0,0,0,0,0,0,0,0,0,0,0,0,0,0,0,41,41,0.0,M2019-10-20D,Race(10),,
11,0,0,0,0,0,0,0,0,0,0,0,0,0,0,0,0,41,41,0.0,M2019-10-20D,Race(10),,
12,0,2,2,4,0,8,2,10,0,1,1,2,0,11,5,16,14,14,0.0,M2019-10-20D,Race(10),,
12,0,2,2,4,0,8,2,10,0,1,1,2,0,11,5,16,14,14,0.0,M2019-10-20D,Race(10),,
13,3,9,2,14,3,6,3,12,4,7,2,13,10,22,7,39,4.6,4.6,0.0,M2019-10-20D,Race(10),,
13,3,9,2,14,3,6,3,12,4,7,2,13,10,22,7,39,4.6,4.6,0.0,M2019-10-20D,Race(10),,
14,0,0,0,0,0,0,0,0,0,0,0,0,0,0,0,0,71,67,0.0,M2019-10-20D,Race(10),,
14,0,0,0,0,0,0,0,0,0,0,0,0,0,0,0,0,71,67,0.0,M2019-10-20D,Race(10),,
1,14,5,7,26,13,8,1,22,8,15,3,26,35,28,11,74,3.7,3.7,1.0,M2019-10-20D,Race(2),,
1,14,5,7,26,13,8,1,22,8,15,3,26,35,28,11,74,3.7,3.7,0.0,M2019-10-20D,Race(2),,
2,4,5,5,14,0,3,3,6,2,1,2,5,6,9,10,25,6,6,2.0,M2019-10-20D,Race(2),,
2,4,5,5,14,0,3,3,6,2,1,2,5,6,9,10,25,6,6,0.0,M2019-10-20D,Race(2),,
3,5,3,11,19,5,7,4,16,11,6,4,21,21,16,19,56,5,5,0.0,M2019-10-20D,Race(2),,
3,5,3,11,19,5,7,4,16,11,6,4,21,21,16,19,56,5,5,0.0,M2019-10-20D,Race(2),,
4,0,0,0,0,0,0,0,0,0,0,1,1,0,0,1,1,101,101,0.0,M2019-10-20D,Race(2),,
4,0,0,0,0,0,0,0,0,0,0,1,1,0,0,1,1,101,101,0.0,M2019-10-20D,Race(2),,
5,2,3,5,10,0,8,5,13,0,0,4,4,2,11,14,27,5,5,3.0,M2019-10-20D,Race(2),,
5,2,3,5,10,0,8,5,13,0,0,4,4,2,11,14,27,5,5,0.0,M2019-10-20D,Race(2),,
6,5,7,0,12,12,4,8,24,5,3,12,20,22,14,20,56,4.6,4.6,0.0,M2019-10-20D,Race(2),,
6,5,7,0,12,12,4,8,24,5,3,12,20,22,14,20,56,4.6,4.6,0.0,M2019-10-20D,Race(2),,
7,0,0,0,0,0,0,0,0,0,0,0,0,0,0,0,0,81,81,0.0,M2019-10-20D,Race(2),,
7,0,0,0,0,0,0,0,0,0,0,0,0,0,0,0,0,81,81,0.0,M2019-10-20D,Race(2),,
8,0,0,0,0,0,0,0,0,0,0,0,0,0,0,0,0,81,81,0.0,M2019-10-20D,Race(2),,
8,0,0,0,0,0,0,0,0,0,0,0,0,0,0,0,0,81,81,0.0,M2019-10-20D,Race(2),,
9,0,0,0,0,0,0,1,1,0,0,0,0,0,0,1,1,16,16,0.0,M2019-10-20D,Race(2),,
9,0,0,0,0,0,0,1,1,0,0,0,0,0,0,1,1,16,16,0.0,M2019-10-20D,Race(2),,
10,0,0,0,0,0,0,0,0,0,0,0,0,0,0,0,0,151,151,0.0,M2019-10-20D,Race(2),,
10,0,0,0,0,0,0,0,0,0,0,0,0,0,0,0,0,151,151,0.0,M2019-10-20D,Race(2),,
11,0,0,0,0,0,0,0,0,0,0,0,0,0,0,0,0,34,34,0.0,M2019-10-20D,Race(2),,
11,0,0,0,0,0,0,0,0,0,0,0,0,0,0,0,0,34,34,0.0,M2019-10-20D,Race(2),,
12,0,0,0,0,0,0,0,0,0,0,0,0,0,0,0,0,151,151,0.0,M2019-10-20D,Race(2),,
12,0,0,0,0,0,0,0,0,0,0,0,0,0,0,0,0,151,151,0.0,M2019-10-20D,Race(2),,
13,0,7,2,9,0,0,8,8,0,1,0,1,0,8,10,18,15,15,0.0,M2019-10-20D,Race(2),,
13,0,7,2,9,0,0,8,8,0,1,0,1,0,8,10,18,15,15,0.0,M2019-10-20D,Race(2),,
14,0,0,0,0,0,0,0,0,0,0,0,0,0,0,0,0,51,51,0.0,M2019-10-20D,Race(2),,
14,0,0,0,0,0,0,0,0,0,0,0,0,0,0,0,0,51,51,0.0,M2019-10-20D,Race(2),,
1,0,0,4,4,8,2,1,11,2,1,5,8,10,3,10,23,14,14,0.0,M2019-10-20D,Race(3),,
1,0,0,4,4,8,2,1,11,2,1,5,8,10,3,10,23,14,14,0.0,M2019-10-20D,Race(3),,
2,0,4,6,10,2,8,5,15,1,5,5,11,3,17,16,36,7.5,7.5,0.0,M2019-10-20D,Race(3),,
2,0,4,6,10,2,8,5,15,1,5,5,11,3,17,16,36,7.5,7.5,3.0,M2019-10-20D,Race(3),,
3,11,8,0,19,4,6,5,15,7,3,3,13,22,17,8,47,3.6,3.6,1.0,M2019-10-20D,Race(3),,
3,11,8,0,19,4,6,5,15,7,3,3,13,22,17,8,47,3.6,3.6,2.0,M2019-10-20D,Race(3),,
4,0,6,6,12,0,8,6,14,0,4,5,9,0,18,17,35,7.5,7.5,0.0,M2019-10-20D,Race(3),,
4,0,6,6,12,0,8,6,14,0,4,5,9,0,18,17,35,7.5,7.5,0.0,M2019-10-20D,Race(3),,
5,3,5,7,15,0,2,5,7,0,5,6,11,3,12,18,33,11,11,0.0,M2019-10-20D,Race(3),,
5,3,5,7,15,0,2,5,7,0,5,6,11,3,12,18,33,11,11,0.0,M2019-10-20D,Race(3),,
6,16,7,7,30,16,4,8,28,16,6,1,23,48,17,16,81,2.1,2.1,0.0,M2019-10-20D,Race(3),,
6,16,7,7,30,16,4,8,28,16,6,1,23,48,17,16,81,2.1,2.1,0.0,M2019-10-20D,Race(3),,
7,0,0,0,0,0,0,0,0,0,1,1,2,0,1,1,2,18,18,0.0,M2019-10-20D,Race(3),,
7,0,0,0,0,0,0,0,0,0,1,1,2,0,1,1,2,18,18,0.0,M2019-10-20D,Race(3),,
8,0,0,0,0,0,0,0,0,0,1,0,1,0,1,0,1,20,20,0.0,M2019-10-20D,Race(3),,
8,0,0,0,0,0,0,0,0,0,1,0,1,0,1,0,1,20,20,0.0,M2019-10-20D,Race(3),,
1,0,0,0,0,8,2,0,10,0,1,0,1,8,3,0,11,41,41,0.0,M2019-10-20D,Race(4),,
1,0,0,0,0,8,2,0,10,0,1,0,1,8,3,0,11,41,41,0.0,M2019-10-20D,Race(4),,
2,2,0,0,2,0,8,0,8,1,2,0,3,3,10,0,13,26,26,0.0,M2019-10-20D,Race(4),,
2,2,0,0,2,0,8,0,8,1,2,0,3,3,10,0,13,26,26,1.0,M2019-10-20D,Race(4),,
3,0,0,0,0,0,0,0,0,0,1,0,1,0,1,0,1,41,41,0.0,M2019-10-20D,Race(4),,
3,0,0,0,0,0,0,0,0,0,1,0,1,0,1,0,1,41,41,3.0,M2019-10-20D,Race(4),,
4,0,0,0,0,1,1,0,2,0,0,0,0,1,1,0,2,26,26,0.0,M2019-10-20D,Race(4),,
4,0,0,0,0,1,1,0,2,0,0,0,0,1,1,0,2,26,26,0.0,M2019-10-20D,Race(4),,
5,24,6,0,30,20,1,1,22,17,2,1,20,61,9,2,72,1.85,1.85,0.0,M2019-10-20D,Race(4),,
5,24,6,0,30,20,1,1,22,17,2,1,20,61,9,2,72,1.85,1.85,2.0,M2019-10-20D,Race(4),,
6,4,5,3,12,0,5,4,9,1,4,8,13,5,14,15,34,4.2,4.2,0.0,M2019-10-20D,Race(4),,
6,4,5,3,12,0,5,4,9,1,4,8,13,5,14,15,34,4.2,4.2,0.0,M2019-10-20D,Race(4),,
7,0,10,10,20,1,8,8,17,0,8,9,17,1,26,27,54,12,12,0.0,M2019-10-20D,Race(4),,
7,0,10,10,20,1,8,8,17,0,8,9,17,1,26,27,54,12,12,0.0,M2019-10-20D,Race(4),,
8,0,0,0,0,0,0,0,0,1,0,0,1,1,0,0,1,71,71,0.0,M2019-10-20D,Race(4),,
8,0,0,0,0,0,0,0,0,1,0,0,1,1,0,0,1,71,71,0.0,M2019-10-20D,Race(4),,
9,0,0,0,0,0,0,0,0,0,0,0,0,0,0,0,0,81,81,0.0,M2019-10-20D,Race(4),,
9,0,0,0,0,0,0,0,0,0,0,0,0,0,0,0,0,81,81,0.0,M2019-10-20D,Race(4),,
10,0,9,14,23,0,5,7,12,0,7,5,12,0,21,26,47,5.5,5.5,0.0,M2019-10-20D,Race(4),,
10,0,9,14,23,0,5,7,12,0,7,5,12,0,21,26,47,5.5,5.5,0.0,M2019-10-20D,Race(4),,
11,0,0,0,0,0,0,8,8,0,1,1,2,0,1,9,10,21,21,0.0,M2019-10-20D,Race(4),,
11,0,0,0,0,0,0,8,8,0,1,1,2,0,1,9,10,21,21,0.0,M2019-10-20D,Race(4),,
12,0,0,3,3,0,0,2,2,0,0,2,2,0,0,7,7,34,34,0.0,M2019-10-20D,Race(4),,
12,0,0,3,3,0,0,2,2,0,0,2,2,0,0,7,7,34,34,0.0,M2019-10-20D,Race(4),,
13,0,0,0,0,0,0,0,0,0,0,0,0,0,0,0,0,151,151,0.0,M2019-10-20D,Race(4),,
13,0,0,0,0,0,0,0,0,0,0,0,0,0,0,0,0,151,151,0.0,M2019-10-20D,Race(4),,
1,0,0,0,0,0,0,0,0,1,0,0,1,1,0,0,1,51,51,0.0,M2019-10-20D,Race(5),,
1,0,0,0,0,0,0,0,0,1,0,0,1,1,0,0,1,51,51,0.0,M2019-10-20D,Race(5),,
2,6,5,6,17,8,2,2,12,1,2,2,5,15,9,10,34,11,11,1.0,M2019-10-20D,Race(5),,
2,6,5,6,17,8,2,2,12,1,2,2,5,15,9,10,34,11,11,0.0,M2019-10-20D,Race(5),,
3,5,5,4,14,9,5,3,17,5,7,5,17,19,17,12,48,6,6,0.0,M2019-10-20D,Race(5),,
3,5,5,4,14,9,5,3,17,5,7,5,17,19,17,12,48,6,6,2.0,M2019-10-20D,Race(5),,
4,0,0,0,0,0,0,8,8,0,0,1,1,0,0,9,9,21,21,0.0,M2019-10-20D,Race(5),,
4,0,0,0,0,0,0,8,8,0,0,1,1,0,0,9,9,21,21,0.0,M2019-10-20D,Race(5),,
5,0,0,0,0,0,0,0,0,0,0,0,0,0,0,0,0,34,34,0.0,M2019-10-20D,Race(5),,
5,0,0,0,0,0,0,0,0,0,0,0,0,0,0,0,0,34,34,3.0,M2019-10-20D,Race(5),,
6,4,5,5,14,7,6,8,21,7,5,9,21,18,16,22,56,5.5,5.5,0.0,M2019-10-20D,Race(5),,
6,4,5,5,14,7,6,8,21,7,5,9,21,18,16,22,56,5.5,5.5,0.0,M2019-10-20D,Race(5),,
7,9,2,6,17,7,5,4,16,11,7,2,20,27,14,12,53,6.5,6.5,0.0,M2019-10-20D,Race(5),,
7,9,2,6,17,7,5,4,16,11,7,2,20,27,14,12,53,6.5,6.5,0.0,M2019-10-20D,Race(5),,
8,0,0,0,0,0,0,0,0,0,1,0,1,0,1,0,1,41,41,0.0,M2019-10-20D,Race(5),,
8,0,0,0,0,0,0,0,0,0,1,0,1,0,1,0,1,41,41,0.0,M2019-10-20D,Race(5),,
9,0,0,0,0,0,0,0,0,0,0,0,0,0,0,0,0,81,81,0.0,M2019-10-20D,Race(5),,
9,0,0,0,0,0,0,0,0,0,0,0,0,0,0,0,0,81,81,0.0,M2019-10-20D,Race(5),,
10,2,2,0,4,0,2,3,5,0,2,2,4,2,6,5,13,5.5,5.5,0.0,M2019-10-20D,Race(5),,
10,2,2,0,4,0,2,3,5,0,2,2,4,2,6,5,13,5.5,5.5,0.0,M2019-10-20D,Race(5),,
11,0,0,0,0,0,0,0,0,0,0,0,0,0,0,0,0,31,31,0.0,M2019-10-20D,Race(5),,
11,0,0,0,0,0,0,0,0,0,0,0,0,0,0,0,0,31,31,0.0,M2019-10-20D,Race(5),,
12,2,8,0,10,1,8,0,9,1,0,0,1,4,16,0,20,10,10,0.0,M2019-10-20D,Race(5),,
12,2,8,0,10,1,8,0,9,1,0,0,1,4,16,0,20,10,10,0.0,M2019-10-20D,Race(5),,
13,0,0,0,0,0,0,0,0,0,0,2,2,0,0,2,2,34,34,0.0,M2019-10-20D,Race(5),,
13,0,0,0,0,0,0,0,0,0,0,2,2,0,0,2,2,34,34,0.0,M2019-10-20D,Race(5),,
14,2,3,9,14,0,0,2,2,0,2,3,5,2,5,14,21,8.5,8.5,0.0,M2019-10-20D,Race(5),,
14,2,3,9,14,0,0,2,2,0,2,3,5,2,5,14,21,8.5,8.5,0.0,M2019-10-20D,Race(5),,
1,16,2,3,21,13,6,0,19,8,10,2,20,37,18,5,60,3.2,3.2,0.0,M2019-10-20D,Race(6),,
1,16,2,3,21,13,6,0,19,8,10,2,20,37,18,5,60,3.2,3.2,0.0,M2019-10-20D,Race(6),,
2,0,0,0,0,0,0,0,0,0,0,0,0,0,0,0,0,41,41,2.0,M2019-10-20D,Race(6),,
2,0,0,0,0,0,0,0,0,0,0,0,0,0,0,0,0,41,41,0.0,M2019-10-20D,Race(6),,
3,4,10,2,16,3,2,5,10,3,3,3,9,10,15,10,35,10,10,0.0,M2019-10-20D,Race(6),,
3,4,10,2,16,3,2,5,10,3,3,3,9,10,15,10,35,10,10,0.0,M2019-10-20D,Race(6),,
4,0,0,6,6,0,0,0,0,3,0,2,5,3,0,8,11,10,10,1.0,M2019-10-20D,Race(6),,
4,0,0,6,6,0,0,0,0,3,0,2,5,3,0,8,11,10,10,0.0,M2019-10-20D,Race(6),,
5,2,3,2,7,8,0,1,9,0,0,3,3,10,3,6,19,15,15,0.0,M2019-10-20D,Race(6),,
5,2,3,2,7,8,0,1,9,0,0,3,3,10,3,6,19,15,15,0.0,M2019-10-20D,Race(6),,
6,0,0,0,0,0,0,0,0,0,0,1,1,0,0,1,1,18,18,0.0,M2019-10-20D,Race(6),,
6,0,0,0,0,0,0,0,0,0,0,1,1,0,0,1,1,18,18,3.0,M2019-10-20D,Race(6),,
7,0,5,7,12,3,7,5,15,4,4,4,12,7,16,16,39,14,14,0.0,M2019-10-20D,Race(6),,
7,0,5,7,12,3,7,5,15,4,4,4,12,7,16,16,39,14,14,0.0,M2019-10-20D,Race(6),,
8,0,7,7,14,2,5,10,17,6,5,6,17,8,17,23,48,7,7,0.0,M2019-10-20D,Race(6),,
8,0,7,7,14,2,5,10,17,6,5,6,17,8,17,23,48,7,7,0.0,M2019-10-20D,Race(6),,
9,0,0,0,0,0,0,0,0,0,2,0,2,0,2,0,2,21,21,0.0,M2019-10-20D,Race(6),,
9,0,0,0,0,0,0,0,0,0,2,0,2,0,2,0,2,21,21,0.0,M2019-10-20D,Race(6),,
10,3,3,3,9,1,8,1,10,1,0,3,4,5,11,7,23,8,8,0.0,M2019-10-20D,Race(6),,
10,3,3,3,9,1,8,1,10,1,0,3,4,5,11,7,23,8,8,0.0,M2019-10-20D,Race(6),,
11,0,0,0,0,0,0,0,0,0,0,0,0,0,0,0,0,71,67,0.0,M2019-10-20D,Race(6),,
11,0,0,0,0,0,0,0,0,0,0,0,0,0,0,0,0,71,67,0.0,M2019-10-20D,Race(6),,
12,3,0,0,3,0,0,0,0,1,1,1,3,4,1,1,6,5.5,6,0.0,M2019-10-20D,Race(6),,
12,3,0,0,3,0,0,0,0,1,1,1,3,4,1,1,6,5.5,6,0.0,M2019-10-20D,Race(6),,
13,0,0,0,0,0,0,0,0,0,0,0,0,0,0,0,0,41,41,0.0,M2019-10-20D,Race(6),,
13,0,0,0,0,0,0,0,0,0,0,0,0,0,0,0,0,41,41,0.0,M2019-10-20D,Race(6),,
14,2,0,0,2,0,0,0,0,0,0,0,0,2,0,0,2,41,41,0.0,M2019-10-20D,Race(6),,
14,2,0,0,2,0,0,0,0,0,0,0,0,2,0,0,2,41,41,0.0,M2019-10-20D,Race(6),,
1,2,16,3,21,9,6,2,17,9,3,3,15,20,25,8,53,4,4,1.0,M2019-10-20D,Race(7),,
1,2,16,3,21,9,6,2,17,9,3,3,15,20,25,8,53,4,4,2.0,M2019-10-20D,Race(7),,
2,18,6,6,30,10,9,2,21,11,10,1,22,39,25,9,73,3.4,3.4,3.0,M2019-10-20D,Race(7),,
2,18,6,6,30,10,9,2,21,11,10,1,22,39,25,9,73,3.4,3.4,0.0,M2019-10-20D,Race(7),,
3,0,2,6,8,8,2,7,17,5,3,9,17,13,7,22,42,10,10,0.0,M2019-10-20D,Race(7),,
3,0,2,6,8,8,2,7,17,5,3,9,17,13,7,22,42,10,10,0.0,M2019-10-20D,Race(7),,
4,0,0,0,0,0,0,0,0,0,0,0,0,0,0,0,0,126,126,0.0,M2019-10-20D,Race(7),,
4,0,0,0,0,0,0,0,0,0,0,0,0,0,0,0,0,126,126,0.0,M2019-10-20D,Race(7),,
5,2,0,0,2,0,1,1,2,0,1,1,2,2,2,2,6,16,16,0.0,M2019-10-20D,Race(7),,
5,2,0,0,2,0,1,1,2,0,1,1,2,2,2,2,6,16,16,0.0,M2019-10-20D,Race(7),,
6,0,2,0,2,0,0,1,1,0,1,1,2,0,3,2,5,18,18,0.0,M2019-10-20D,Race(7),,
6,0,2,0,2,0,0,1,1,0,1,1,2,0,3,2,5,18,18,0.0,M2019-10-20D,Race(7),,
7,0,0,0,0,0,0,0,0,0,0,0,0,0,0,0,0,81,81,0.0,M2019-10-20D,Race(7),,
7,0,0,0,0,0,0,0,0,0,0,0,0,0,0,0,0,81,81,0.0,M2019-10-20D,Race(7),,
8,0,0,0,0,0,0,2,2,0,0,2,2,0,0,4,4,21,21,0.0,M2019-10-20D,Race(7),,
8,0,0,0,0,0,0,2,2,0,0,2,2,0,0,4,4,21,21,0.0,M2019-10-20D,Race(7),,
9,0,0,3,3,0,8,1,9,0,3,1,4,0,11,5,16,12,12,0.0,M2019-10-20D,Race(7),,
9,0,0,3,3,0,8,1,9,0,3,1,4,0,11,5,16,12,12,0.0,M2019-10-20D,Race(7),,
10,0,0,0,0,0,0,0,0,0,0,1,1,0,0,1,1,31,31,0.0,M2019-10-20D,Race(7),,
10,0,0,0,0,0,0,0,0,0,0,1,1,0,0,1,1,31,31,0.0,M2019-10-20D,Race(7),,
11,5,2,7,14,3,4,6,13,1,5,7,13,9,11,20,40,6,6,0.0,M2019-10-20D,Race(7),,
11,5,2,7,14,3,4,6,13,1,5,7,13,9,11,20,40,6,6,0.0,M2019-10-20D,Race(7),,
12,3,0,0,3,0,0,0,0,0,0,0,0,3,0,0,3,13,13,0.0,M2019-10-20D,Race(7),,
12,3,0,0,3,0,0,0,0,0,0,0,0,3,0,0,3,13,13,0.0,M2019-10-20D,Race(7),,
13,0,2,3,5,0,0,8,8,0,0,0,0,0,2,11,13,19,19,0.0,M2019-10-20D,Race(7),,
13,0,2,3,5,0,0,8,8,0,0,0,0,0,2,11,13,19,19,0.0,M2019-10-20D,Race(7),,
14,0,0,2,2,0,0,0,0,0,0,0,0,0,0,2,2,26,26,0.0,M2019-10-20D,Race(7),,
14,0,0,2,2,0,0,0,0,0,0,0,0,0,0,2,2,26,26,0.0,M2019-10-20D,Race(7),,
1,30,0,0,30,22,1,0,23,25,0,1,26,77,1,1,79,1.2,1.2,3.0,M2019-10-20D,Race(8),,
1,30,0,0,30,22,1,0,23,25,0,1,26,77,1,1,79,1.2,1.2,1.0,M2019-10-20D,Race(8),,
2,0,8,11,19,0,6,5,11,0,11,2,13,0,25,18,43,13,13,0.0,M2019-10-20D,Race(8),,
2,0,8,11,19,0,6,5,11,0,11,2,13,0,25,18,43,13,13,0.0,M2019-10-20D,Race(8),,
3,0,5,5,10,0,8,2,10,1,0,2,3,1,13,9,23,26,26,0.0,M2019-10-20D,Race(8),,
3,0,5,5,10,0,8,2,10,1,0,2,3,1,13,9,23,26,26,0.0,M2019-10-20D,Race(8),,
4,0,0,3,3,0,0,0,0,0,0,0,0,0,0,3,3,51,51,0.0,M2019-10-20D,Race(8),,
4,0,0,3,3,0,0,0,0,0,0,0,0,0,0,3,3,51,51,2.0,M2019-10-20D,Race(8),,
5,0,0,4,4,0,0,2,2,0,0,2,2,0,0,8,8,26,26,0.0,M2019-10-20D,Race(8),,
5,0,0,4,4,0,0,2,2,0,0,2,2,0,0,8,8,26,26,0.0,M2019-10-20D,Race(8),,
6,0,0,3,3,0,0,8,8,0,1,5,6,0,1,16,17,26,26,0.0,M2019-10-20D,Race(8),,
6,0,0,3,3,0,0,8,8,0,1,5,6,0,1,16,17,26,26,0.0,M2019-10-20D,Race(8),,
7,0,0,0,0,0,0,0,0,0,0,0,0,0,0,0,0,81,81,0.0,M2019-10-20D,Race(8),,
7,0,0,0,0,0,0,0,0,0,0,0,0,0,0,0,0,81,81,0.0,M2019-10-20D,Race(8),,
8,0,7,0,7,8,4,6,18,0,5,8,13,8,16,14,38,8,8,0.0,M2019-10-20D,Race(8),,
8,0,7,0,7,8,4,6,18,0,5,8,13,8,16,14,38,8,8,0.0,M2019-10-20D,Race(8),,
9,0,10,4,14,0,11,7,18,0,9,6,15,0,30,17,47,15,15,0.0,M2019-10-20D,Race(8),,
9,0,10,4,14,0,11,7,18,0,9,6,15,0,30,17,47,15,15,0.0,M2019-10-20D,Race(8),,
10,0,0,0,0,0,0,0,0,0,0,0,0,0,0,0,0,81,81,0.0,M2019-10-20D,Race(8),,
10,0,0,0,0,0,0,0,0,0,0,0,0,0,0,0,0,81,81,0.0,M2019-10-20D,Race(8),,
11,0,0,0,0,0,0,0,0,0,0,0,0,0,0,0,0,71,67,0.0,M2019-10-20D,Race(8),,
11,0,0,0,0,0,0,0,0,0,0,0,0,0,0,0,0,71,67,0.0,M2019-10-20D,Race(8),,
1,0,0,0,0,8,0,0,8,2,0,0,2,10,0,0,10,26,26,0.0,M2019-10-20D,Race(9),,
1,0,0,0,0,8,0,0,8,2,0,0,2,10,0,0,10,26,26,0.0,M2019-10-20D,Race(9),,
2,3,7,5,15,6,6,7,19,6,7,5,18,15,20,17,52,4.6,4.5,2.0,M2019-10-20D,Race(9),,
2,3,7,5,15,6,6,7,19,6,7,5,18,15,20,17,52,4.6,4.5,0.0,M2019-10-20D,Race(9),,
3,0,0,0,0,0,0,0,0,0,0,1,1,0,0,1,1,21,21,0.0,M2019-10-20D,Race(9),,
3,0,0,0,0,0,0,0,0,0,0,1,1,0,0,1,1,21,21,0.0,M2019-10-20D,Race(9),,
4,0,0,5,5,0,9,1,10,0,0,1,1,0,9,7,16,15,15,0.0,M2019-10-20D,Race(9),,
4,0,0,5,5,0,9,1,10,0,0,1,1,0,9,7,16,15,15,0.0,M2019-10-20D,Race(9),,
5,9,12,7,28,11,9,1,21,11,11,2,24,31,32,10,73,4,4,0.0,M2019-10-20D,Race(9),,
5,9,12,7,28,11,9,1,21,11,11,2,24,31,32,10,73,4,4,3.0,M2019-10-20D,Race(9),,
6,0,0,0,0,0,0,0,0,0,0,0,0,0,0,0,0,51,51,1.0,M2019-10-20D,Race(9),,
6,0,0,0,0,0,0,0,0,0,0,0,0,0,0,0,0,51,51,0.0,M2019-10-20D,Race(9),,
7,0,0,0,0,1,2,3,6,0,3,5,8,1,5,8,14,12,12,0.0,M2019-10-20D,Race(9),,
7,0,0,0,0,1,2,3,6,0,3,5,8,1,5,8,14,12,12,0.0,M2019-10-20D,Race(9),,
8,0,4,6,10,0,0,1,1,0,0,2,2,0,4,9,13,26,26,0.0,M2019-10-20D,Race(9),,
8,0,4,6,10,0,0,1,1,0,0,2,2,0,4,9,13,26,26,0.0,M2019-10-20D,Race(9),,
9,0,0,0,0,0,0,0,0,0,0,0,0,0,0,0,0,26,26,0.0,M2019-10-20D,Race(9),,
9,0,0,0,0,0,0,0,0,0,0,0,0,0,0,0,0,26,26,0.0,M2019-10-20D,Race(9),,
10,0,0,0,0,1,0,8,9,2,0,1,3,3,0,9,12,41,41,0.0,M2019-10-20D,Race(9),,
10,0,0,0,0,1,0,8,9,2,0,1,3,3,0,9,12,41,41,0.0,M2019-10-20D,Race(9),,
11,14,5,7,26,3,4,7,14,5,5,6,16,22,14,20,56,2.8,2.8,0.0,M2019-10-20D,Race(9),,
11,14,5,7,26,3,4,7,14,5,5,6,16,22,14,20,56,2.8,2.8,0.0,M2019-10-20D,Race(9),,
12,0,0,0,0,0,0,0,0,0,0,1,1,0,0,1,1,41,41,0.0,M2019-10-20D,Race(9),,
12,0,0,0,0,0,0,0,0,0,0,1,1,0,0,1,1,41,41,0.0,M2019-10-20D,Race(9),,
13,4,2,0,6,0,0,2,2,0,0,2,2,4,2,4,10,15,15,0.0,M2019-10-20D,Race(9),,
13,4,2,0,6,0,0,2,2,0,0,2,2,4,2,4,10,15,15,0.0,M2019-10-20D,Race(9),,
1,5,0,0,5,1,1,4,6,3,2,4,9,9,3,8,20,7,7,2.0,M2019-10-23D,Race(1),,
1,5,0,0,5,1,1,4,6,3,2,4,9,9,3,8,20,7,7,0.0,M2019-10-23D,Race(1),,
2,0,0,0,0,1,2,3,6,0,5,2,7,1,7,5,13,13,13,0.0,M2019-10-23D,Race(1),,
2,0,0,0,0,1,2,3,6,0,5,2,7,1,7,5,13,13,13,0.0,M2019-10-23D,Race(1),,
3,11,3,5,19,1,9,3,13,3,7,3,13,15,19,11,45,5.5,5.5,0.0,M2019-10-23D,Race(1),,
3,11,3,5,19,1,9,3,13,3,7,3,13,15,19,11,45,5.5,5.5,0.0,M2019-10-23D,Race(1),,
4,0,0,0,0,1,2,3,6,3,1,3,7,4,3,6,13,26,26,0.0,M2019-10-23D,Race(1),,
4,0,0,0,0,1,2,3,6,3,1,3,7,4,3,6,13,26,26,0.0,M2019-10-23D,Race(1),,
5,8,13,6,27,18,3,2,23,14,3,3,20,40,19,11,70,2.5,2.5,0.0,M2019-10-23D,Race(1),,
5,8,13,6,27,18,3,2,23,14,3,3,20,40,19,11,70,2.5,2.5,3.0,M2019-10-23D,Race(1),,
6,0,0,5,5,0,0,8,8,1,2,1,4,1,2,14,17,34,34,1.0,M2019-10-23D,Race(1),,
6,0,0,5,5,0,0,8,8,1,2,1,4,1,2,14,17,34,34,0.0,M2019-10-23D,Race(1),,
7,0,0,0,0,8,0,0,8,1,0,1,2,9,0,1,10,26,26,0.0,M2019-10-23D,Race(1),,
7,0,0,0,0,8,0,0,8,1,0,1,2,9,0,1,10,26,26,0.0,M2019-10-23D,Race(1),,
8,0,0,0,0,0,0,0,0,0,0,0,0,0,0,0,0,51,51,0.0,M2019-10-23D,Race(1),,
8,0,0,0,0,0,0,0,0,0,0,0,0,0,0,0,0,51,51,0.0,M2019-10-23D,Race(1),,
9,0,0,2,2,0,0,2,2,0,0,4,4,0,0,8,8,17,17,0.0,M2019-10-23D,Race(1),,
9,0,0,2,2,0,0,2,2,0,0,4,4,0,0,8,8,17,17,0.0,M2019-10-23D,Race(1),,
10,6,6,12,24,0,5,2,7,0,5,1,6,6,16,15,37,7.5,7.5,0.0,M2019-10-23D,Race(1),,
10,6,6,12,24,0,5,2,7,0,5,1,6,6,16,15,37,7.5,7.5,0.0,M2019-10-23D,Race(1),,
11,0,5,0,5,0,8,3,11,1,1,4,6,1,14,7,22,8,8,0.0,M2019-10-23D,Race(1),,
11,0,5,0,5,0,8,3,11,1,1,4,6,1,14,7,22,8,8,0.0,M2019-10-23D,Race(1),,
12,0,3,0,3,0,0,0,0,0,0,0,0,0,3,0,3,31,31,0.0,M2019-10-23D,Race(1),,
12,0,3,0,3,0,0,0,0,0,0,0,0,0,3,0,3,31,31,0.0,M2019-10-23D,Race(1),,
1,5,2,4,11,0,1,2,3,0,2,4,6,5,5,10,20,13,13,0.0,M2019-10-23D,Race(2),,
1,5,2,4,11,0,1,2,3,0,2,4,6,5,5,10,20,13,13,0.0,M2019-10-23D,Race(2),,
2,2,3,0,5,1,0,3,4,3,0,2,5,6,3,5,14,10,10,2.0,M2019-10-23D,Race(2),,
2,2,3,0,5,1,0,3,4,3,0,2,5,6,3,5,14,10,10,3.0,M2019-10-23D,Race(2),,
3,0,2,0,2,0,0,1,1,0,0,0,0,0,2,1,3,21,21,1.0,M2019-10-23D,Race(2),,
3,0,2,0,2,0,0,1,1,0,0,0,0,0,2,1,3,21,21,0.0,M2019-10-23D,Race(2),,
4,5,2,5,12,3,8,4,15,4,1,3,8,12,11,12,35,7.5,7.5,0.0,M2019-10-23D,Race(2),,
4,5,2,5,12,3,8,4,15,4,1,3,8,12,11,12,35,7.5,7.5,0.0,M2019-10-23D,Race(2),,
5,2,14,7,23,6,1,8,15,8,1,7,16,16,16,22,54,4.2,4.2,0.0,M2019-10-23D,Race(2),,
5,2,14,7,23,6,1,8,15,8,1,7,16,16,16,22,54,4.2,4.2,0.0,M2019-10-23D,Race(2),,
6,5,2,9,16,9,9,2,20,5,17,2,24,19,28,13,60,4.8,4.8,0.0,M2019-10-23D,Race(2),,
6,5,2,9,16,9,9,2,20,5,17,2,24,19,28,13,60,4.8,4.8,0.0,M2019-10-23D,Race(2),,
7,0,0,0,0,0,0,0,0,0,0,0,0,0,0,0,0,71,71,0.0,M2019-10-23D,Race(2),,
7,0,0,0,0,0,0,0,0,0,0,0,0,0,0,0,0,71,71,0.0,M2019-10-23D,Race(2),,
8,0,0,3,3,0,1,0,1,0,0,1,1,0,1,4,5,13,13,0.0,M2019-10-23D,Race(2),,
8,0,0,3,3,0,1,0,1,0,0,1,1,0,1,4,5,13,13,0.0,M2019-10-23D,Race(2),,
9,0,0,0,0,0,0,0,0,0,0,0,0,0,0,0,0,41,41,0.0,M2019-10-23D,Race(2),,
9,0,0,0,0,0,0,0,0,0,0,0,0,0,0,0,0,41,41,0.0,M2019-10-23D,Race(2),,
10,9,3,2,14,3,9,2,14,3,5,6,14,15,17,10,42,5.5,5.5,0.0,M2019-10-23D,Race(2),,
10,9,3,2,14,3,9,2,14,3,5,6,14,15,17,10,42,5.5,5.5,0.0,M2019-10-23D,Race(2),,
11,2,2,0,4,0,1,8,9,0,0,0,0,2,3,8,13,8,8,0.0,M2019-10-23D,Race(2),,
11,2,2,0,4,0,1,8,9,0,0,0,0,2,3,8,13,8,8,0.0,M2019-10-23D,Race(2),,
12,0,0,0,0,8,0,0,8,2,0,1,3,10,0,1,11,19,19,0.0,M2019-10-23D,Race(2),,
12,0,0,0,0,8,0,0,8,2,0,1,3,10,0,1,11,19,19,0.0,M2019-10-23D,Race(2),,
1,15,4,6,25,6,5,4,15,9,7,3,19,30,16,13,59,3.2,3.2,0.0,M2019-10-23D,Race(3),,
1,15,4,6,25,6,5,4,15,9,7,3,19,30,16,13,59,3.2,3.2,0.0,M2019-10-23D,Race(3),,
2,0,3,0,3,3,0,3,6,2,1,5,8,5,4,8,17,12,12,1.0,M2019-10-23D,Race(3),,
2,0,3,0,3,3,0,3,6,2,1,5,8,5,4,8,17,12,12,0.0,M2019-10-23D,Race(3),,
3,0,0,3,3,8,0,1,9,2,1,1,4,10,1,5,16,26,26,0.0,M2019-10-23D,Race(3),,
3,0,0,3,3,8,0,1,9,2,1,1,4,10,1,5,16,26,26,0.0,M2019-10-23D,Race(3),,
4,0,0,0,0,0,0,3,3,1,1,3,5,1,1,6,8,21,21,0.0,M2019-10-23D,Race(3),,
4,0,0,0,0,0,0,3,3,1,1,3,5,1,1,6,8,21,21,2.0,M2019-10-23D,Race(3),,
5,0,0,0,0,0,0,0,0,0,0,0,0,0,0,0,0,91,91,0.0,M2019-10-23D,Race(3),,
5,0,0,0,0,0,0,0,0,0,0,0,0,0,0,0,0,91,91,3.0,M2019-10-23D,Race(3),,
6,2,5,2,9,0,0,8,8,1,0,3,4,3,5,13,21,9,9,0.0,M2019-10-23D,Race(3),,
6,2,5,2,9,0,0,8,8,1,0,3,4,3,5,13,21,9,9,0.0,M2019-10-23D,Race(3),,
7,0,0,0,0,0,8,0,8,0,0,0,0,0,8,0,8,41,41,0.0,M2019-10-23D,Race(3),,
7,0,0,0,0,0,8,0,8,0,0,0,0,0,8,0,8,41,41,0.0,M2019-10-23D,Race(3),,
8,2,2,0,4,0,1,2,3,0,0,1,1,2,3,3,8,11,11,0.0,M2019-10-23D,Race(3),,
8,2,2,0,4,0,1,2,3,0,0,1,1,2,3,3,8,11,11,0.0,M2019-10-23D,Race(3),,
9,11,7,12,30,10,8,3,21,8,7,3,18,29,22,18,69,2.9,2.9,0.0,M2019-10-23D,Race(3),,
9,11,7,12,30,10,8,3,21,8,7,3,18,29,22,18,69,2.9,2.9,0.0,M2019-10-23D,Race(3),,
10,0,9,7,16,3,8,6,17,2,9,7,18,5,26,20,51,6,6,0.0,M2019-10-23D,Race(3),,
10,0,9,7,16,3,8,6,17,2,9,7,18,5,26,20,51,6,6,0.0,M2019-10-23D,Race(3),,
11,0,0,0,0,0,0,0,0,0,0,0,0,0,0,0,0,34,34,0.0,M2019-10-23D,Race(3),,
11,0,0,0,0,0,0,0,0,0,0,0,0,0,0,0,0,34,34,0.0,M2019-10-23D,Race(3),,
12,0,0,0,0,0,0,0,0,1,0,0,1,1,0,0,1,61,61,0.0,M2019-10-23D,Race(3),,
12,0,0,0,0,0,0,0,0,1,0,0,1,1,0,0,1,61,61,0.0,M2019-10-23D,Race(3),,
1,3,18,2,23,1,5,4,10,2,7,4,13,6,30,10,46,7.5,7.5,0.0,M2019-10-23D,Race(4),,
1,3,18,2,23,1,5,4,10,2,7,4,13,6,30,10,46,7.5,7.5,3.0,M2019-10-23D,Race(4),,
2,15,6,9,30,15,3,3,21,12,5,3,20,42,14,15,71,2.6,2.6,0.0,M2019-10-23D,Race(4),,
2,15,6,9,30,15,3,3,21,12,5,3,20,42,14,15,71,2.6,2.6,0.0,M2019-10-23D,Race(4),,
3,3,0,8,11,1,2,9,12,2,2,2,6,6,4,19,29,10,10,2.0,M2019-10-23D,Race(4),,
3,3,0,8,11,1,2,9,12,2,2,2,6,6,4,19,29,10,10,0.0,M2019-10-23D,Race(4),,
4,0,0,0,0,0,8,0,8,0,0,0,0,0,8,0,8,17,17,0.0,M2019-10-23D,Race(4),,
4,0,0,0,0,0,8,0,8,0,0,0,0,0,8,0,8,17,17,0.0,M2019-10-23D,Race(4),,
5,2,4,5,11,2,7,9,18,6,5,9,20,10,16,23,49,7,7,1.0,M2019-10-23D,Race(4),,
5,2,4,5,11,2,7,9,18,6,5,9,20,10,16,23,49,7,7,0.0,M2019-10-23D,Race(4),,
6,2,0,0,2,0,0,0,0,0,3,0,3,2,3,0,5,26,26,0.0,M2019-10-23D,Race(4),,
6,2,0,0,2,0,0,0,0,0,3,0,3,2,3,0,5,26,26,0.0,M2019-10-23D,Race(4),,
7,0,0,0,0,8,0,0,8,0,0,0,0,8,0,0,8,31,31,0.0,M2019-10-23D,Race(4),,
7,0,0,0,0,8,0,0,8,0,0,0,0,8,0,0,8,31,31,0.0,M2019-10-23D,Race(4),,
8,3,0,0,3,0,0,0,0,0,0,1,1,3,0,1,4,15,15,0.0,M2019-10-23D,Race(4),,
8,3,0,0,3,0,0,0,0,0,0,1,1,3,0,1,4,15,15,0.0,M2019-10-23D,Race(4),,
9,2,2,6,10,3,5,5,13,4,4,7,15,9,11,18,38,3.1,3.1,0.0,M2019-10-23D,Race(4),,
9,2,2,6,10,3,5,5,13,4,4,7,15,9,11,18,38,3.1,3.1,0.0,M2019-10-23D,Race(4),,
10,0,0,0,0,0,0,0,0,0,0,0,0,0,0,0,0,0,0,0.0,M2019-10-23D,Race(4),,
10,0,0,0,0,0,0,0,0,0,0,0,0,0,0,0,0,0,0,0.0,M2019-10-23D,Race(4),,
11,0,0,0,0,0,0,0,0,0,0,0,0,0,0,0,0,0,0,0.0,M2019-10-23D,Race(4),,
11,0,0,0,0,0,0,0,0,0,0,0,0,0,0,0,0,0,0,0.0,M2019-10-23D,Race(4),,
12,0,0,0,0,0,0,0,0,0,0,0,0,0,0,0,0,0,0,0.0,M2019-10-23D,Race(4),,
12,0,0,0,0,0,0,0,0,0,0,0,0,0,0,0,0,0,0,0.0,M2019-10-23D,Race(4),,
1,7,6,7,20,1,3,7,11,1,3,1,5,9,12,15,36,8.5,8.5,1.0,M2019-10-23D,Race(5),,
1,7,6,7,20,1,3,7,11,1,3,1,5,9,12,15,36,8.5,8.5,0.0,M2019-10-23D,Race(5),,
2,0,10,12,22,8,7,5,20,6,4,2,12,14,21,19,54,5,5,0.0,M2019-10-23D,Race(5),,
2,0,10,12,22,8,7,5,20,6,4,2,12,14,21,19,54,5,5,0.0,M2019-10-23D,Race(5),,
3,20,3,2,25,19,4,0,23,17,6,2,25,56,13,4,73,2.4,2.4,0.0,M2019-10-23D,Race(5),,
3,20,3,2,25,19,4,0,23,17,6,2,25,56,13,4,73,2.4,2.4,2.0,M2019-10-23D,Race(5),,
4,0,2,5,7,0,1,8,9,0,1,4,5,0,4,17,21,9.5,9.5,3.0,M2019-10-23D,Race(5),,
4,0,2,5,7,0,1,8,9,0,1,4,5,0,4,17,21,9.5,9.5,0.0,M2019-10-23D,Race(5),,
5,0,2,0,2,0,2,0,2,0,4,3,7,0,8,3,11,26,26,0.0,M2019-10-23D,Race(5),,
5,0,2,0,2,0,2,0,2,0,4,3,7,0,8,3,11,26,26,0.0,M2019-10-23D,Race(5),,
6,0,3,0,3,1,1,1,3,1,2,0,3,2,6,1,9,10,10,0.0,M2019-10-23D,Race(5),,
6,0,3,0,3,1,1,1,3,1,2,0,3,2,6,1,9,10,10,0.0,M2019-10-23D,Race(5),,
7,0,0,0,0,1,4,7,12,1,4,9,14,2,8,16,26,14,14,0.0,M2019-10-23D,Race(5),,
7,0,0,0,0,1,4,7,12,1,4,9,14,2,8,16,26,14,14,0.0,M2019-10-23D,Race(5),,
8,0,2,0,2,0,0,0,0,0,0,0,0,0,2,0,2,34,34,0.0,M2019-10-23D,Race(5),,
8,0,2,0,2,0,0,0,0,0,0,0,0,0,2,0,2,34,34,0.0,M2019-10-23D,Race(5),,
9,3,2,2,7,0,0,2,2,0,2,5,7,3,4,9,16,9,9,0.0,M2019-10-23D,Race(5),,
9,3,2,2,7,0,0,2,2,0,2,5,7,3,4,9,16,9,9,0.0,M2019-10-23D,Race(5),,
10,0,0,0,0,0,0,0,0,0,0,0,0,0,0,0,0,31,31,0.0,M2019-10-23D,Race(5),,
10,0,0,0,0,0,0,0,0,0,0,0,0,0,0,0,0,31,31,0.0,M2019-10-23D,Race(5),,
11,0,0,2,2,0,8,0,8,0,0,0,0,0,8,2,10,41,41,0.0,M2019-10-23D,Race(5),,
11,0,0,2,2,0,8,0,8,0,0,0,0,0,8,2,10,41,41,0.0,M2019-10-23D,Race(5),,
12,0,0,0,0,0,0,0,0,0,0,0,0,0,0,0,0,31,31,0.0,M2019-10-23D,Race(5),,
12,0,0,0,0,0,0,0,0,0,0,0,0,0,0,0,0,31,31,0.0,M2019-10-23D,Race(5),,
1,14,3,6,23,4,3,3,10,5,3,4,12,23,9,13,45,3.2,3.2,0.0,M2019-10-23D,Race(6),,
1,14,3,6,23,4,3,3,10,5,3,4,12,23,9,13,45,3.2,3.2,0.0,M2019-10-23D,Race(6),,
2,0,7,9,16,10,3,8,21,5,6,6,17,15,16,23,54,7.5,7.5,1.0,M2019-10-23D,Race(6),,
2,0,7,9,16,10,3,8,21,5,6,6,17,15,16,23,54,7.5,7.5,0.0,M2019-10-23D,Race(6),,
3,2,17,6,25,10,8,2,20,8,9,4,21,20,34,12,66,3.3,3.3,2.0,M2019-10-23D,Race(6),,
3,2,17,6,25,10,8,2,20,8,9,4,21,20,34,12,66,3.3,3.3,3.0,M2019-10-23D,Race(6),,
4,9,0,7,16,7,8,3,18,7,4,5,16,23,12,15,50,6,6,0.0,M2019-10-23D,Race(6),,
4,9,0,7,16,7,8,3,18,7,4,5,16,23,12,15,50,6,6,0.0,M2019-10-23D,Race(6),,
5,0,0,2,2,0,0,1,1,0,1,0,1,0,1,3,4,12,12,0.0,M2019-10-23D,Race(6),,
5,0,0,2,2,0,0,1,1,0,1,0,1,0,1,3,4,12,12,0.0,M2019-10-23D,Race(6),,
6,0,0,0,0,0,0,0,0,0,0,0,0,0,0,0,0,31,31,0.0,M2019-10-23D,Race(6),,
6,0,0,0,0,0,0,0,0,0,0,0,0,0,0,0,0,31,31,0.0,M2019-10-23D,Race(6),,
7,0,0,0,0,0,0,0,0,0,0,1,1,0,0,1,1,51,51,0.0,M2019-10-23D,Race(6),,
7,0,0,0,0,0,0,0,0,0,0,1,1,0,0,1,1,51,51,0.0,M2019-10-23D,Race(6),,
8,0,3,0,3,0,0,1,1,0,1,1,2,0,4,2,6,19,19,0.0,M2019-10-23D,Race(6),,
8,0,3,0,3,0,0,1,1,0,1,1,2,0,4,2,6,19,19,0.0,M2019-10-23D,Race(6),,
9,3,0,0,3,0,8,4,12,0,2,4,6,3,10,8,21,15,15,0.0,M2019-10-23D,Race(6),,
9,3,0,0,3,0,8,4,12,0,2,4,6,3,10,8,21,15,15,0.0,M2019-10-23D,Race(6),,
10,0,0,0,0,0,0,8,8,1,0,1,2,1,0,9,10,15,15,0.0,M2019-10-23D,Race(6),,
10,0,0,0,0,0,0,8,8,1,0,1,2,1,0,9,10,15,15,0.0,M2019-10-23D,Race(6),,
11,0,0,0,0,0,0,0,0,0,0,0,0,0,0,0,0,81,81,0.0,M2019-10-23D,Race(6),,
11,0,0,0,0,0,0,0,0,0,0,0,0,0,0,0,0,81,81,0.0,M2019-10-23D,Race(6),,
12,2,0,0,2,0,0,0,0,0,0,0,0,2,0,0,2,34,34,0.0,M2019-10-23D,Race(6),,
12,2,0,0,2,0,0,0,0,0,0,0,0,2,0,0,2,34,34,0.0,M2019-10-23D,Race(6),,
1,9,5,7,21,3,12,3,18,7,12,3,22,19,29,13,61,3.7,3.7,0.0,M2019-10-23D,Race(7),,
1,9,5,7,21,3,12,3,18,7,12,3,22,19,29,13,61,3.7,3.7,0.0,M2019-10-23D,Race(7),,
2,0,2,3,5,0,9,0,9,2,4,3,9,2,15,6,23,13,13,0.0,M2019-10-23D,Race(7),,
2,0,2,3,5,0,9,0,9,2,4,3,9,2,15,6,23,13,13,0.0,M2019-10-23D,Race(7),,
3,2,6,0,8,0,4,4,8,1,2,1,4,3,12,5,20,8.5,8.5,0.0,M2019-10-23D,Race(7),,
3,2,6,0,8,0,4,4,8,1,2,1,4,3,12,5,20,8.5,8.5,3.0,M2019-10-23D,Race(7),,
4,0,3,9,12,8,1,5,14,2,0,6,8,10,4,20,34,9,9,0.0,M2019-10-23D,Race(7),,
4,0,3,9,12,8,1,5,14,2,0,6,8,10,4,20,34,9,9,0.0,M2019-10-23D,Race(7),,
5,0,0,0,0,0,0,1,1,0,0,2,2,0,0,3,3,14,14,0.0,M2019-10-23D,Race(7),,
5,0,0,0,0,0,0,1,1,0,0,2,2,0,0,3,3,14,14,0.0,M2019-10-23D,Race(7),,
6,15,10,2,27,17,2,2,21,11,5,4,20,43,17,8,68,3.1,3.1,2.0,M2019-10-23D,Race(7),,
6,15,10,2,27,17,2,2,21,11,5,4,20,43,17,8,68,3.1,3.1,1.0,M2019-10-23D,Race(7),,
7,0,0,0,0,0,0,0,0,0,0,0,0,0,0,0,0,31,31,0.0,M2019-10-23D,Race(7),,
7,0,0,0,0,0,0,0,0,0,0,0,0,0,0,0,0,31,31,0.0,M2019-10-23D,Race(7),,
8,0,4,0,4,0,0,8,8,0,1,0,1,0,5,8,13,26,26,0.0,M2019-10-23D,Race(7),,
8,0,4,0,4,0,0,8,8,0,1,0,1,0,5,8,13,26,26,0.0,M2019-10-23D,Race(7),,
9,2,0,3,5,0,0,0,0,2,0,0,2,4,0,3,7,16,16,0.0,M2019-10-23D,Race(7),,
9,2,0,3,5,0,0,0,0,2,0,0,2,4,0,3,7,16,16,0.0,M2019-10-23D,Race(7),,
10,0,0,2,2,2,0,5,7,1,1,0,2,3,1,7,11,13,13,0.0,M2019-10-23D,Race(7),,
10,0,0,2,2,2,0,5,7,1,1,0,2,3,1,7,11,13,13,0.0,M2019-10-23D,Race(7),,
11,0,0,0,0,0,0,0,0,0,0,0,0,0,0,0,0,41,41,0.0,M2019-10-23D,Race(7),,
11,0,0,0,0,0,0,0,0,0,0,0,0,0,0,0,0,41,41,0.0,M2019-10-23D,Race(7),,
12,2,0,4,6,0,0,0,0,0,0,0,0,2,0,4,6,14,14,0.0,M2019-10-23D,Race(7),,
12,2,0,4,6,0,0,0,0,0,0,0,0,2,0,4,6,14,14,0.0,M2019-10-23D,Race(7),,
1,0,5,10,15,2,4,7,13,4,6,4,14,6,15,21,42,8,8,3.0,M2019-10-23D,Race(8),,
1,0,5,10,15,2,4,7,13,4,6,4,14,6,15,21,42,8,8,0.0,M2019-10-23D,Race(8),,
2,2,16,7,25,1,12,4,17,3,5,10,18,6,33,21,60,5,5,0.0,M2019-10-23D,Race(8),,
2,2,16,7,25,1,12,4,17,3,5,10,18,6,33,21,60,5,5,0.0,M2019-10-23D,Race(8),,
3,0,0,3,3,0,0,6,6,0,0,3,3,0,0,12,12,17,17,1.0,M2019-10-23D,Race(8),,
3,0,0,3,3,0,0,6,6,0,0,3,3,0,0,12,12,17,17,0.0,M2019-10-23D,Race(8),,
4,0,0,0,0,0,1,0,1,0,0,0,0,0,1,0,1,26,26,2.0,M2019-10-23D,Race(8),,
4,0,0,0,0,0,1,0,1,0,0,0,0,0,1,0,1,26,26,0.0,M2019-10-23D,Race(8),,
5,26,4,0,30,19,2,1,22,17,7,0,24,62,13,1,76,1.8,1.8,0.0,M2019-10-23D,Race(8),,
5,26,4,0,30,19,2,1,22,17,7,0,24,62,13,1,76,1.8,1.8,0.0,M2019-10-23D,Race(8),,
6,0,2,3,5,0,9,0,9,0,5,1,6,0,16,4,20,15,15,0.0,M2019-10-23D,Race(8),,
6,0,2,3,5,0,9,0,9,0,5,1,6,0,16,4,20,15,15,0.0,M2019-10-23D,Race(8),,
7,0,0,0,0,8,0,2,10,2,1,3,6,10,1,5,16,10,10,0.0,M2019-10-23D,Race(8),,
7,0,0,0,0,8,0,2,10,2,1,3,6,10,1,5,16,10,10,0.0,M2019-10-23D,Race(8),,
8,0,0,0,0,0,0,0,0,0,0,2,2,0,0,2,2,41,41,0.0,M2019-10-23D,Race(8),,
8,0,0,0,0,0,0,0,0,0,0,2,2,0,0,2,2,41,41,0.0,M2019-10-23D,Race(8),,
9,2,3,7,12,0,2,10,12,0,2,3,5,2,7,20,29,15,15,0.0,M2019-10-23D,Race(8),,
9,2,3,7,12,0,2,10,12,0,2,3,5,2,7,20,29,15,15,0.0,M2019-10-23D,Race(8),,
10,0,0,0,0,0,0,0,0,0,0,0,0,0,0,0,0,126,126,0.0,M2019-10-23D,Race(8),,
10,0,0,0,0,0,0,0,0,0,0,0,0,0,0,0,0,126,126,0.0,M2019-10-23D,Race(8),,
11,0,0,0,0,0,0,0,0,0,0,0,0,0,0,0,0,41,41,0.0,M2019-10-23D,Race(8),,
11,0,0,0,0,0,0,0,0,0,0,0,0,0,0,0,0,41,41,0.0,M2019-10-23D,Race(8),,
12,0,0,0,0,0,0,0,0,0,0,0,0,0,0,0,0,91,91,0.0,M2019-10-23D,Race(8),,
12,0,0,0,0,0,0,0,0,0,0,0,0,0,0,0,0,91,91,0.0,M2019-10-23D,Race(8),,
1,23,2,5,30,15,5,3,23,12,10,3,25,50,17,11,78,1.8,1.8,3.0,M2019-10-23D,Race(9),,
1,23,2,5,30,15,5,3,23,12,10,3,25,50,17,11,78,1.8,1.8,0.0,M2019-10-23D,Race(9),,
2,0,8,5,13,0,0,3,3,1,0,3,4,1,8,11,20,12,12,0.0,M2019-10-23D,Race(9),,
2,0,8,5,13,0,0,3,3,1,0,3,4,1,8,11,20,12,12,0.0,M2019-10-23D,Race(9),,
3,5,16,5,26,5,10,2,17,5,7,2,14,15,33,9,57,5,5,1.0,M2019-10-23D,Race(9),,
3,5,16,5,26,5,10,2,17,5,7,2,14,15,33,9,57,5,5,0.0,M2019-10-23D,Race(9),,
4,0,0,0,0,0,1,0,1,0,2,1,3,0,3,1,4,31,31,0.0,M2019-10-23D,Race(9),,
4,0,0,0,0,0,1,0,1,0,2,1,3,0,3,1,4,31,31,0.0,M2019-10-23D,Race(9),,
5,0,0,0,0,0,8,0,8,0,0,1,1,0,8,1,9,26,26,0.0,M2019-10-23D,Race(9),,
5,0,0,0,0,0,8,0,8,0,0,1,1,0,8,1,9,26,26,0.0,M2019-10-23D,Race(9),,
6,0,0,3,3,0,3,9,12,2,3,9,14,2,6,21,29,10,10,0.0,M2019-10-23D,Race(9),,
6,0,0,3,3,0,3,9,12,2,3,9,14,2,6,21,29,10,10,2.0,M2019-10-23D,Race(9),,
7,0,2,5,7,8,3,5,16,3,4,4,11,11,9,14,34,13,13,0.0,M2019-10-23D,Race(9),,
7,0,2,5,7,8,3,5,16,3,4,4,11,11,9,14,34,13,13,0.0,M2019-10-23D,Race(9),,
8,0,0,0,0,0,0,0,0,0,0,0,0,0,0,0,0,41,41,0.0,M2019-10-23D,Race(9),,
8,0,0,0,0,0,0,0,0,0,0,0,0,0,0,0,0,41,41,0.0,M2019-10-23D,Race(9),,
9,0,0,3,3,0,0,0,0,0,0,1,1,0,0,4,4,16,16,0.0,M2019-10-23D,Race(9),,
9,0,0,3,3,0,0,0,0,0,0,1,1,0,0,4,4,16,16,0.0,M2019-10-23D,Race(9),,
10,2,0,4,6,0,0,0,0,0,0,0,0,2,0,4,6,26,26,0.0,M2019-10-23D,Race(9),,
10,2,0,4,6,0,0,0,0,0,0,0,0,2,0,4,6,26,26,0.0,M2019-10-23D,Race(9),,
11,0,2,0,2,0,0,0,0,1,0,0,1,1,2,0,3,26,26,0.0,M2019-10-23D,Race(9),,
11,0,2,0,2,0,0,0,0,1,0,0,1,1,2,0,3,26,26,0.0,M2019-10-23D,Race(9),,
12,0,0,0,0,0,0,0,0,0,0,0,0,0,0,0,0,34,34,0.0,M2019-10-23D,Race(9),,
12,0,0,0,0,0,0,0,0,0,0,0,0,0,0,0,0,34,34,0.0,M2019-10-23D,Race(9),,
1,7,10,6,23,21,3,5,29,14,4,2,20,42,17,13,72,5,5,0.0,M2019-10-27D,Race(1),,
1,7,10,6,23,21,3,5,29,14,4,2,20,42,17,13,72,5,5,0.0,M2019-10-27D,Race(1),,
2,0,0,0,0,0,0,0,0,0,0,0,0,0,0,0,0,0,0,0.0,M2019-10-27D,Race(1),,
2,0,0,0,0,0,0,0,0,0,0,0,0,0,0,0,0,0,0,0.0,M2019-10-27D,Race(1),,
3,10,5,5,20,3,7,12,22,6,3,5,14,19,15,22,56,3.8,3.8,3.0,M2019-10-27D,Race(1),,
3,10,5,5,20,3,7,12,22,6,3,5,14,19,15,22,56,3.8,3.8,0.0,M2019-10-27D,Race(1),,
4,2,2,5,9,2,3,1,6,2,2,1,5,6,7,7,20,11,11,0.0,M2019-10-27D,Race(1),,
4,2,2,5,9,2,3,1,6,2,2,1,5,6,7,7,20,11,11,0.0,M2019-10-27D,Race(1),,
5,8,10,5,23,3,15,6,24,1,1,10,12,12,26,21,59,3.1,3.1,0.0,M2019-10-27D,Race(1),,
5,8,10,5,23,3,15,6,24,1,1,10,12,12,26,21,59,3.1,3.1,1.0,M2019-10-27D,Race(1),,
6,0,0,0,0,1,0,0,1,0,1,0,1,1,1,0,2,21,21,2.0,M2019-10-27D,Race(1),,
6,0,0,0,0,1,0,0,1,0,1,0,1,1,1,0,2,21,21,0.0,M2019-10-27D,Race(1),,
7,0,0,0,0,0,0,0,0,0,0,0,0,0,0,0,0,41,41,0.0,M2019-10-27D,Race(1),,
7,0,0,0,0,0,0,0,0,0,0,0,0,0,0,0,0,41,41,0.0,M2019-10-27D,Race(1),,
8,0,0,0,0,0,0,0,0,0,1,0,1,0,1,0,1,14,14,0.0,M2019-10-27D,Race(1),,
8,0,0,0,0,0,0,0,0,0,1,0,1,0,1,0,1,14,14,0.0,M2019-10-27D,Race(1),,
9,0,0,2,2,0,0,0,0,0,1,1,2,0,1,3,4,51,51,0.0,M2019-10-27D,Race(1),,
9,0,0,2,2,0,0,0,0,0,1,1,2,0,1,3,4,51,51,0.0,M2019-10-27D,Race(1),,
10,3,3,4,10,0,2,5,7,1,3,2,6,4,8,11,23,8.5,9,0.0,M2019-10-27D,Race(1),,
10,3,3,4,10,0,2,5,7,1,3,2,6,4,8,11,23,8.5,9,0.0,M2019-10-27D,Race(1),,
11,0,0,3,3,0,0,1,1,0,0,3,3,0,0,7,7,11,11,0.0,M2019-10-27D,Race(1),,
11,0,0,3,3,0,0,1,1,0,0,3,3,0,0,7,7,11,11,0.0,M2019-10-27D,Race(1),,
12,0,0,0,0,0,0,0,0,0,0,0,0,0,0,0,0,31,31,0.0,M2019-10-27D,Race(1),,
12,0,0,0,0,0,0,0,0,0,0,0,0,0,0,0,0,31,31,0.0,M2019-10-27D,Race(1),,
1,5,11,5,21,16,9,4,29,8,6,6,20,29,26,15,70,4,4,0.0,M2019-10-27D,Race(2),,
1,5,11,5,21,16,9,4,29,8,6,6,20,29,26,15,70,4,4,0.0,M2019-10-27D,Race(2),,
2,0,2,8,10,0,1,2,3,0,1,3,4,0,4,13,17,11,11,0.0,M2019-10-27D,Race(2),,
2,0,2,8,10,0,1,2,3,0,1,3,4,0,4,13,17,11,11,0.0,M2019-10-27D,Race(2),,
3,2,2,5,9,6,14,4,24,5,6,2,13,13,22,11,46,10,10,0.0,M2019-10-27D,Race(2),,
3,2,2,5,9,6,14,4,24,5,6,2,13,13,22,11,46,10,10,0.0,M2019-10-27D,Race(2),,
4,0,3,2,5,1,1,1,3,2,2,0,4,3,6,3,12,14,14,1.0,M2019-10-27D,Race(2),,
4,0,3,2,5,1,1,1,3,2,2,0,4,3,6,3,12,14,14,2.0,M2019-10-27D,Race(2),,
5,2,0,0,2,0,0,0,0,1,0,1,2,3,0,1,4,34,34,3.0,M2019-10-27D,Race(2),,
5,2,0,0,2,0,0,0,0,1,0,1,2,3,0,1,4,34,34,0.0,M2019-10-27D,Race(2),,
6,12,9,3,24,4,3,13,20,8,8,7,23,24,20,23,67,3.5,3.5,0.0,M2019-10-27D,Race(2),,
6,12,9,3,24,4,3,13,20,8,8,7,23,24,20,23,67,3.5,3.5,0.0,M2019-10-27D,Race(2),,
7,0,0,0,0,0,0,0,0,0,0,0,0,0,0,0,0,34,34,0.0,M2019-10-27D,Race(2),,
7,0,0,0,0,0,0,0,0,0,0,0,0,0,0,0,0,34,34,0.0,M2019-10-27D,Race(2),,
8,2,0,2,4,0,0,0,0,0,0,0,0,2,0,2,4,19,19,0.0,M2019-10-27D,Race(2),,
8,2,0,2,4,0,0,0,0,0,0,0,0,2,0,2,4,19,19,0.0,M2019-10-27D,Race(2),,
9,7,3,5,15,3,2,6,11,1,3,7,11,11,8,18,37,2.9,2.9,0.0,M2019-10-27D,Race(2),,
9,7,3,5,15,3,2,6,11,1,3,7,11,11,8,18,37,2.9,2.9,0.0,M2019-10-27D,Race(2),,
10,0,0,0,0,0,0,0,0,1,0,0,1,1,0,0,1,41,41,0.0,M2019-10-27D,Race(2),,
10,0,0,0,0,0,0,0,0,1,0,0,1,1,0,0,1,41,41,0.0,M2019-10-27D,Race(2),,
1,3,0,5,8,0,2,0,2,1,1,0,2,4,3,5,12,7.5,8,3.0,M2019-10-27D,Race(3),,
1,3,0,5,8,0,2,0,2,1,1,0,2,4,3,5,12,7.5,8,0.0,M2019-10-27D,Race(3),,
2,0,0,2,2,0,0,0,0,0,0,0,0,0,0,2,2,21,21,0.0,M2019-10-27D,Race(3),,
2,0,0,2,2,0,0,0,0,0,0,0,0,0,0,2,2,21,21,0.0,M2019-10-27D,Race(3),,
3,2,8,3,13,7,2,4,13,4,1,3,8,13,11,10,34,4.2,4.2,0.0,M2019-10-27D,Race(3),,
3,2,8,3,13,7,2,4,13,4,1,3,8,13,11,10,34,4.2,4.2,0.0,M2019-10-27D,Race(3),,
4,0,0,0,0,0,0,0,0,0,2,0,2,0,2,0,2,41,41,0.0,M2019-10-27D,Race(3),,
4,0,0,0,0,0,0,0,0,0,2,0,2,0,2,0,2,41,41,0.0,M2019-10-27D,Race(3),,
5,16,10,0,26,22,3,4,29,14,4,1,19,52,17,5,74,4.2,4.2,0.0,M2019-10-27D,Race(3),,
5,16,10,0,26,22,3,4,29,14,4,1,19,52,17,5,74,4.2,4.2,1.0,M2019-10-27D,Race(3),,
6,0,2,0,2,1,0,1,2,1,0,3,4,2,2,4,8,21,21,0.0,M2019-10-27D,Race(3),,
6,0,2,0,2,1,0,1,2,1,0,3,4,2,2,4,8,21,21,0.0,M2019-10-27D,Race(3),,
7,2,0,0,2,0,0,0,0,0,0,0,0,2,0,0,2,31,31,0.0,M2019-10-27D,Race(3),,
7,2,0,0,2,0,0,0,0,0,0,0,0,2,0,0,2,31,31,2.0,M2019-10-27D,Race(3),,
8,0,2,2,4,0,3,2,5,0,3,3,6,0,8,7,15,12,12,0.0,M2019-10-27D,Race(3),,
8,0,2,2,4,0,3,2,5,0,3,3,6,0,8,7,15,12,12,0.0,M2019-10-27D,Race(3),,
9,0,0,0,0,0,0,0,0,1,0,0,1,1,0,0,1,41,51,0.0,M2019-10-27D,Race(3),,
9,0,0,0,0,0,0,0,0,1,0,0,1,1,0,0,1,41,51,0.0,M2019-10-27D,Race(3),,
10,5,5,6,16,0,3,15,18,2,2,12,16,7,10,33,50,5.5,5.5,0.0,M2019-10-27D,Race(3),,
10,5,5,6,16,0,3,15,18,2,2,12,16,7,10,33,50,5.5,5.5,0.0,M2019-10-27D,Race(3),,
11,2,3,12,17,0,17,4,21,3,13,4,20,5,33,20,58,6,6.5,0.0,M2019-10-27D,Race(3),,
11,2,3,12,17,0,17,4,21,3,13,4,20,5,33,20,58,6,6.5,0.0,M2019-10-27D,Race(3),,
12,0,0,0,0,0,0,0,0,0,0,0,0,0,0,0,0,18,18,0.0,M2019-10-27D,Race(3),,
12,0,0,0,0,0,0,0,0,0,0,0,0,0,0,0,0,18,18,0.0,M2019-10-27D,Race(3),,
13,0,0,0,0,0,0,0,0,0,0,0,0,0,0,0,0,81,81,0.0,M2019-10-27D,Race(3),,
13,0,0,0,0,0,0,0,0,0,0,0,0,0,0,0,0,81,81,0.0,M2019-10-27D,Race(3),,
14,0,0,0,0,0,0,0,0,0,0,0,0,0,0,0,0,51,51,0.0,M2019-10-27D,Race(3),,
14,0,0,0,0,0,0,0,0,0,0,0,0,0,0,0,0,51,51,0.0,M2019-10-27D,Race(3),,
1,18,7,5,30,20,6,4,30,12,7,5,24,50,20,14,84,2,2,1.0,M2019-10-27D,Race(4),,
1,18,7,5,30,20,6,4,30,12,7,5,24,50,20,14,84,2,2,0.0,M2019-10-27D,Race(4),,
2,2,0,0,2,0,0,0,0,0,0,1,1,2,0,1,3,31,31,3.0,M2019-10-27D,Race(4),,
2,2,0,0,2,0,0,0,0,0,0,1,1,2,0,1,3,31,31,0.0,M2019-10-27D,Race(4),,
3,0,0,2,2,0,1,3,4,0,2,3,5,0,3,8,11,12,12,0.0,M2019-10-27D,Race(4),,
3,0,0,2,2,0,1,3,4,0,2,3,5,0,3,8,11,12,12,0.0,M2019-10-27D,Race(4),,
4,3,7,13,23,5,6,13,24,2,5,5,12,10,18,31,59,5.5,5.5,2.0,M2019-10-27D,Race(4),,
4,3,7,13,23,5,6,13,24,2,5,5,12,10,18,31,59,5.5,5.5,0.0,M2019-10-27D,Race(4),,
5,0,0,7,7,0,0,3,3,0,0,6,6,0,0,16,16,13,13,0.0,M2019-10-27D,Race(4),,
5,0,0,7,7,0,0,3,3,0,0,6,6,0,0,16,16,13,13,0.0,M2019-10-27D,Race(4),,
6,0,3,0,3,1,0,0,1,1,2,2,5,2,5,2,9,17,17,0.0,M2019-10-27D,Race(4),,
6,0,3,0,3,1,0,0,1,1,2,2,5,2,5,2,9,17,17,0.0,M2019-10-27D,Race(4),,
7,7,11,3,21,4,16,7,27,11,9,4,24,22,36,14,72,4,4,0.0,M2019-10-27D,Race(4),,
7,7,11,3,21,4,16,7,27,11,9,4,24,22,36,14,72,4,4,0.0,M2019-10-27D,Race(4),,
8,0,0,0,0,0,0,0,0,0,0,0,0,0,0,0,0,16,16,0.0,M2019-10-27D,Race(4),,
8,0,0,0,0,0,0,0,0,0,0,0,0,0,0,0,0,16,16,0.0,M2019-10-27D,Race(4),,
9,0,2,0,2,0,1,0,1,0,1,0,1,0,4,0,4,34,34,0.0,M2019-10-27D,Race(4),,
9,0,2,0,2,0,1,0,1,0,1,0,1,0,4,0,4,34,34,0.0,M2019-10-27D,Race(4),,
1,0,2,0,2,3,2,3,8,1,1,3,5,4,5,6,15,9,9,0.0,M2019-10-27D,Race(5),,
1,0,2,0,2,3,2,3,8,1,1,3,5,4,5,6,15,9,9,0.0,M2019-10-27D,Race(5),,
2,6,2,4,12,15,8,4,27,10,8,3,21,31,18,11,60,4.6,4.5,3.0,M2019-10-27D,Race(5),,
2,6,2,4,12,15,8,4,27,10,8,3,21,31,18,11,60,4.6,4.5,2.0,M2019-10-27D,Race(5),,
3,0,0,2,2,0,1,0,1,0,1,0,1,0,2,2,4,11,11,0.0,M2019-10-27D,Race(5),,
3,0,0,2,2,0,1,0,1,0,1,0,1,0,2,2,4,11,11,0.0,M2019-10-27D,Race(5),,
4,3,0,2,5,1,1,0,2,0,0,0,0,4,1,2,7,16,16,0.0,M2019-10-27D,Race(5),,
4,3,0,2,5,1,1,0,2,0,0,0,0,4,1,2,7,16,16,0.0,M2019-10-27D,Race(5),,
5,9,14,2,25,5,14,4,23,5,11,5,21,19,39,11,69,5,5,0.0,M2019-10-27D,Race(5),,
5,9,14,2,25,5,14,4,23,5,11,5,21,19,39,11,69,5,5,0.0,M2019-10-27D,Race(5),,
6,0,4,0,4,0,0,0,0,0,0,0,0,0,4,0,4,17,17,0.0,M2019-10-27D,Race(5),,
6,0,4,0,4,0,0,0,0,0,0,0,0,0,4,0,4,17,17,1.0,M2019-10-27D,Race(5),,
7,0,0,0,0,0,2,0,2,0,0,0,0,0,2,0,2,19,19,0.0,M2019-10-27D,Race(5),,
7,0,0,0,0,0,2,0,2,0,0,0,0,0,2,0,2,19,19,0.0,M2019-10-27D,Race(5),,
8,0,0,0,0,0,0,1,1,0,0,3,3,0,0,4,4,31,31,0.0,M2019-10-27D,Race(5),,
8,0,0,0,0,0,0,1,1,0,0,3,3,0,0,4,4,31,31,0.0,M2019-10-27D,Race(5),,
9,0,0,0,0,0,0,0,0,0,0,0,0,0,0,0,0,26,26,0.0,M2019-10-27D,Race(5),,
9,0,0,0,0,0,0,0,0,0,0,0,0,0,0,0,0,26,26,0.0,M2019-10-27D,Race(5),,
10,5,5,14,24,3,1,3,7,5,2,2,9,13,8,19,40,4.4,4.4,0.0,M2019-10-27D,Race(5),,
10,5,5,14,24,3,1,3,7,5,2,2,9,13,8,19,40,4.4,4.4,0.0,M2019-10-27D,Race(5),,
11,2,0,0,2,0,0,0,0,0,0,0,0,2,0,0,2,41,41,0.0,M2019-10-27D,Race(5),,
11,2,0,0,2,0,0,0,0,0,0,0,0,2,0,0,2,41,41,0.0,M2019-10-27D,Race(5),,
12,5,3,6,14,3,0,15,18,5,1,10,16,13,4,31,48,6.5,6.5,0.0,M2019-10-27D,Race(5),,
12,5,3,6,14,3,0,15,18,5,1,10,16,13,4,31,48,6.5,6.5,0.0,M2019-10-27D,Race(5),,
1,0,4,3,7,0,0,6,6,2,1,8,11,2,5,17,24,12,12,3.0,M2019-10-27D,Race(6),,
1,0,4,3,7,0,0,6,6,2,1,8,11,2,5,17,24,12,12,0.0,M2019-10-27D,Race(6),,
2,13,8,2,23,20,6,3,29,9,10,2,21,42,24,7,73,3.5,3.5,0.0,M2019-10-27D,Race(6),,
2,13,8,2,23,20,6,3,29,9,10,2,21,42,24,7,73,3.5,3.5,0.0,M2019-10-27D,Race(6),,
3,0,0,0,0,0,0,0,0,0,0,0,0,0,0,0,0,19,19,0.0,M2019-10-27D,Race(6),,
3,0,0,0,0,0,0,0,0,0,0,0,0,0,0,0,0,19,19,0.0,M2019-10-27D,Race(6),,
4,0,0,0,0,0,0,0,0,1,1,0,2,1,1,0,2,21,21,0.0,M2019-10-27D,Race(6),,
4,0,0,0,0,0,0,0,0,1,1,0,2,1,1,0,2,21,21,1.0,M2019-10-27D,Race(6),,
5,4,0,2,6,0,0,0,0,0,0,2,2,4,0,4,8,10,10,0.0,M2019-10-27D,Race(6),,
5,4,0,2,6,0,0,0,0,0,0,2,2,4,0,4,8,10,10,0.0,M2019-10-27D,Race(6),,
6,0,0,0,0,0,0,0,0,0,0,0,0,0,0,0,0,101,101,2.0,M2019-10-27D,Race(6),,
6,0,0,0,0,0,0,0,0,0,0,0,0,0,0,0,0,101,101,0.0,M2019-10-27D,Race(6),,
7,2,3,0,5,0,0,1,1,0,0,3,3,2,3,4,9,21,21,0.0,M2019-10-27D,Race(6),,
7,2,3,0,5,0,0,1,1,0,0,3,3,2,3,4,9,21,21,0.0,M2019-10-27D,Race(6),,
8,8,8,9,25,6,20,3,29,8,9,4,21,22,37,16,75,3.4,3.5,0.0,M2019-10-27D,Race(6),,
8,8,8,9,25,6,20,3,29,8,9,4,21,22,37,16,75,3.4,3.5,0.0,M2019-10-27D,Race(6),,
9,0,0,0,0,0,0,0,0,0,0,0,0,0,0,0,0,81,81,0.0,M2019-10-27D,Race(6),,
9,0,0,0,0,0,0,0,0,0,0,0,0,0,0,0,0,81,81,0.0,M2019-10-27D,Race(6),,
10,0,0,0,0,1,0,1,2,1,0,1,2,2,0,2,4,21,21,0.0,M2019-10-27D,Race(6),,
10,0,0,0,0,1,0,1,2,1,0,1,2,2,0,2,4,21,21,0.0,M2019-10-27D,Race(6),,
11,3,7,14,24,3,3,16,22,5,5,6,16,11,15,36,62,4.2,4.4,0.0,M2019-10-27D,Race(6),,
11,3,7,14,24,3,3,16,22,5,5,6,16,11,15,36,62,4.2,4.4,0.0,M2019-10-27D,Race(6),,
12,0,0,0,0,0,1,0,1,0,0,0,0,0,1,0,1,13,13,0.0,M2019-10-27D,Race(6),,
12,0,0,0,0,0,1,0,1,0,0,0,0,0,1,0,1,13,13,0.0,M2019-10-27D,Race(6),,
1,3,3,4,10,0,3,2,5,0,1,1,2,3,7,7,17,8,8,0.0,M2019-10-27D,Race(7),,
1,3,3,4,10,0,3,2,5,0,1,1,2,3,7,7,17,8,8,0.0,M2019-10-27D,Race(7),,
2,8,11,5,24,22,4,3,29,20,3,2,25,50,18,10,78,4,4,0.0,M2019-10-27D,Race(7),,
2,8,11,5,24,22,4,3,29,20,3,2,25,50,18,10,78,4,4,3.0,M2019-10-27D,Race(7),,
3,2,3,0,5,1,4,14,19,3,3,4,10,6,10,18,34,12,12,0.0,M2019-10-27D,Race(7),,
3,2,3,0,5,1,4,14,19,3,3,4,10,6,10,18,34,12,12,1.0,M2019-10-27D,Race(7),,
4,0,2,3,5,0,0,3,3,0,1,5,6,0,3,11,14,10,10,0.0,M2019-10-27D,Race(7),,
4,0,2,3,5,0,0,3,3,0,1,5,6,0,3,11,14,10,10,0.0,M2019-10-27D,Race(7),,
5,0,0,0,0,0,0,0,0,0,0,0,0,0,0,0,0,23,26,0.0,M2019-10-27D,Race(7),,
5,0,0,0,0,0,0,0,0,0,0,0,0,0,0,0,0,23,26,0.0,M2019-10-27D,Race(7),,
6,2,2,3,7,0,0,0,0,0,2,2,4,2,4,5,11,14,14,2.0,M2019-10-27D,Race(7),,
6,2,2,3,7,0,0,0,0,0,2,2,4,2,4,5,11,14,14,0.0,M2019-10-27D,Race(7),,
7,3,4,3,10,0,0,2,2,0,1,3,4,3,5,8,16,8,8,0.0,M2019-10-27D,Race(7),,
7,3,4,3,10,0,0,2,2,0,1,3,4,3,5,8,16,8,8,0.0,M2019-10-27D,Race(7),,
8,0,0,0,0,0,0,0,0,0,1,0,1,0,1,0,1,41,41,0.0,M2019-10-27D,Race(7),,
8,0,0,0,0,0,0,0,0,0,1,0,1,0,1,0,1,41,41,0.0,M2019-10-27D,Race(7),,
9,0,0,0,0,0,0,1,1,0,0,1,1,0,0,2,2,61,61,0.0,M2019-10-27D,Race(7),,
9,0,0,0,0,0,0,1,1,0,0,1,1,0,0,2,2,61,61,0.0,M2019-10-27D,Race(7),,
10,2,0,3,5,1,0,0,1,1,0,2,3,4,0,5,9,12,12,0.0,M2019-10-27D,Race(7),,
10,2,0,3,5,1,0,0,1,1,0,2,3,4,0,5,9,12,12,0.0,M2019-10-27D,Race(7),,
11,10,5,9,24,6,19,5,30,2,14,6,22,18,38,20,76,2.9,2.9,0.0,M2019-10-27D,Race(7),,
11,10,5,9,24,6,19,5,30,2,14,6,22,18,38,20,76,2.9,2.9,0.0,M2019-10-27D,Race(7),,
12,0,0,0,0,0,0,0,0,0,0,0,0,0,0,0,0,61,61,0.0,M2019-10-27D,Race(7),,
12,0,0,0,0,0,0,0,0,0,0,0,0,0,0,0,0,61,61,0.0,M2019-10-27D,Race(7),,
1,2,0,5,7,7,15,5,27,9,7,6,22,18,22,16,56,7.5,7.5,3.0,M2019-10-27D,Race(8),,
1,2,0,5,7,7,15,5,27,9,7,6,22,18,22,16,56,7.5,7.5,0.0,M2019-10-27D,Race(8),,
2,0,0,3,3,0,1,1,2,0,2,2,4,0,3,6,9,21,21,0.0,M2019-10-27D,Race(8),,
2,0,0,3,3,0,1,1,2,0,2,2,4,0,3,6,9,21,21,0.0,M2019-10-27D,Race(8),,
3,7,12,2,21,1,5,15,21,2,3,6,11,10,20,23,53,5,5,2.0,M2019-10-27D,Race(8),,
3,7,12,2,21,1,5,15,21,2,3,6,11,10,20,23,53,5,5,0.0,M2019-10-27D,Race(8),,
4,0,0,0,0,0,0,0,0,0,0,0,0,0,0,0,0,18,18,0.0,M2019-10-27D,Race(8),,
4,0,0,0,0,0,0,0,0,0,0,0,0,0,0,0,0,18,18,1.0,M2019-10-27D,Race(8),,
5,0,5,0,5,1,1,2,4,3,3,2,8,4,9,4,17,15,15,0.0,M2019-10-27D,Race(8),,
5,0,5,0,5,1,1,2,4,3,3,2,8,4,9,4,17,15,15,0.0,M2019-10-27D,Race(8),,
6,0,0,0,0,0,0,0,0,1,0,0,1,1,0,0,1,41,41,0.0,M2019-10-27D,Race(8),,
6,0,0,0,0,0,0,0,0,1,0,0,1,1,0,0,1,41,41,0.0,M2019-10-27D,Race(8),,
7,0,0,0,0,0,0,0,0,0,0,0,0,0,0,0,0,51,51,0.0,M2019-10-27D,Race(8),,
7,0,0,0,0,0,0,0,0,0,0,0,0,0,0,0,0,51,51,0.0,M2019-10-27D,Race(8),,
8,16,9,3,28,19,5,4,28,9,7,6,22,44,21,13,78,2.5,2.5,0.0,M2019-10-27D,Race(8),,
8,16,9,3,28,19,5,4,28,9,7,6,22,44,21,13,78,2.5,2.5,0.0,M2019-10-27D,Race(8),,
9,0,0,0,0,0,0,0,0,0,0,0,0,0,0,0,0,71,67,0.0,M2019-10-27D,Race(8),,
9,0,0,0,0,0,0,0,0,0,0,0,0,0,0,0,0,71,67,0.0,M2019-10-27D,Race(8),,
10,0,0,3,3,0,0,2,2,0,1,0,1,0,1,5,6,41,41,0.0,M2019-10-27D,Race(8),,
10,0,0,3,3,0,0,2,2,0,1,0,1,0,1,5,6,41,41,0.0,M2019-10-27D,Race(8),,
11,0,4,5,9,0,2,0,2,0,2,1,3,0,8,6,14,13,13,0.0,M2019-10-27D,Race(8),,
11,0,4,5,9,0,2,0,2,0,2,1,3,0,8,6,14,13,13,0.0,M2019-10-27D,Race(8),,
12,2,0,5,7,0,1,0,1,0,1,0,1,2,2,5,9,11,11,0.0,M2019-10-27D,Race(8),,
12,2,0,5,7,0,1,0,1,0,1,0,1,2,2,5,9,11,11,0.0,M2019-10-27D,Race(8),,
13,3,0,4,7,2,0,1,3,2,0,3,5,7,0,8,15,10,10,0.0,M2019-10-27D,Race(8),,
13,3,0,4,7,2,0,1,3,2,0,3,5,7,0,8,15,10,10,0.0,M2019-10-27D,Race(8),,
14,0,0,0,0,0,0,0,0,0,0,0,0,0,0,0,0,41,41,0.0,M2019-10-27D,Race(8),,
14,0,0,0,0,0,0,0,0,0,0,0,0,0,0,0,0,41,41,0.0,M2019-10-27D,Race(8),,
1,5,8,4,17,7,14,5,26,8,7,3,18,20,29,12,61,8,8,3.0,M2019-10-27D,Race(9),,
1,5,8,4,17,7,14,5,26,8,7,3,18,20,29,12,61,8,8,1.0,M2019-10-27D,Race(9),,
2,7,0,2,9,2,1,1,4,4,2,0,6,13,3,3,19,5.5,5.5,0.0,M2019-10-27D,Race(9),,
2,7,0,2,9,2,1,1,4,4,2,0,6,13,3,3,19,5.5,5.5,0.0,M2019-10-27D,Race(9),,
3,0,6,7,13,18,4,3,25,7,6,1,14,25,16,11,52,4.8,4.8,0.0,M2019-10-27D,Race(9),,
3,0,6,7,13,18,4,3,25,7,6,1,14,25,16,11,52,4.8,4.8,0.0,M2019-10-27D,Race(9),,
4,0,0,0,0,0,2,2,4,2,3,3,8,2,5,5,12,12,12,0.0,M2019-10-27D,Race(9),,
4,0,0,0,0,0,2,2,4,2,3,3,8,2,5,5,12,12,12,2.0,M2019-10-27D,Race(9),,
5,0,0,0,0,0,1,0,1,0,1,0,1,0,2,0,2,19,19,0.0,M2019-10-27D,Race(9),,
5,0,0,0,0,0,1,0,1,0,1,0,1,0,2,0,2,19,19,0.0,M2019-10-27D,Race(9),,
6,0,0,0,0,0,0,0,0,0,0,0,0,0,0,0,0,15,15,0.0,M2019-10-27D,Race(9),,
6,0,0,0,0,0,0,0,0,0,0,0,0,0,0,0,0,15,15,0.0,M2019-10-27D,Race(9),,
7,0,5,0,5,0,1,2,3,0,1,4,5,0,7,6,13,15,15,0.0,M2019-10-27D,Race(9),,
7,0,5,0,5,0,1,2,3,0,1,4,5,0,7,6,13,15,15,0.0,M2019-10-27D,Race(9),,
8,18,0,3,21,2,2,4,8,2,2,10,14,22,4,17,43,5,5,0.0,M2019-10-27D,Race(9),,
8,18,0,3,21,2,2,4,8,2,2,10,14,22,4,17,43,5,5,0.0,M2019-10-27D,Race(9),,
9,0,2,8,10,0,1,0,1,0,0,0,0,0,3,8,11,11,11,0.0,M2019-10-27D,Race(9),,
9,0,2,8,10,0,1,0,1,0,0,0,0,0,3,8,11,11,11,0.0,M2019-10-27D,Race(9),,
10,0,9,6,15,1,4,13,18,3,4,4,11,4,17,23,44,6,6,0.0,M2019-10-27D,Race(9),,
10,0,9,6,15,1,4,13,18,3,4,4,11,4,17,23,44,6,6,0.0,M2019-10-27D,Race(9),,
11,0,0,0,0,0,0,0,0,0,0,1,1,0,0,1,1,81,81,0.0,M2019-10-27D,Race(9),,
11,0,0,0,0,0,0,0,0,0,0,1,1,0,0,1,1,81,81,0.0,M2019-10-27D,Race(9),,
12,0,0,0,0,0,0,0,0,0,0,0,0,0,0,0,0,41,41,0.0,M2019-10-27D,Race(9),,
12,0,0,0,0,0,0,0,0,0,0,0,0,0,0,0,0,41,41,0.0,M2019-10-27D,Race(9),,
1,11,2,0,13,2,10,3,15,1,4,9,14,14,16,12,42,4.8,4.8,0.0,M2019-10-30D,Race(1),,
1,11,2,0,13,2,10,3,15,1,4,9,14,14,16,12,42,4.8,4.8,0.0,M2019-10-30D,Race(1),,
2,5,12,2,19,5,3,5,13,4,4,1,9,14,19,8,41,5,5,0.0,M2019-10-30D,Race(1),,
2,5,12,2,19,5,3,5,13,4,4,1,9,14,19,8,41,5,5,0.0,M2019-10-30D,Race(1),,
3,0,3,3,6,7,4,3,14,7,2,5,14,14,9,11,34,9,9,3.0,M2019-10-30D,Race(1),,
3,0,3,3,6,7,4,3,14,7,2,5,14,14,9,11,34,9,9,0.0,M2019-10-30D,Race(1),,
4,7,2,5,14,1,1,8,10,1,1,0,2,9,4,13,26,5.5,5.5,0.0,M2019-10-30D,Race(1),,
4,7,2,5,14,1,1,8,10,1,1,0,2,9,4,13,26,5.5,5.5,2.0,M2019-10-30D,Race(1),,
5,3,7,6,16,6,8,5,19,10,6,2,18,19,21,13,53,6.5,6.5,1.0,M2019-10-30D,Race(1),,
5,3,7,6,16,6,8,5,19,10,6,2,18,19,21,13,53,6.5,6.5,0.0,M2019-10-30D,Race(1),,
6,0,2,0,2,0,0,0,0,0,0,0,0,0,2,0,2,26,26,0.0,M2019-10-30D,Race(1),,
6,0,2,0,2,0,0,0,0,0,0,0,0,0,2,0,2,26,26,0.0,M2019-10-30D,Race(1),,
7,0,0,0,0,8,0,0,8,0,0,1,1,8,0,1,9,9.5,9.5,0.0,M2019-10-30D,Race(1),,
7,0,0,0,0,8,0,0,8,0,0,1,1,8,0,1,9,9.5,9.5,0.0,M2019-10-30D,Race(1),,
8,2,2,4,8,1,4,6,11,2,8,6,16,5,14,16,35,8,8,0.0,M2019-10-30D,Race(1),,
8,2,2,4,8,1,4,6,11,2,8,6,16,5,14,16,35,8,8,0.0,M2019-10-30D,Race(1),,
9,2,0,10,12,0,0,0,0,1,1,2,4,3,1,12,16,6.5,6.5,0.0,M2019-10-30D,Race(1),,
9,2,0,10,12,0,0,0,0,1,1,2,4,3,1,12,16,6.5,6.5,0.0,M2019-10-30D,Race(1),,
1,5,4,3,12,2,3,8,13,1,3,4,8,8,10,15,33,7,7,0.0,M2019-10-30D,Race(2),,
1,5,4,3,12,2,3,8,13,1,3,4,8,8,10,15,33,7,7,0.0,M2019-10-30D,Race(2),,
2,4,0,5,9,8,1,1,10,2,0,1,3,14,1,7,22,11,11,3.0,M2019-10-30D,Race(2),,
2,4,0,5,9,8,1,1,10,2,0,1,3,14,1,7,22,11,11,1.0,M2019-10-30D,Race(2),,
3,3,3,11,17,2,2,0,4,1,2,1,4,6,7,12,25,7.5,7.5,0.0,M2019-10-30D,Race(2),,
3,3,3,11,17,2,2,0,4,1,2,1,4,6,7,12,25,7.5,7.5,0.0,M2019-10-30D,Race(2),,
4,4,8,3,15,13,2,3,18,10,5,6,21,27,15,12,54,4.2,4.2,0.0,M2019-10-30D,Race(2),,
4,4,8,3,15,13,2,3,18,10,5,6,21,27,15,12,54,4.2,4.2,0.0,M2019-10-30D,Race(2),,
5,0,0,0,0,0,1,0,1,1,0,0,1,1,1,0,2,41,41,2.0,M2019-10-30D,Race(2),,
5,0,0,0,0,0,1,0,1,1,0,0,1,1,1,0,2,41,41,0.0,M2019-10-30D,Race(2),,
6,3,5,0,8,0,4,1,5,0,6,0,6,3,15,1,19,8.5,8.5,0.0,M2019-10-30D,Race(2),,
6,3,5,0,8,0,4,1,5,0,6,0,6,3,15,1,19,8.5,8.5,0.0,M2019-10-30D,Race(2),,
7,0,0,2,2,0,0,0,0,1,1,1,3,1,1,3,5,51,51,0.0,M2019-10-30D,Race(2),,
7,0,0,2,2,0,0,0,0,1,1,1,3,1,1,3,5,51,51,0.0,M2019-10-30D,Race(2),,
8,8,8,0,16,4,8,5,17,7,4,8,19,19,20,13,52,5.5,5.5,0.0,M2019-10-30D,Race(2),,
8,8,8,0,16,4,8,5,17,7,4,8,19,19,20,13,52,5.5,5.5,0.0,M2019-10-30D,Race(2),,
9,0,0,0,0,0,8,1,9,0,1,3,4,0,9,4,13,17,17,0.0,M2019-10-30D,Race(2),,
9,0,0,0,0,0,8,1,9,0,1,3,4,0,9,4,13,17,17,0.0,M2019-10-30D,Race(2),,
10,0,0,3,3,1,1,3,5,2,4,2,8,3,5,8,16,11,11,0.0,M2019-10-30D,Race(2),,
10,0,0,3,3,1,1,3,5,2,4,2,8,3,5,8,16,11,11,0.0,M2019-10-30D,Race(2),,
11,0,0,0,0,0,0,0,0,0,0,0,0,0,0,0,0,81,81,0.0,M2019-10-30D,Race(2),,
11,0,0,0,0,0,0,0,0,0,0,0,0,0,0,0,0,81,81,0.0,M2019-10-30D,Race(2),,
12,3,2,3,8,0,0,8,8,1,0,0,1,4,2,11,17,6,6,0.0,M2019-10-30D,Race(2),,
12,3,2,3,8,0,0,8,8,1,0,0,1,4,2,11,17,6,6,0.0,M2019-10-30D,Race(2),,
1,4,3,7,14,9,4,2,15,0,8,3,11,13,15,12,40,6.5,6.5,1.0,M2019-10-30D,Race(3),,
1,4,3,7,14,9,4,2,15,0,8,3,11,13,15,12,40,6.5,6.5,0.0,M2019-10-30D,Race(3),,
2,0,0,0,0,0,0,2,2,0,1,2,3,0,1,4,5,18,18,0.0,M2019-10-30D,Race(3),,
2,0,0,0,0,0,0,2,2,0,1,2,3,0,1,4,5,18,18,2.0,M2019-10-30D,Race(3),,
3,3,6,3,12,3,3,6,12,4,4,4,12,10,13,13,36,4.4,4.4,0.0,M2019-10-30D,Race(3),,
3,3,6,3,12,3,3,6,12,4,4,4,12,10,13,13,36,4.4,4.4,0.0,M2019-10-30D,Race(3),,
4,4,6,8,18,3,0,2,5,5,1,3,9,12,7,13,32,5,5,0.0,M2019-10-30D,Race(3),,
4,4,6,8,18,3,0,2,5,5,1,3,9,12,7,13,32,5,5,3.0,M2019-10-30D,Race(3),,
5,8,2,3,13,3,4,4,11,1,1,7,9,12,7,14,33,6,6,0.0,M2019-10-30D,Race(3),,
5,8,2,3,13,3,4,4,11,1,1,7,9,12,7,14,33,6,6,0.0,M2019-10-30D,Race(3),,
6,0,0,0,0,0,4,2,6,0,5,2,7,0,9,4,13,19,19,0.0,M2019-10-30D,Race(3),,
6,0,0,0,0,0,4,2,6,0,5,2,7,0,9,4,13,19,19,0.0,M2019-10-30D,Race(3),,
7,0,0,0,0,0,0,0,0,0,0,0,0,0,0,0,0,101,101,0.0,M2019-10-30D,Race(3),,
7,0,0,0,0,0,0,0,0,0,0,0,0,0,0,0,0,101,101,0.0,M2019-10-30D,Race(3),,
8,9,7,9,25,12,5,3,20,14,4,3,21,35,16,15,66,3.8,3.8,0.0,M2019-10-30D,Race(3),,
8,9,7,9,25,12,5,3,20,14,4,3,21,35,16,15,66,3.8,3.8,0.0,M2019-10-30D,Race(3),,
9,0,0,0,0,0,8,0,8,0,0,0,0,0,8,0,8,101,101,0.0,M2019-10-30D,Race(3),,
9,0,0,0,0,0,8,0,8,0,0,0,0,0,8,0,8,101,101,0.0,M2019-10-30D,Race(3),,
10,0,0,0,0,0,0,0,0,0,0,0,0,0,0,0,0,16,16,0.0,M2019-10-30D,Race(3),,
10,0,0,0,0,0,0,0,0,0,0,0,0,0,0,0,0,16,16,0.0,M2019-10-30D,Race(3),,
11,0,0,0,0,0,0,0,0,1,0,0,1,1,0,0,1,0,0,0.0,M2019-10-30D,Race(3),,
11,0,0,0,0,0,0,0,0,1,0,0,1,1,0,0,1,0,0,0.0,M2019-10-30D,Race(3),,
12,2,6,0,8,0,2,9,11,1,2,2,5,3,10,11,24,13,13,0.0,M2019-10-30D,Race(3),,
12,2,6,0,8,0,2,9,11,1,2,2,5,3,10,11,24,13,13,0.0,M2019-10-30D,Race(3),,
1,0,2,2,4,8,2,1,11,1,0,3,4,9,4,6,19,21,21,0.0,M2019-10-30D,Race(4),,
1,0,2,2,4,8,2,1,11,1,0,3,4,9,4,6,19,21,21,2.0,M2019-10-30D,Race(4),,
2,12,2,3,17,3,5,4,12,4,4,4,12,19,11,11,41,3.8,3.8,0.0,M2019-10-30D,Race(4),,
2,12,2,3,17,3,5,4,12,4,4,4,12,19,11,11,41,3.8,3.8,0.0,M2019-10-30D,Race(4),,
3,0,0,0,0,0,0,0,0,0,1,0,1,0,1,0,1,41,41,0.0,M2019-10-30D,Race(4),,
3,0,0,0,0,0,0,0,0,0,1,0,1,0,1,0,1,41,41,0.0,M2019-10-30D,Race(4),,
4,0,0,2,2,0,3,8,11,0,4,0,4,0,7,10,17,10,10,1.0,M2019-10-30D,Race(4),,
4,0,0,2,2,0,3,8,11,0,4,0,4,0,7,10,17,10,10,0.0,M2019-10-30D,Race(4),,
5,0,0,0,0,0,0,0,0,1,0,0,1,1,0,0,1,126,126,3.0,M2019-10-30D,Race(4),,
5,0,0,0,0,0,0,0,0,1,0,0,1,1,0,0,1,126,126,0.0,M2019-10-30D,Race(4),,
6,0,0,0,0,0,0,0,0,0,0,1,1,0,0,1,1,13,13,0.0,M2019-10-30D,Race(4),,
6,0,0,0,0,0,0,0,0,0,0,1,1,0,0,1,1,13,13,0.0,M2019-10-30D,Race(4),,
7,3,3,8,14,7,4,8,19,10,6,4,20,20,13,20,53,7,7,0.0,M2019-10-30D,Race(4),,
7,3,3,8,14,7,4,8,19,10,6,4,20,20,13,20,53,7,7,0.0,M2019-10-30D,Race(4),,
8,3,0,2,5,1,1,3,5,1,1,6,8,5,2,11,18,8,8,0.0,M2019-10-30D,Race(4),,
8,3,0,2,5,1,1,3,5,1,1,6,8,5,2,11,18,8,8,0.0,M2019-10-30D,Race(4),,
9,0,3,0,3,0,8,0,8,0,0,0,0,0,11,0,11,26,26,0.0,M2019-10-30D,Race(4),,
9,0,3,0,3,0,8,0,8,0,0,0,0,0,11,0,11,26,26,0.0,M2019-10-30D,Race(4),,
10,10,15,5,30,10,6,4,20,7,9,5,21,27,30,14,71,3.2,3.2,0.0,M2019-10-30D,Race(4),,
10,10,15,5,30,10,6,4,20,7,9,5,21,27,30,14,71,3.2,3.2,0.0,M2019-10-30D,Race(4),,
11,0,0,0,0,0,0,0,0,0,0,0,0,0,0,0,0,61,61,0.0,M2019-10-30D,Race(4),,
11,0,0,0,0,0,0,0,0,0,0,0,0,0,0,0,0,61,61,0.0,M2019-10-30D,Race(4),,
12,2,5,8,15,1,1,2,4,2,1,3,6,5,7,13,25,8,8,0.0,M2019-10-30D,Race(4),,
12,2,5,8,15,1,1,2,4,2,1,3,6,5,7,13,25,8,8,0.0,M2019-10-30D,Race(4),,
1,0,3,0,3,8,3,7,18,5,3,5,13,13,9,12,34,13,13,0.0,M2019-10-30D,Race(5),,
1,0,3,0,3,8,3,7,18,5,3,5,13,13,9,12,34,13,13,3.0,M2019-10-30D,Race(5),,
2,0,2,7,9,0,0,10,10,0,0,3,3,0,2,20,22,17,17,2.0,M2019-10-30D,Race(5),,
2,0,2,7,9,0,0,10,10,0,0,3,3,0,2,20,22,17,17,0.0,M2019-10-30D,Race(5),,
3,5,9,5,19,1,2,5,8,0,2,5,7,6,13,15,34,5,5,1.0,M2019-10-30D,Race(5),,
3,5,9,5,19,1,2,5,8,0,2,5,7,6,13,15,34,5,5,0.0,M2019-10-30D,Race(5),,
4,25,0,2,27,18,4,1,23,15,7,3,25,58,11,6,75,2.6,2.6,0.0,M2019-10-30D,Race(5),,
4,25,0,2,27,18,4,1,23,15,7,3,25,58,11,6,75,2.6,2.6,0.0,M2019-10-30D,Race(5),,
5,0,10,5,15,3,12,4,19,6,10,5,21,9,32,14,55,6,6,0.0,M2019-10-30D,Race(5),,
5,0,10,5,15,3,12,4,19,6,10,5,21,9,32,14,55,6,6,0.0,M2019-10-30D,Race(5),,
6,0,0,0,0,0,0,0,0,0,0,0,0,0,0,0,0,41,41,0.0,M2019-10-30D,Race(5),,
6,0,0,0,0,0,0,0,0,0,0,0,0,0,0,0,0,41,41,0.0,M2019-10-30D,Race(5),,
7,0,0,0,0,0,0,0,0,0,1,2,3,0,1,2,3,9,9,0.0,M2019-10-30D,Race(5),,
7,0,0,0,0,0,0,0,0,0,1,2,3,0,1,2,3,9,9,0.0,M2019-10-30D,Race(5),,
8,0,0,0,0,0,0,0,0,0,0,0,0,0,0,0,0,81,81,0.0,M2019-10-30D,Race(5),,
8,0,0,0,0,0,0,0,0,0,0,0,0,0,0,0,0,81,81,0.0,M2019-10-30D,Race(5),,
9,0,0,0,0,0,0,0,0,0,0,0,0,0,0,0,0,31,31,0.0,M2019-10-30D,Race(5),,
9,0,0,0,0,0,0,0,0,0,0,0,0,0,0,0,0,31,31,0.0,M2019-10-30D,Race(5),,
10,0,0,0,0,0,0,0,0,0,0,0,0,0,0,0,0,31,31,0.0,M2019-10-30D,Race(5),,
10,0,0,0,0,0,0,0,0,0,0,0,0,0,0,0,0,31,31,0.0,M2019-10-30D,Race(5),,
11,0,6,11,17,0,9,3,12,0,3,3,6,0,18,17,35,6,6,0.0,M2019-10-30D,Race(5),,
11,0,6,11,17,0,9,3,12,0,3,3,6,0,18,17,35,6,6,0.0,M2019-10-30D,Race(5),,
12,0,0,0,0,0,0,0,0,0,0,0,0,0,0,0,0,81,81,0.0,M2019-10-30D,Race(5),,
12,0,0,0,0,0,0,0,0,0,0,0,0,0,0,0,0,81,81,0.0,M2019-10-30D,Race(5),,
1,7,7,2,16,6,8,7,21,7,10,7,24,20,25,16,61,4.6,4.6,0.0,M2019-10-30D,Race(6),,
1,7,7,2,16,6,8,7,21,7,10,7,24,20,25,16,61,4.6,4.6,2.0,M2019-10-30D,Race(6),,
2,7,3,5,15,0,0,1,1,1,0,3,4,8,3,9,20,17,17,0.0,M2019-10-30D,Race(6),,
2,7,3,5,15,0,0,1,1,1,0,3,4,8,3,9,20,17,17,0.0,M2019-10-30D,Race(6),,
3,0,0,0,0,0,0,0,0,0,0,1,1,0,0,1,1,31,31,0.0,M2019-10-30D,Race(6),,
3,0,0,0,0,0,0,0,0,0,0,1,1,0,0,1,1,31,31,0.0,M2019-10-30D,Race(6),,
4,2,5,9,16,1,5,9,15,4,4,7,15,7,14,25,46,4,4,3.0,M2019-10-30D,Race(6),,
4,2,5,9,16,1,5,9,15,4,4,7,15,7,14,25,46,4,4,0.0,M2019-10-30D,Race(6),,
5,0,2,3,5,0,8,1,9,1,1,2,4,1,11,6,18,13,13,0.0,M2019-10-30D,Race(6),,
5,0,2,3,5,0,8,1,9,1,1,2,4,1,11,6,18,13,13,0.0,M2019-10-30D,Race(6),,
6,0,3,0,3,0,0,0,0,0,0,0,0,0,3,0,3,26,26,0.0,M2019-10-30D,Race(6),,
6,0,3,0,3,0,0,0,0,0,0,0,0,0,3,0,3,26,26,1.0,M2019-10-30D,Race(6),,
7,14,5,8,27,15,6,2,23,13,9,2,24,42,20,12,74,3.2,3.2,0.0,M2019-10-30D,Race(6),,
7,14,5,8,27,15,6,2,23,13,9,2,24,42,20,12,74,3.2,3.2,0.0,M2019-10-30D,Race(6),,
8,0,3,0,3,0,0,0,0,0,0,0,0,0,3,0,3,13,13,0.0,M2019-10-30D,Race(6),,
8,0,3,0,3,0,0,0,0,0,0,0,0,0,3,0,3,13,13,0.0,M2019-10-30D,Race(6),,
9,0,0,0,0,0,0,8,8,0,0,0,0,0,0,8,8,26,26,0.0,M2019-10-30D,Race(6),,
9,0,0,0,0,0,0,8,8,0,0,0,0,0,0,8,8,26,26,0.0,M2019-10-30D,Race(6),,
10,0,0,0,0,0,0,0,0,0,0,0,0,0,0,0,0,41,41,0.0,M2019-10-30D,Race(6),,
10,0,0,0,0,0,0,0,0,0,0,0,0,0,0,0,0,41,41,0.0,M2019-10-30D,Race(6),,
11,0,0,3,3,0,0,0,0,0,0,1,1,0,0,4,4,41,41,0.0,M2019-10-30D,Race(6),,
11,0,0,3,3,0,0,0,0,0,0,1,1,0,0,4,4,41,41,0.0,M2019-10-30D,Race(6),,
12,0,2,0,2,8,3,2,13,0,2,3,5,8,7,5,20,8,8,0.0,M2019-10-30D,Race(6),,
12,0,2,0,2,8,3,2,13,0,2,3,5,8,7,5,20,8,8,0.0,M2019-10-30D,Race(6),,
1,8,14,6,28,14,6,1,21,11,6,4,21,33,26,11,70,4,4,0.0,M2019-10-30D,Race(7),,
1,8,14,6,28,14,6,1,21,11,6,4,21,33,26,11,70,4,4,0.0,M2019-10-30D,Race(7),,
2,3,2,5,10,1,0,8,9,5,2,5,12,9,4,18,31,7.5,7.5,0.0,M2019-10-30D,Race(7),,
2,3,2,5,10,1,0,8,9,5,2,5,12,9,4,18,31,7.5,7.5,0.0,M2019-10-30D,Race(7),,
3,0,0,0,0,0,2,1,3,2,2,2,6,2,4,3,9,26,26,1.0,M2019-10-30D,Race(7),,
3,0,0,0,0,0,2,1,3,2,2,2,6,2,4,3,9,26,26,0.0,M2019-10-30D,Race(7),,
4,0,0,3,3,0,8,1,9,1,1,1,3,1,9,5,15,9,9,0.0,M2019-10-30D,Race(7),,
4,0,0,3,3,0,8,1,9,1,1,1,3,1,9,5,15,9,9,3.0,M2019-10-30D,Race(7),,
5,6,0,3,9,1,0,4,5,4,2,2,8,11,2,9,22,13,13,2.0,M2019-10-30D,Race(7),,
5,6,0,3,9,1,0,4,5,4,2,2,8,11,2,9,22,13,13,0.0,M2019-10-30D,Race(7),,
6,0,0,0,0,0,0,0,0,0,0,0,0,0,0,0,0,14,14,0.0,M2019-10-30D,Race(7),,
6,0,0,0,0,0,0,0,0,0,0,0,0,0,0,0,0,14,14,0.0,M2019-10-30D,Race(7),,
7,0,4,2,6,0,0,1,1,0,0,0,0,0,4,3,7,26,26,0.0,M2019-10-30D,Race(7),,
7,0,4,2,6,0,0,1,1,0,0,0,0,0,4,3,7,26,26,0.0,M2019-10-30D,Race(7),,
8,3,0,0,3,1,1,1,3,0,1,4,5,4,2,5,11,8,8,0.0,M2019-10-30D,Race(7),,
8,3,0,0,3,1,1,1,3,0,1,4,5,4,2,5,11,8,8,0.0,M2019-10-30D,Race(7),,
9,10,8,8,26,5,12,4,21,3,12,5,20,18,32,17,67,3.8,3.8,0.0,M2019-10-30D,Race(7),,
9,10,8,8,26,5,12,4,21,3,12,5,20,18,32,17,67,3.8,3.8,0.0,M2019-10-30D,Race(7),,
10,0,0,3,3,0,0,1,1,0,0,2,2,0,0,6,6,13,13,0.0,M2019-10-30D,Race(7),,
10,0,0,3,3,0,0,1,1,0,0,2,2,0,0,6,6,13,13,0.0,M2019-10-30D,Race(7),,
11,0,2,0,2,0,0,8,8,0,0,1,1,0,2,9,11,14,14,0.0,M2019-10-30D,Race(7),,
11,0,2,0,2,0,0,8,8,0,0,1,1,0,2,9,11,14,14,0.0,M2019-10-30D,Race(7),,
12,0,0,0,0,8,0,0,8,0,0,0,0,8,0,0,8,51,51,0.0,M2019-10-30D,Race(7),,
12,0,0,0,0,8,0,0,8,0,0,0,0,8,0,0,8,51,51,0.0,M2019-10-30D,Race(7),,
1,16,5,7,28,15,4,3,22,17,1,5,23,48,10,15,73,3,3,2.0,M2019-10-30D,Race(8),,
1,16,5,7,28,15,4,3,22,17,1,5,23,48,10,15,73,3,3,0.0,M2019-10-30D,Race(8),,
2,3,5,5,13,8,2,1,11,1,1,4,6,12,8,10,30,14,14,0.0,M2019-10-30D,Race(8),,
2,3,5,5,13,8,2,1,11,1,1,4,6,12,8,10,30,14,14,0.0,M2019-10-30D,Race(8),,
3,0,2,3,5,0,6,4,10,1,3,1,5,1,11,8,20,11,11,0.0,M2019-10-30D,Race(8),,
3,0,2,3,5,0,6,4,10,1,3,1,5,1,11,8,20,11,11,0.0,M2019-10-30D,Race(8),,
4,0,0,0,0,0,1,2,3,1,1,2,4,1,2,4,7,18,18,0.0,M2019-10-30D,Race(8),,
4,0,0,0,0,0,1,2,3,1,1,2,4,1,2,4,7,18,18,0.0,M2019-10-30D,Race(8),,
5,2,5,5,12,2,2,0,4,1,3,1,5,5,10,6,21,8,8,0.0,M2019-10-30D,Race(8),,
5,2,5,5,12,2,2,0,4,1,3,1,5,5,10,6,21,8,8,3.0,M2019-10-30D,Race(8),,
6,4,3,3,10,1,8,4,13,1,3,4,8,6,14,11,31,12,12,1.0,M2019-10-30D,Race(8),,
6,4,3,3,10,1,8,4,13,1,3,4,8,6,14,11,31,12,12,0.0,M2019-10-30D,Race(8),,
7,5,10,5,20,4,6,7,17,2,12,4,18,11,28,16,55,5.5,5.5,0.0,M2019-10-30D,Race(8),,
7,5,10,5,20,4,6,7,17,2,12,4,18,11,28,16,55,5.5,5.5,0.0,M2019-10-30D,Race(8),,
8,0,0,0,0,0,0,0,0,0,0,2,2,0,0,2,2,15,15,0.0,M2019-10-30D,Race(8),,
8,0,0,0,0,0,0,0,0,0,0,2,2,0,0,2,2,15,15,0.0,M2019-10-30D,Race(8),,
9,0,0,0,0,0,0,0,0,1,0,0,1,1,0,0,1,31,31,0.0,M2019-10-30D,Race(8),,
9,0,0,0,0,0,0,0,0,1,0,0,1,1,0,0,1,31,31,0.0,M2019-10-30D,Race(8),,
10,0,0,0,0,0,0,0,0,0,0,0,0,0,0,0,0,21,21,0.0,M2019-10-30D,Race(8),,
10,0,0,0,0,0,0,0,0,0,0,0,0,0,0,0,0,21,21,0.0,M2019-10-30D,Race(8),,
11,0,0,0,0,0,1,0,1,0,1,0,1,0,2,0,2,8,8,0.0,M2019-10-30D,Race(8),,
11,0,0,0,0,0,1,0,1,0,1,0,1,0,2,0,2,8,8,0.0,M2019-10-30D,Race(8),,
12,0,0,2,2,0,0,9,9,1,1,3,5,1,1,14,16,15,15,0.0,M2019-10-30D,Race(8),,
12,0,0,2,2,0,0,9,9,1,1,3,5,1,1,14,16,15,15,0.0,M2019-10-30D,Race(8),,
9,0,0,2,2,0,0,0,0,0,0,0,0,0,0,2,2,31,31,2.0,M2019-11-03D,Race(1),,
11,2,0,10,12,1,0,2,3,1,0,5,6,4,0,17,21,4.8,4.8,1.0,M2019-11-03D,Race(1),,
10,3,0,0,3,0,0,0,0,0,0,0,0,3,0,0,3,21,21,0.0,M2019-11-03D,Race(1),,
1,0,0,0,0,0,1,3,4,1,2,5,8,1,3,8,12,8,8,0.0,M2019-11-03D,Race(1),,
2,25,0,2,27,27,2,1,30,19,2,3,24,71,4,6,81,3.4,3.4,0.0,M2019-11-03D,Race(1),,
3,0,8,2,10,0,17,4,21,0,8,2,10,0,33,8,41,7,7,0.0,M2019-11-03D,Race(1),,
4,0,8,3,11,0,5,14,19,0,2,2,4,0,15,19,34,8,8,3.0,M2019-11-03D,Race(1),,
5,0,7,0,7,1,1,1,3,4,2,2,8,5,10,3,18,16,16,0.0,M2019-11-03D,Race(1),,
6,0,0,0,0,0,0,0,0,0,0,0,0,0,0,0,0,61,61,0.0,M2019-11-03D,Race(1),,
7,0,0,0,0,0,0,0,0,0,1,0,1,0,1,0,1,34,34,0.0,M2019-11-03D,Race(1),,
8,0,3,5,8,1,2,3,6,1,3,3,7,2,8,11,21,9,9,0.0,M2019-11-03D,Race(1),,
12,0,4,6,10,0,2,2,4,0,6,4,10,0,12,12,24,12,12,0.0,M2019-11-03D,Race(1),,
9,0,7,9,16,0,1,0,1,1,0,0,1,1,8,9,18,7,7,3.0,M2019-11-03D,Race(10),,
11,0,0,0,0,0,1,0,1,0,0,1,1,0,1,1,2,34,34,2.0,M2019-11-03D,Race(10),,
7,2,0,3,5,0,0,0,0,0,1,2,3,2,1,5,8,17,17,0.0,M2019-11-03D,Race(10),,
6,0,0,3,3,0,1,3,4,1,0,5,6,1,1,11,13,21,21,0.0,M2019-11-03D,Race(10),,
5,10,5,7,22,7,6,14,27,7,9,5,21,24,20,26,70,3.4,3.4,0.0,M2019-11-03D,Race(10),,
4,3,0,2,5,0,2,0,2,2,2,0,4,5,4,2,11,11,11,0.0,M2019-11-03D,Race(10),,
3,2,0,0,2,0,0,0,0,0,0,0,0,2,0,0,2,14,14,0.0,M2019-11-03D,Race(10),,
2,0,0,0,0,0,0,2,2,0,0,1,1,0,0,3,3,21,21,0.0,M2019-11-03D,Race(10),,
1,0,0,0,0,0,2,1,3,0,2,2,4,0,4,3,7,19,21,0.0,M2019-11-03D,Race(10),,
10,13,10,0,23,19,3,6,28,12,4,6,22,44,17,12,73,3.8,3.8,1.0,M2019-11-03D,Race(10),,
8,0,0,0,0,0,0,0,0,0,0,0,0,0,0,0,0,31,31,0.0,M2019-11-03D,Race(10),,
12,0,8,6,14,4,14,4,22,3,8,4,15,7,30,14,51,7,7,0.0,M2019-11-03D,Race(10),,
13,0,0,0,0,0,0,0,0,0,0,0,0,0,0,0,0,101,101,0.0,M2019-11-03D,Race(10),,
7,0,0,0,0,0,0,1,1,0,0,1,1,0,0,2,2,41,41,0.0,M2019-11-03D,Race(2),,
1,0,12,7,19,4,6,14,24,6,8,5,19,10,26,26,62,6,6,1.0,M2019-11-03D,Race(2),,
10,0,0,0,0,0,0,0,0,0,1,2,3,0,1,2,3,31,31,0.0,M2019-11-03D,Race(2),,
12,3,0,0,3,0,0,0,0,0,0,0,0,3,0,0,3,21,21,0.0,M2019-11-03D,Race(2),,
2,7,16,2,25,20,6,2,28,11,6,3,20,38,28,7,73,3.4,3.4,0.0,M2019-11-03D,Race(2),,
3,0,0,5,5,0,1,2,3,1,0,3,4,1,1,10,12,17,17,0.0,M2019-11-03D,Race(2),,
4,0,2,9,11,0,3,6,9,1,4,3,8,1,9,18,28,8,8,0.0,M2019-11-03D,Race(2),,
6,20,0,7,27,6,14,5,25,7,6,6,19,33,20,18,71,2.4,2.4,2.0,M2019-11-03D,Race(2),,
8,0,0,0,0,0,0,0,0,0,1,0,1,0,1,0,1,81,81,0.0,M2019-11-03D,Race(2),,
14,0,0,0,0,0,0,0,0,0,0,0,0,0,0,0,0,51,51,0.0,M2019-11-03D,Race(2),,
13,0,0,0,0,0,0,0,0,0,0,0,0,0,0,0,0,51,51,0.0,M2019-11-03D,Race(2),,
11,0,0,0,0,0,0,0,0,0,0,3,3,0,0,3,3,21,21,0.0,M2019-11-03D,Race(2),,
9,0,0,0,0,0,0,0,0,0,0,0,0,0,0,0,0,151,151,0.0,M2019-11-03D,Race(2),,
5,0,0,0,0,0,0,0,0,0,0,0,0,0,0,0,0,126,126,3.0,M2019-11-03D,Race(2),,
5,0,0,0,0,0,0,0,0,0,0,0,0,0,0,0,0,51,51,0.0,M2019-11-03D,Race(3),,
6,5,0,0,5,1,1,1,3,1,4,4,9,7,5,5,17,8.5,8.5,3.0,M2019-11-03D,Race(3),,
3,0,3,2,5,3,16,2,21,3,6,4,13,6,25,8,39,8.5,8.5,0.0,M2019-11-03D,Race(3),,
8,2,7,0,9,1,1,5,7,3,1,5,9,6,9,10,25,5,5,2.0,M2019-11-03D,Race(3),,
9,0,0,0,0,0,0,0,0,0,0,0,0,0,0,0,0,81,81,0.0,M2019-11-03D,Race(3),,
2,14,9,2,25,8,6,14,28,6,8,5,19,28,23,21,72,3.6,3.6,0.0,M2019-11-03D,Race(3),,
1,6,6,13,25,16,4,4,24,11,2,3,16,33,12,20,65,5,5,1.0,M2019-11-03D,Race(3),,
10,3,2,5,10,0,1,0,1,2,5,2,9,5,8,7,20,8.5,8.5,0.0,M2019-11-03D,Race(3),,
11,0,0,0,0,0,0,0,0,0,0,0,0,0,0,0,0,51,51,0.0,M2019-11-03D,Race(3),,
4,0,0,5,5,0,0,2,2,0,0,2,2,0,0,9,9,41,41,0.0,M2019-11-03D,Race(3),,
7,0,3,3,6,1,1,2,4,0,0,1,1,1,4,6,11,6.5,6.5,0.0,M2019-11-03D,Race(3),,
12,0,0,0,0,0,0,0,0,0,0,0,0,0,0,0,0,51,51,0.0,M2019-11-03D,Race(3),,
9,10,6,10,26,26,2,2,30,15,4,3,22,51,12,15,78,2.2,2.2,1.0,M2019-11-03D,Race(4),,
10,0,0,3,3,0,4,2,6,0,0,3,3,0,4,8,12,15,15,0.0,M2019-11-03D,Race(4),,
8,0,0,0,0,0,0,0,0,0,0,0,0,0,0,0,0,81,81,0.0,M2019-11-03D,Race(4),,
11,0,0,0,0,0,0,0,0,0,0,1,1,0,0,1,1,81,81,3.0,M2019-11-03D,Race(4),,
7,0,0,0,0,0,0,0,0,0,0,0,0,0,0,0,0,81,81,0.0,M2019-11-03D,Race(4),,
6,0,0,0,0,0,0,0,0,0,0,0,0,0,0,0,0,81,81,0.0,M2019-11-03D,Race(4),,
12,0,0,0,0,0,0,0,0,0,0,0,0,0,0,0,0,81,81,0.0,M2019-11-03D,Race(4),,
4,2,7,3,12,0,0,2,2,2,1,3,6,4,8,8,20,15,15,0.0,M2019-11-03D,Race(4),,
5,9,6,2,17,2,4,13,19,2,2,8,12,13,12,23,48,4.8,4.8,0.0,M2019-11-03D,Race(4),,
2,0,7,0,7,1,4,3,8,1,6,3,10,2,17,6,25,13,13,2.0,M2019-11-03D,Race(4),,
1,9,4,12,25,1,14,6,21,5,9,5,19,15,27,23,65,3.5,3.5,0.0,M2019-11-03D,Race(4),,
3,0,0,0,0,0,2,2,4,1,4,0,5,1,6,2,9,17,17,0.0,M2019-11-03D,Race(4),,
9,0,0,0,0,0,0,0,0,0,0,0,0,0,0,0,0,41,41,0.0,M2019-11-03D,Race(5),,
8,0,0,2,2,0,0,1,1,0,0,2,2,0,0,5,5,51,51,0.0,M2019-11-03D,Race(5),,
4,0,7,7,14,0,3,2,5,1,1,2,4,1,11,11,23,4.2,4.2,3.0,M2019-11-03D,Race(5),,
10,4,2,9,15,0,2,4,6,0,3,8,11,4,7,21,32,12,12,0.0,M2019-11-03D,Race(5),,
2,14,8,0,22,6,15,1,22,10,5,2,17,30,28,3,61,4,4,1.0,M2019-11-03D,Race(5),,
13,0,0,0,0,0,0,0,0,0,0,0,0,0,0,0,0,81,81,0.0,M2019-11-03D,Race(5),,
1,10,6,2,18,19,6,3,28,12,4,2,18,41,16,7,64,4,4,0.0,M2019-11-03D,Race(5),,
12,0,0,0,0,0,0,0,0,0,0,0,0,0,0,0,0,18,18,0.0,M2019-11-03D,Race(5),,
11,0,0,0,0,0,0,1,1,0,1,3,4,0,1,4,5,26,26,0.0,M2019-11-03D,Race(5),,
7,0,2,8,10,0,4,5,9,0,8,5,13,0,14,18,32,14,14,2.0,M2019-11-03D,Race(5),,
14,0,0,0,0,0,0,0,0,0,0,0,0,0,0,0,0,21,21,0.0,M2019-11-03D,Race(5),,
6,2,2,2,6,4,0,12,16,2,4,1,7,8,6,15,29,9,9,0.0,M2019-11-03D,Race(5),,
5,0,0,0,0,0,0,0,0,0,0,0,0,0,0,0,0,34,34,0.0,M2019-11-03D,Race(5),,
3,0,3,0,3,1,0,1,2,1,0,1,2,2,3,2,7,21,21,0.0,M2019-11-03D,Race(5),,
10,2,0,2,4,0,3,2,5,0,5,3,8,2,8,7,17,16,19,0.0,M2019-11-03D,Race(6),,
12,0,0,0,0,0,0,0,0,0,0,1,1,0,0,1,1,41,41,0.0,M2019-11-03D,Race(6),,
11,0,0,3,3,0,0,1,1,0,0,2,2,0,0,6,6,41,41,0.0,M2019-11-03D,Race(6),,
9,0,6,0,6,1,1,1,3,1,1,1,3,2,8,2,12,8,8,0.0,M2019-11-03D,Race(6),,
1,0,17,10,27,2,16,9,27,2,9,9,20,4,42,28,74,7,7,2.0,M2019-11-03D,Race(6),,
7,0,0,0,0,0,0,0,0,0,0,3,3,0,0,3,3,41,41,0.0,M2019-11-03D,Race(6),,
6,2,3,9,14,3,5,13,21,3,5,2,10,8,13,24,45,4.6,4.6,1.0,M2019-11-03D,Race(6),,
5,0,0,3,3,0,0,0,0,0,0,0,0,0,0,3,3,21,21,0.0,M2019-11-03D,Race(6),,
2,26,4,0,30,24,4,2,30,19,3,3,25,69,11,5,85,1.95,1.95,3.0,M2019-11-03D,Race(6),,
4,0,0,3,3,0,1,2,3,0,2,2,4,0,3,7,10,23,26,0.0,M2019-11-03D,Race(6),,
8,0,0,0,0,0,0,0,0,1,1,0,2,1,1,0,2,19,20,0.0,M2019-11-03D,Race(6),,
3,0,0,0,0,0,0,0,0,0,0,0,0,0,0,0,0,51,51,0.0,M2019-11-03D,Race(6),,
4,5,6,8,19,1,15,3,19,4,9,4,17,10,30,15,55,5,5,0.0,M2019-11-03D,Race(7),,
11,0,0,0,0,0,0,0,0,0,0,0,0,0,0,0,0,34,34,0.0,M2019-11-03D,Race(7),,
9,0,0,0,0,0,0,0,0,0,0,0,0,0,0,0,0,71,67,0.0,M2019-11-03D,Race(7),,
8,13,5,6,24,4,3,13,20,5,4,3,12,22,12,22,56,5.5,5.5,0.0,M2019-11-03D,Race(7),,
6,0,3,0,3,0,1,0,1,1,0,0,1,1,4,0,5,17,17,0.0,M2019-11-03D,Race(7),,
5,0,2,0,2,1,1,4,6,0,0,5,5,1,3,9,13,8,8,2.0,M2019-11-03D,Race(7),,
3,2,5,0,7,0,3,4,7,0,2,5,7,2,10,9,21,10,10,0.0,M2019-11-03D,Race(7),,
2,0,0,3,3,2,1,1,4,1,0,1,2,3,1,5,9,26,26,1.0,M2019-11-03D,Race(7),,
1,6,7,5,18,17,5,3,25,12,7,2,21,35,19,10,64,2.9,2.9,3.0,M2019-11-03D,Race(7),,
7,0,0,3,3,0,0,0,0,0,0,1,1,0,0,4,4,31,31,0.0,M2019-11-03D,Race(7),,
10,4,2,5,11,5,1,2,8,3,4,5,12,12,7,12,31,6.5,6.5,0.0,M2019-11-03D,Race(7),,
9,2,0,0,2,0,0,0,0,0,0,1,1,2,0,1,3,17,17,0.0,M2019-11-03D,Race(8),,
7,0,0,0,0,0,0,0,0,0,0,0,0,0,0,0,0,41,41,0.0,M2019-11-03D,Race(8),,
8,0,0,0,0,0,1,0,1,0,0,0,0,0,1,0,1,16,16,0.0,M2019-11-03D,Race(8),,
5,2,0,5,7,0,0,4,4,2,0,7,9,4,0,16,20,12,12,0.0,M2019-11-03D,Race(8),,
4,0,0,0,0,0,0,0,0,0,0,0,0,0,0,0,0,81,81,0.0,M2019-11-03D,Race(8),,
3,2,0,0,2,0,2,1,3,4,1,0,5,6,3,1,10,12,11,0.0,M2019-11-03D,Race(8),,
2,0,0,0,0,0,0,0,0,0,0,0,0,0,0,0,0,101,101,0.0,M2019-11-03D,Race(8),,
1,5,13,3,21,20,6,3,29,13,5,2,20,38,24,8,70,5.5,5,3.0,M2019-11-03D,Race(8),,
11,3,10,10,23,0,0,1,1,0,0,0,0,3,10,11,24,5.5,6,2.0,M2019-11-03D,Race(8),,
12,0,0,0,0,0,0,0,0,0,0,0,0,0,0,0,0,81,81,0.0,M2019-11-03D,Race(8),,
13,0,4,3,7,0,1,2,3,1,0,0,1,1,5,5,11,13,17,1.0,M2019-11-03D,Race(8),,
14,0,0,5,5,3,2,16,21,3,2,5,10,6,4,26,36,7,6.5,0.0,M2019-11-03D,Race(8),,
10,0,0,0,0,0,0,0,0,0,0,0,0,0,0,0,0,0,0,0.0,M2019-11-03D,Race(8),,
6,16,3,4,23,7,18,3,28,3,11,6,20,26,32,13,71,2.65,2.9,0.0,M2019-11-03D,Race(8),,
14,10,8,0,18,4,3,11,18,3,3,2,8,17,14,13,44,5,5.5,0.0,M2019-11-03D,Race(9),,
13,0,0,3,3,0,1,0,1,0,0,0,0,0,1,3,4,19,14,3.0,M2019-11-03D,Race(9),,
12,2,0,2,4,0,0,1,1,0,0,0,0,2,0,3,5,17,17,0.0,M2019-11-03D,Race(9),,
10,0,0,0,0,0,0,0,0,0,0,0,0,0,0,0,0,61,38,0.0,M2019-11-03D,Race(9),,
9,0,0,0,0,0,0,0,0,0,0,0,0,0,0,0,0,91,44,0.0,M2019-11-03D,Race(9),,
3,0,0,0,0,0,0,0,0,0,0,0,0,0,0,0,0,91,69,0.0,M2019-11-03D,Race(9),,
6,0,0,3,3,1,4,2,7,3,4,4,11,4,8,9,21,16,17,0.0,M2019-11-03D,Race(9),,
5,0,7,0,7,3,1,3,7,3,1,4,8,6,9,7,22,6.5,7,0.0,M2019-11-03D,Race(9),,
4,0,0,0,0,0,0,0,0,0,1,1,2,0,1,1,2,13,11,0.0,M2019-11-03D,Race(9),,
2,3,0,8,11,2,2,1,5,2,4,1,7,7,6,10,23,7.5,9,0.0,M2019-11-03D,Race(9),,
1,0,0,2,2,1,1,1,3,1,0,3,4,2,1,6,9,26,19,1.0,M2019-11-03D,Race(9),,
11,2,5,5,12,0,3,3,6,0,4,8,12,2,12,16,30,9.5,9,0.0,M2019-11-03D,Race(9),,
7,8,7,5,20,6,14,6,26,6,8,3,17,20,29,14,63,4.2,5.5,0.0,M2019-11-03D,Race(9),,
8,5,3,2,10,13,1,2,16,8,1,0,9,26,5,4,35,8,10,2.0,M2019-11-03D,Race(9),,
10,0,0,0,0,0,0,0,0,0,0,0,0,0,0,0,0,16,16,3.0,M2019-11-06D,Race(1),,
9,0,2,2,4,8,1,2,11,0,0,3,3,8,3,7,18,6.5,6.5,2.0,M2019-11-06D,Race(1),,
1,9,3,11,23,7,5,7,19,5,5,6,16,21,13,24,58,4.6,4.6,0.0,M2019-11-06D,Race(1),,
2,0,2,0,2,0,0,2,2,0,1,2,3,0,3,4,7,21,21,0.0,M2019-11-06D,Race(1),,
3,0,0,0,0,0,0,8,8,1,1,2,4,1,1,10,12,26,26,0.0,M2019-11-06D,Race(1),,
4,7,6,3,16,10,6,0,16,9,4,2,15,26,16,5,47,4.8,4.8,0.0,M2019-11-06D,Race(1),,
5,0,3,3,6,1,8,4,13,3,2,4,9,4,13,11,28,14,14,0.0,M2019-11-06D,Race(1),,
6,0,0,0,0,0,0,0,0,1,0,0,1,1,0,0,1,101,101,0.0,M2019-11-06D,Race(1),,
12,5,2,0,7,1,0,1,2,2,1,2,5,8,3,3,14,16,16,0.0,M2019-11-06D,Race(1),,
11,4,5,5,14,1,5,4,10,1,9,2,12,6,19,11,36,4.4,4.4,1.0,M2019-11-06D,Race(1),,
7,3,5,6,14,0,4,0,4,2,3,2,7,5,12,8,25,8,8,0.0,M2019-11-06D,Race(1),,
8,2,2,0,4,2,1,2,5,2,0,1,3,6,3,3,12,19,19,0.0,M2019-11-06D,Race(1),,
11,2,3,3,8,1,0,5,6,3,1,8,12,6,4,16,26,14,14,1.0,M2019-11-06D,Race(2),,
10,0,0,2,2,1,8,0,9,1,2,0,3,2,10,2,14,13,13,2.0,M2019-11-06D,Race(2),,
9,0,0,3,3,1,0,1,2,1,0,1,2,2,0,5,7,10,10,0.0,M2019-11-06D,Race(2),,
1,16,4,2,22,13,7,2,22,7,13,1,21,36,24,5,65,3,3,0.0,M2019-11-06D,Race(2),,
2,2,6,4,12,8,5,8,21,5,3,10,18,15,14,22,51,5.5,5.5,0.0,M2019-11-06D,Race(2),,
3,10,6,3,19,3,3,2,8,3,3,1,7,16,12,6,34,9,9,3.0,M2019-11-06D,Race(2),,
4,0,0,0,0,0,0,0,0,0,0,0,0,0,0,0,0,101,101,0.0,M2019-11-06D,Race(2),,
5,0,0,0,0,0,0,0,0,0,1,0,1,0,1,0,1,64,64,0.0,M2019-11-06D,Race(2),,
6,0,11,8,19,2,6,4,12,5,3,3,11,7,20,15,42,4.8,4.8,0.0,M2019-11-06D,Race(2),,
7,0,0,0,0,0,0,0,0,0,0,0,0,0,0,0,0,31,31,0.0,M2019-11-06D,Race(2),,
8,0,0,0,0,0,0,0,0,1,0,0,1,1,0,0,1,81,81,0.0,M2019-11-06D,Race(2),,
12,0,0,5,5,1,1,8,10,0,0,2,2,1,1,15,17,8,8,0.0,M2019-11-06D,Race(2),,
12,3,0,0,3,0,8,0,8,0,2,0,2,3,10,0,13,12,12,0.0,M2019-11-06D,Race(3),,
1,9,11,3,23,4,6,6,16,2,6,4,12,15,23,13,51,3.7,3.7,1.0,M2019-11-06D,Race(3),,
3,0,0,0,0,0,0,0,0,0,0,0,0,0,0,0,0,126,126,0.0,M2019-11-06D,Race(3),,
4,2,0,0,2,0,0,0,0,2,1,0,3,4,1,0,5,31,31,0.0,M2019-11-06D,Race(3),,
5,0,0,0,0,0,0,0,0,0,0,0,0,0,0,0,0,81,81,0.0,M2019-11-06D,Race(3),,
6,0,0,0,0,0,0,0,0,0,1,0,1,0,1,0,1,17,17,0.0,M2019-11-06D,Race(3),,
7,0,7,9,16,9,1,1,11,1,3,2,6,10,11,12,33,6.5,6.5,0.0,M2019-11-06D,Race(3),,
8,0,0,2,2,0,2,1,3,0,2,4,6,0,4,7,11,14,14,0.0,M2019-11-06D,Race(3),,
9,13,7,7,27,10,8,2,20,11,9,0,20,34,24,9,67,3.5,3.5,3.0,M2019-11-06D,Race(3),,
10,0,0,0,0,0,1,8,9,1,1,3,5,1,2,11,14,17,17,0.0,M2019-11-06D,Race(3),,
2,0,0,0,0,0,0,0,0,0,0,0,0,0,0,0,0,31,31,0.0,M2019-11-06D,Race(3),,
11,3,5,9,17,0,1,3,4,0,0,6,6,3,6,18,27,4.8,4.8,2.0,M2019-11-06D,Race(3),,
9,3,5,7,15,0,0,6,6,0,6,1,7,3,11,14,28,6,6,0.0,M2019-11-06D,Race(4),,
5,10,7,8,25,4,5,8,17,3,8,5,16,17,20,21,58,5,5,1.0,M2019-11-06D,Race(4),,
1,2,2,0,4,5,3,2,10,5,3,3,11,12,8,5,25,5.5,5.5,0.0,M2019-11-06D,Race(4),,
2,3,3,2,8,2,2,2,6,5,1,1,7,10,6,5,21,12,12,0.0,M2019-11-06D,Race(4),,
8,0,0,0,0,0,0,0,0,0,0,0,0,0,0,0,0,81,81,0.0,M2019-11-06D,Race(4),,
4,2,9,5,16,10,4,3,17,9,2,2,13,21,15,10,46,4.2,4.2,2.0,M2019-11-06D,Race(4),,
3,2,0,3,5,0,0,0,0,0,0,1,1,2,0,4,6,17,17,0.0,M2019-11-06D,Race(4),,
7,0,4,0,4,0,4,4,8,1,0,6,7,1,8,10,19,11,11,3.0,M2019-11-06D,Race(4),,
11,8,0,3,11,1,3,3,7,2,3,3,8,11,6,9,26,8,8,0.0,M2019-11-06D,Race(4),,
12,0,0,2,2,0,8,1,9,0,2,3,5,0,10,6,16,13,13,0.0,M2019-11-06D,Race(4),,
10,0,0,0,0,0,0,0,0,0,0,0,0,0,0,0,0,126,126,0.0,M2019-11-06D,Race(4),,
6,0,0,0,0,8,1,1,10,1,1,1,3,9,2,2,13,26,26,0.0,M2019-11-06D,Race(4),,
12,3,6,5,14,2,1,3,6,1,1,4,6,6,8,12,26,7.5,7.5,2.0,M2019-11-06D,Race(5),,
11,0,8,0,8,8,1,7,16,2,2,5,9,10,11,12,33,8,8,0.0,M2019-11-06D,Race(5),,
1,2,6,5,13,3,5,5,13,5,3,4,12,10,14,14,38,5,5,0.0,M2019-11-06D,Race(5),,
3,0,2,2,4,0,8,1,9,0,1,0,1,0,11,3,14,15,15,0.0,M2019-11-06D,Race(5),,
4,3,0,0,3,0,1,8,9,0,3,2,5,3,4,10,17,12,12,0.0,M2019-11-06D,Race(5),,
6,6,2,9,17,2,2,3,7,2,3,7,12,10,7,19,36,10,10,0.0,M2019-11-06D,Race(5),,
7,0,0,4,4,1,3,1,5,0,2,1,3,1,5,6,12,9,9,0.0,M2019-11-06D,Race(5),,
8,0,0,0,0,0,0,0,0,0,0,0,0,0,0,0,0,81,81,0.0,M2019-11-06D,Race(5),,
9,0,0,3,3,1,0,1,2,1,1,0,2,2,1,4,7,17,17,3.0,M2019-11-06D,Race(5),,
10,16,6,2,24,13,7,1,21,12,9,3,24,41,22,6,69,3.2,3.2,1.0,M2019-11-06D,Race(5),,
5,0,0,0,0,0,0,0,0,0,0,0,0,0,0,0,0,81,81,0.0,M2019-11-06D,Race(5),,
2,0,0,0,0,0,2,0,2,3,1,0,4,3,3,0,6,16,16,0.0,M2019-11-06D,Race(5),,
12,0,0,4,4,0,0,0,0,0,0,0,0,0,0,4,4,51,81,1.0,M2019-11-06D,Race(6),,
8,0,2,0,2,0,0,0,0,0,0,0,0,0,2,0,2,51,51,0.0,M2019-11-06D,Race(6),,
9,8,0,3,11,0,0,0,0,0,3,2,5,8,3,5,16,7,7,0.0,M2019-11-06D,Race(6),,
10,0,0,0,0,0,0,0,0,0,0,0,0,0,0,0,0,81,81,0.0,M2019-11-06D,Race(6),,
11,4,3,0,7,9,4,2,15,4,6,5,15,17,13,7,37,7.5,7.5,0.0,M2019-11-06D,Race(6),,
6,2,2,3,7,0,3,9,12,2,2,4,8,4,7,16,27,12,12,3.0,M2019-11-06D,Race(6),,
4,3,5,3,11,0,4,4,8,0,6,5,11,3,15,12,30,7,7,0.0,M2019-11-06D,Race(6),,
1,3,15,8,26,12,2,6,20,14,0,5,19,29,17,19,65,2.7,2.7,2.0,M2019-11-06D,Race(6),,
3,5,3,5,13,3,8,6,17,4,7,5,16,12,18,16,46,5.5,5.5,0.0,M2019-11-06D,Race(6),,
7,0,0,0,0,0,0,0,0,0,0,0,0,0,0,0,0,41,41,0.0,M2019-11-06D,Race(6),,
2,5,0,4,9,6,1,3,10,2,2,0,4,13,3,7,23,8,8,0.0,M2019-11-06D,Race(6),,
5,0,0,0,0,0,8,0,8,0,0,0,0,0,8,0,8,34,34,0.0,M2019-11-06D,Race(6),,
9,0,0,0,0,0,0,0,0,0,0,1,1,0,0,1,1,26,26,0.0,M2019-11-06D,Race(7),,
6,0,2,11,13,0,5,9,14,0,2,13,15,0,9,33,42,8,8,0.0,M2019-11-06D,Race(7),,
5,0,0,0,0,0,0,0,0,0,0,0,0,0,0,0,0,81,81,0.0,M2019-11-06D,Race(7),,
4,5,0,4,9,0,10,1,11,0,3,2,5,5,13,7,25,9,9,2.0,M2019-11-06D,Race(7),,
3,21,7,0,28,15,4,2,21,21,4,0,25,57,15,2,74,1.7,1.7,1.0,M2019-11-06D,Race(7),,
2,2,9,5,16,8,2,5,15,2,5,4,11,12,16,14,42,10,10,0.0,M2019-11-06D,Race(7),,
1,0,10,8,18,4,8,5,17,2,11,3,16,6,29,16,51,5,5,0.0,M2019-11-06D,Race(7),,
10,2,0,2,4,2,1,8,11,0,0,2,2,4,1,12,17,16,16,3.0,M2019-11-06D,Race(7),,
7,0,2,0,2,1,0,0,1,1,1,1,3,2,3,1,6,21,21,0.0,M2019-11-06D,Race(7),,
8,0,0,0,0,0,0,0,0,0,0,0,0,0,0,0,0,101,101,0.0,M2019-11-06D,Race(7),,
8,15,5,3,23,10,4,13,27,4,7,8,19,29,16,24,69,4.6,4.6,1.0,M2019-11-06D,Race(8),,
1,0,0,0,0,0,0,0,0,0,0,0,0,0,0,0,0,19,19,0.0,M2019-11-06D,Race(8),,
2,0,15,9,24,16,5,8,29,17,3,5,25,33,23,22,78,2.6,2.6,0.0,M2019-11-06D,Race(8),,
3,3,0,6,9,0,0,3,3,0,2,3,5,3,2,12,17,10,10,0.0,M2019-11-06D,Race(8),,
4,2,3,3,8,4,12,4,20,4,13,6,23,10,28,13,51,6,6,0.0,M2019-11-06D,Race(8),,
5,5,0,0,5,0,1,2,3,0,0,2,2,5,1,4,10,15,15,0.0,M2019-11-06D,Race(8),,
6,0,0,0,0,0,0,0,0,0,0,0,0,0,0,0,0,31,31,0.0,M2019-11-06D,Race(8),,
7,2,7,9,18,0,8,0,8,1,1,2,4,3,16,11,30,6.5,6.5,0.0,M2019-11-06D,Race(8),,
9,3,0,0,3,0,0,0,0,0,0,0,0,3,0,0,3,26,26,3.0,M2019-11-06D,Race(8),,
10,0,0,0,0,0,0,0,0,0,0,0,0,0,0,0,0,31,31,2.0,M2019-11-06D,Race(8),,
11,0,0,0,0,0,0,0,0,0,0,0,0,0,0,0,0,81,81,0.0,M2019-11-06D,Race(8),,
12,0,0,0,0,0,0,0,0,0,0,0,0,0,0,0,0,51,51,0.0,M2019-11-06D,Race(8),,
2,0,0,0,0,0,1,0,1,1,2,0,3,1,3,0,4,31,31,0.0,M2019-11-06D,Race(9),,
1,0,5,2,7,4,2,4,10,2,1,4,7,6,8,10,24,5.5,5.5,2.0,M2019-11-06D,Race(9),,
11,8,7,8,23,6,7,3,16,10,8,1,19,24,22,12,58,3.2,3.2,1.0,M2019-11-06D,Race(9),,
10,0,0,0,0,0,0,0,0,0,0,0,0,0,0,0,0,61,61,0.0,M2019-11-06D,Race(9),,
9,2,0,3,5,8,2,3,13,3,2,3,8,13,4,9,26,12,12,0.0,M2019-11-06D,Race(9),,
8,3,6,3,12,0,3,2,5,1,2,6,9,4,11,11,26,7,7,0.0,M2019-11-06D,Race(9),,
7,0,0,0,0,0,0,0,0,0,2,0,2,0,2,0,2,31,31,0.0,M2019-11-06D,Race(9),,
6,3,0,5,8,0,8,6,14,1,2,9,12,4,10,20,34,6,6,0.0,M2019-11-06D,Race(9),,
5,4,0,0,4,3,1,8,12,3,0,0,3,10,1,8,19,26,26,0.0,M2019-11-06D,Race(9),,
4,6,10,4,20,9,6,4,19,5,7,2,14,20,23,10,53,8.5,8.5,3.0,M2019-11-06D,Race(9),,
12,0,0,2,2,0,0,0,0,0,0,0,0,0,0,2,2,51,51,0.0,M2019-11-06D,Race(9),,
3,4,2,3,9,0,0,0,0,0,0,1,1,4,2,4,10,7.5,7.5,0.0,M2019-11-06D,Race(9),,
7,0,0,0,0,0,0,0,0,0,0,0,0,0,0,0,0,51,51,0.0,M2019-11-09D,Race(1),,
14,0,0,0,0,0,0,0,0,0,0,0,0,0,0,0,0,126,126,0.0,M2019-11-09D,Race(1),,
13,14,3,6,23,9,5,11,25,9,4,3,16,32,12,20,64,2.8,2.8,0.0,M2019-11-09D,Race(1),,
12,3,2,0,5,0,0,0,0,0,1,1,2,3,3,1,7,17,17,0.0,M2019-11-09D,Race(1),,
11,0,0,0,0,0,1,0,1,0,0,0,0,0,1,0,1,18,17,0.0,M2019-11-09D,Race(1),,
10,4,3,6,13,0,14,8,22,0,4,2,6,4,21,16,41,8.5,8.5,2.0,M2019-11-09D,Race(1),,
9,5,11,3,19,19,7,4,30,12,4,6,22,36,22,13,71,3.7,3.7,1.0,M2019-11-09D,Race(1),,
8,0,2,2,4,0,1,1,2,0,4,1,5,0,7,4,11,61,61,0.0,M2019-11-09D,Race(1),,
6,0,0,2,2,0,1,2,3,0,1,6,7,0,2,10,12,10,10,3.0,M2019-11-09D,Race(1),,
5,2,0,0,2,1,0,0,1,2,1,1,4,5,1,1,7,16,16,0.0,M2019-11-09D,Race(1),,
1,0,0,2,2,0,0,0,0,1,1,0,2,1,1,2,4,51,51,0.0,M2019-11-09D,Race(1),,
4,2,9,9,20,1,1,3,5,2,4,6,12,5,14,18,37,5.5,6,0.0,M2019-11-09D,Race(1),,
3,0,0,0,0,0,0,0,0,0,0,0,0,0,0,0,0,101,101,0.0,M2019-11-09D,Race(1),,
2,0,0,0,0,0,0,1,1,0,2,0,2,0,2,1,3,71,67,0.0,M2019-11-09D,Race(1),,
5,0,0,5,5,1,6,13,20,2,5,4,11,3,11,22,36,15,15,0.0,M2019-11-09D,Race(10),,
3,3,12,5,20,19,6,2,27,13,8,2,23,35,26,9,70,3.7,3.7,3.0,M2019-11-09D,Race(10),,
1,0,0,0,0,0,0,0,0,0,0,0,0,0,0,0,0,81,81,0.0,M2019-11-09D,Race(10),,
6,0,0,0,0,0,0,0,0,0,0,1,1,0,0,1,1,81,81,0.0,M2019-11-09D,Race(10),,
7,2,0,0,2,0,0,0,0,0,0,0,0,2,0,0,2,31,31,0.0,M2019-11-09D,Race(10),,
8,3,4,0,7,1,0,2,3,0,1,1,2,4,5,3,12,7,7,0.0,M2019-11-09D,Race(10),,
9,6,6,5,17,0,3,3,6,1,1,3,5,7,10,11,28,7,7,0.0,M2019-11-09D,Race(10),,
11,0,3,8,11,0,0,0,0,2,2,1,5,2,5,9,16,11,11,2.0,M2019-11-09D,Race(10),,
10,3,0,0,3,0,0,1,1,0,0,3,3,3,0,4,7,11,11,1.0,M2019-11-09D,Race(10),,
13,0,0,4,4,2,1,2,5,0,0,2,2,2,1,8,11,16,16,0.0,M2019-11-09D,Race(10),,
14,0,0,0,0,0,0,1,1,0,0,0,0,0,0,1,1,101,101,0.0,M2019-11-09D,Race(10),,
4,10,5,3,18,7,14,5,26,6,7,3,16,23,26,11,60,4.8,4.8,0.0,M2019-11-09D,Race(10),,
2,0,0,0,0,0,0,1,1,1,1,1,3,1,1,2,4,17,17,0.0,M2019-11-09D,Race(10),,
12,3,0,0,3,0,0,0,0,1,1,5,7,4,1,5,10,13,13,0.0,M2019-11-09D,Race(10),,
8,0,0,0,0,0,0,0,0,0,1,0,1,0,1,0,1,34,34,0.0,M2019-11-09D,Race(2),,
12,7,0,2,9,3,2,14,19,5,0,7,12,15,2,23,40,8,8,0.0,M2019-11-09D,Race(2),,
11,3,11,6,20,0,16,6,22,1,10,3,14,4,37,15,56,4,4,0.0,M2019-11-09D,Race(2),,
10,2,0,0,2,0,0,0,0,0,1,2,3,2,1,2,5,21,21,0.0,M2019-11-09D,Race(2),,
7,0,6,0,6,1,1,3,5,2,0,2,4,3,7,5,15,8,8,0.0,M2019-11-09D,Race(2),,
2,0,0,0,0,0,0,1,1,0,1,1,2,0,1,2,3,17,17,0.0,M2019-11-09D,Race(2),,
5,3,4,9,16,1,2,3,6,2,6,1,9,6,12,13,31,7,7,2.0,M2019-11-09D,Race(2),,
4,0,2,0,2,0,1,0,1,1,1,2,4,1,4,2,7,21,21,3.0,M2019-11-09D,Race(2),,
3,0,0,0,0,0,1,1,2,0,0,3,3,0,1,4,5,21,21,0.0,M2019-11-09D,Race(2),,
1,11,7,8,26,24,3,1,28,13,2,3,18,48,12,12,72,3.6,3.6,0.0,M2019-11-09D,Race(2),,
13,0,0,0,0,0,1,0,1,0,0,0,0,0,1,0,1,126,126,0.0,M2019-11-09D,Race(2),,
6,4,0,5,9,1,3,1,5,1,4,2,7,6,7,8,21,11,11,0.0,M2019-11-09D,Race(2),,
14,0,0,0,0,0,0,0,0,0,0,0,0,0,0,0,0,81,81,0.0,M2019-11-09D,Race(2),,
9,0,0,0,0,0,0,0,0,1,0,0,1,1,0,0,1,61,61,1.0,M2019-11-09D,Race(2),,
11,7,0,0,7,0,0,2,2,0,2,2,4,7,2,4,13,13,13,0.0,M2019-11-09D,Race(3),,
13,0,0,0,0,0,0,0,0,0,0,0,0,0,0,0,0,41,41,0.0,M2019-11-09D,Race(3),,
3,0,0,0,0,0,0,0,0,2,0,0,2,2,0,0,2,101,101,0.0,M2019-11-09D,Race(3),,
2,0,4,0,4,0,0,0,0,0,0,0,0,0,4,0,4,31,31,1.0,M2019-11-09D,Race(3),,
14,5,8,5,18,3,1,3,7,5,1,2,8,13,10,10,33,3.7,3.7,3.0,M2019-11-09D,Race(3),,
12,2,3,5,10,1,4,3,8,0,3,2,5,3,10,10,23,16,16,0.0,M2019-11-09D,Race(3),,
10,0,0,0,0,0,0,1,1,0,2,1,3,0,2,2,4,21,21,0.0,M2019-11-09D,Race(3),,
9,0,0,0,0,0,0,0,0,0,0,0,0,0,0,0,0,81,81,0.0,M2019-11-09D,Race(3),,
1,8,2,0,10,14,7,4,25,6,3,10,19,28,12,14,54,5,5,2.0,M2019-11-09D,Race(3),,
7,0,0,0,0,0,0,0,0,0,0,2,2,0,0,2,2,101,101,0.0,M2019-11-09D,Race(3),,
6,8,3,4,15,6,3,11,20,8,6,1,15,22,12,16,50,11,11,0.0,M2019-11-09D,Race(3),,
5,0,0,3,3,0,2,0,2,0,0,0,0,0,2,3,5,10,10,0.0,M2019-11-09D,Race(3),,
4,0,0,3,3,0,1,0,1,1,1,1,3,1,2,4,7,19,19,0.0,M2019-11-09D,Race(3),,
8,0,10,10,20,6,12,6,24,4,8,5,17,10,30,21,61,3.5,3.5,0.0,M2019-11-09D,Race(3),,
5,0,0,0,0,1,0,0,1,0,0,0,0,1,0,0,1,31,31,0.0,M2019-11-09D,Race(4),,
10,0,0,0,0,0,1,0,1,0,0,0,0,0,1,0,1,71,67,0.0,M2019-11-09D,Race(4),,
11,8,8,4,20,16,6,2,24,9,10,1,20,33,24,7,64,4,4,2.0,M2019-11-09D,Race(4),,
9,2,6,2,10,0,0,1,1,0,0,1,1,2,6,4,12,17,17,0.0,M2019-11-09D,Race(4),,
8,0,4,3,7,2,0,4,6,4,2,4,10,6,6,11,23,16,16,0.0,M2019-11-09D,Race(4),,
7,2,0,0,2,0,0,3,3,1,0,8,9,3,0,11,14,9,11,3.0,M2019-11-09D,Race(4),,
12,0,0,0,0,1,0,0,1,0,0,1,1,1,0,1,2,81,81,0.0,M2019-11-09D,Race(4),,
6,0,0,0,0,0,0,0,0,0,0,0,0,0,0,0,0,81,81,0.0,M2019-11-09D,Race(4),,
3,18,5,7,30,9,17,2,28,9,13,0,22,36,35,9,80,2.45,2.5,0.0,M2019-11-09D,Race(4),,
4,0,0,2,2,0,2,3,5,0,0,3,3,0,2,8,10,16,16,0.0,M2019-11-09D,Race(4),,
13,0,0,0,0,0,0,0,0,0,0,1,1,0,0,1,1,71,67,0.0,M2019-11-09D,Race(4),,
2,0,4,12,16,1,4,15,20,2,1,7,10,3,9,34,46,5,5,1.0,M2019-11-09D,Race(4),,
1,0,3,0,3,0,0,0,0,1,0,0,1,1,3,0,4,15,15,0.0,M2019-11-09D,Race(4),,
14,0,0,0,0,0,0,0,0,0,0,0,0,0,0,0,0,51,51,0.0,M2019-11-09D,Race(4),,
3,0,0,0,0,0,0,0,0,0,0,0,0,0,0,0,0,26,26,0.0,M2019-11-09D,Race(5),,
4,0,0,0,0,0,0,0,0,0,0,0,0,0,0,0,0,34,34,0.0,M2019-11-09D,Race(5),,
11,0,0,7,7,1,0,0,1,1,1,1,3,2,1,8,11,15,15,0.0,M2019-11-09D,Race(5),,
12,5,6,2,13,3,3,15,21,3,1,5,9,11,10,22,43,7,7,0.0,M2019-11-09D,Race(5),,
2,0,0,0,0,0,0,0,0,0,1,0,1,0,1,0,1,41,41,0.0,M2019-11-09D,Race(5),,
7,0,0,8,8,0,1,1,2,0,2,3,5,0,3,12,15,12,12,1.0,M2019-11-09D,Race(5),,
10,7,9,3,19,7,14,4,25,6,4,5,15,20,27,12,59,3,3,0.0,M2019-11-09D,Race(5),,
13,0,2,0,2,0,0,0,0,0,0,0,0,0,2,0,2,41,41,0.0,M2019-11-09D,Race(5),,
9,12,6,5,23,3,3,6,12,3,8,10,21,18,17,21,56,5.5,5.5,0.0,M2019-11-09D,Race(5),,
14,0,0,0,0,0,0,0,0,0,0,0,0,0,0,0,0,51,51,0.0,M2019-11-09D,Race(5),,
8,6,7,5,18,16,9,3,28,12,8,2,22,34,24,10,68,3.8,3.8,2.0,M2019-11-09D,Race(5),,
6,0,0,0,0,0,0,1,1,1,1,0,2,1,1,1,3,26,26,3.0,M2019-11-09D,Race(5),,
1,0,0,0,0,0,0,0,0,0,0,0,0,0,0,0,0,81,81,0.0,M2019-11-09D,Race(5),,
5,0,0,0,0,0,0,0,0,0,0,0,0,0,0,0,0,51,51,0.0,M2019-11-09D,Race(5),,
8,0,0,0,0,0,0,0,0,0,0,0,0,0,0,0,0,61,61,0.0,M2019-11-09D,Race(6),,
12,3,0,2,5,1,0,1,2,0,0,3,3,4,0,6,10,26,26,0.0,M2019-11-09D,Race(6),,
14,0,0,0,0,0,0,1,1,0,0,1,1,0,0,2,2,31,31,3.0,M2019-11-09D,Race(6),,
11,0,0,0,0,0,0,0,0,0,0,0,0,0,0,0,0,51,51,0.0,M2019-11-09D,Race(6),,
9,0,0,0,0,0,0,1,1,0,0,2,2,0,0,3,3,14,14,1.0,M2019-11-09D,Race(6),,
13,20,2,6,28,8,14,3,25,6,12,2,20,34,28,11,73,2.1,2.1,2.0,M2019-11-09D,Race(6),,
6,0,0,3,3,0,0,0,0,1,0,0,1,1,0,3,4,34,34,0.0,M2019-11-09D,Race(6),,
5,0,0,0,0,0,0,1,1,0,0,0,0,0,0,1,1,51,51,0.0,M2019-11-09D,Race(6),,
4,3,13,7,23,0,4,14,18,4,4,3,11,7,21,24,52,6.5,6.5,0.0,M2019-11-09D,Race(6),,
3,2,0,3,5,0,2,2,4,0,0,2,2,2,2,7,11,26,26,0.0,M2019-11-09D,Race(6),,
2,2,3,2,7,1,1,3,5,1,3,1,5,4,7,6,17,18,18,0.0,M2019-11-09D,Race(6),,
1,0,0,0,0,0,0,0,0,0,0,0,0,0,0,0,0,13,13,0.0,M2019-11-09D,Race(6),,
7,0,4,0,4,0,2,1,3,0,4,0,4,0,10,1,11,21,21,0.0,M2019-11-09D,Race(6),,
10,0,8,7,15,2,0,1,3,3,0,7,10,5,8,15,28,5,5,0.0,M2019-11-09D,Race(6),,
6,0,3,2,5,0,2,1,3,1,9,1,11,1,14,4,19,19,19,0.0,M2019-11-09D,Race(7),,
9,3,7,8,18,0,16,5,21,2,2,7,11,5,25,20,50,7,7,3.0,M2019-11-09D,Race(7),,
12,0,0,0,0,0,0,0,0,0,0,0,0,0,0,0,0,61,61,0.0,M2019-11-09D,Race(7),,
8,0,0,2,2,0,0,3,3,0,0,3,3,0,0,8,8,26,26,0.0,M2019-11-09D,Race(7),,
5,7,8,2,17,0,6,18,24,1,2,8,11,8,16,28,52,6,6,1.0,M2019-11-09D,Race(7),,
7,0,0,0,0,0,0,0,0,0,0,0,0,0,0,0,0,34,34,0.0,M2019-11-09D,Race(7),,
4,0,2,12,14,0,4,3,7,1,4,1,6,1,10,16,27,16,16,0.0,M2019-11-09D,Race(7),,
2,0,2,0,2,0,1,0,1,0,4,4,8,0,7,4,11,17,17,2.0,M2019-11-09D,Race(7),,
1,20,6,4,30,29,1,0,30,20,4,1,25,69,11,5,85,1.75,1.75,0.0,M2019-11-09D,Race(7),,
13,0,2,0,2,0,0,0,0,0,0,0,0,0,2,0,2,51,51,0.0,M2019-11-09D,Race(7),,
11,0,0,0,0,0,0,0,0,0,0,0,0,0,0,0,0,21,21,0.0,M2019-11-09D,Race(7),,
10,0,0,0,0,0,0,0,0,0,0,0,0,0,0,0,0,41,41,0.0,M2019-11-09D,Race(7),,
3,0,0,0,0,1,0,0,1,1,1,1,3,2,1,1,4,21,21,0.0,M2019-11-09D,Race(7),,
12,0,0,0,0,0,0,0,0,0,0,0,0,0,0,0,0,101,101,0.0,M2019-11-09D,Race(8),,
11,0,0,0,0,0,0,0,0,0,0,0,0,0,0,0,0,41,41,0.0,M2019-11-09D,Race(8),,
10,0,0,0,0,0,0,0,0,0,0,0,0,0,0,0,0,51,51,0.0,M2019-11-09D,Race(8),,
9,0,0,0,0,0,0,0,0,0,0,0,0,0,0,0,0,101,101,0.0,M2019-11-09D,Race(8),,
8,0,3,0,3,0,1,1,2,0,0,2,2,0,4,3,7,7.5,7.5,0.0,M2019-11-09D,Race(8),,
7,0,2,0,2,0,0,0,0,0,0,2,2,0,2,2,4,13,13,3.0,M2019-11-09D,Race(8),,
4,0,0,0,0,0,2,1,3,0,1,0,1,0,3,1,4,23,23,0.0,M2019-11-09D,Race(8),,
5,2,0,0,2,2,0,1,3,0,0,1,1,4,0,2,6,26,26,0.0,M2019-11-09D,Race(8),,
2,0,0,0,0,0,0,0,0,0,1,1,2,0,1,1,2,81,81,0.0,M2019-11-09D,Race(8),,
1,5,10,7,22,1,20,6,27,3,9,4,16,9,39,17,65,6.5,6,0.0,M2019-11-09D,Race(8),,
14,3,3,7,13,0,1,5,6,1,3,7,11,4,7,19,30,6,6,2.0,M2019-11-09D,Race(8),,
13,0,4,3,7,1,4,14,19,2,4,7,13,3,12,24,39,6.5,8,0.0,M2019-11-09D,Race(8),,
6,20,2,5,27,25,2,1,28,16,5,2,23,61,9,8,78,2.65,2.7,1.0,M2019-11-09D,Race(8),,
3,0,6,8,14,1,0,1,2,4,3,0,7,5,9,9,23,13,12,0.0,M2019-11-09D,Race(8),,
2,5,5,2,12,2,4,11,17,0,4,5,9,7,13,18,38,9,9,2.0,M2019-11-09D,Race(9),,
4,5,5,2,12,0,2,2,4,0,1,4,5,5,8,8,21,15,15,0.0,M2019-11-09D,Race(9),,
5,0,0,0,0,0,0,1,1,0,1,1,2,0,1,2,3,9,9,3.0,M2019-11-09D,Race(9),,
6,0,3,3,6,0,0,1,1,0,2,1,3,0,5,5,10,16,16,0.0,M2019-11-09D,Race(9),,
8,0,3,2,5,0,0,0,0,0,0,0,0,0,3,2,5,6,6,1.0,M2019-11-09D,Race(9),,
9,10,0,5,15,1,1,2,4,4,1,3,8,15,2,10,27,6.5,6.5,0.0,M2019-11-09D,Race(9),,
10,0,0,0,0,0,0,0,0,1,0,0,1,1,0,0,1,26,26,0.0,M2019-11-09D,Race(9),,
11,0,0,0,0,0,0,0,0,0,0,0,0,0,0,0,0,31,31,0.0,M2019-11-09D,Race(9),,
12,3,10,2,15,0,2,1,3,0,1,2,3,3,13,5,21,8.5,8.5,0.0,M2019-11-09D,Race(9),,
13,2,0,5,7,0,0,1,1,0,0,1,1,2,0,7,9,14,14,0.0,M2019-11-09D,Race(9),,
14,0,0,0,0,0,0,0,0,0,1,0,1,0,1,0,1,31,31,0.0,M2019-11-09D,Race(9),,
7,0,0,0,0,0,0,0,0,0,0,0,0,0,0,0,0,81,81,0.0,M2019-11-09D,Race(9),,
1,0,2,3,5,1,1,2,4,1,0,3,4,2,3,8,13,7.5,7.5,0.0,M2019-11-09D,Race(9),,
3,5,2,6,13,7,16,4,27,9,9,1,19,21,27,11,59,6,6,0.0,M2019-11-09D,Race(9),,
13,0,4,8,12,0,0,1,1,0,1,3,4,0,5,12,17,17,17,2.0,M2019-11-17D,Race(1),,
2,2,0,0,2,0,1,1,2,0,1,1,2,2,2,2,6,17,17,0.0,M2019-11-17D,Race(1),,
3,0,0,10,10,4,3,3,10,6,4,0,10,10,7,13,30,9,9,0.0,M2019-11-17D,Race(1),,
4,2,6,2,10,3,0,12,15,2,1,5,8,7,7,19,33,6,6,0.0,M2019-11-17D,Race(1),,
5,0,0,0,0,0,0,0,0,0,1,0,1,0,1,0,1,41,41,0.0,M2019-11-17D,Race(1),,
6,13,7,2,22,7,16,6,29,8,8,8,24,28,31,16,75,3.2,3.2,0.0,M2019-11-17D,Race(1),,
12,0,0,0,0,0,0,0,0,0,0,0,0,0,0,0,0,151,151,0.0,M2019-11-17D,Race(1),,
7,0,0,0,0,0,0,0,0,0,0,0,0,0,0,0,0,31,31,0.0,M2019-11-17D,Race(1),,
8,0,0,0,0,0,0,0,0,0,0,0,0,0,0,0,0,71,67,0.0,M2019-11-17D,Race(1),,
9,8,7,3,18,16,9,3,28,8,8,3,19,32,24,9,65,3.5,3.5,1.0,M2019-11-17D,Race(1),,
10,0,3,5,8,0,0,1,1,0,0,0,0,0,3,6,9,10,10,3.0,M2019-11-17D,Race(1),,
11,0,0,0,0,0,0,0,0,0,0,0,0,0,0,0,0,151,151,0.0,M2019-11-17D,Race(1),,
14,5,3,0,8,0,0,1,1,0,0,3,3,5,3,4,12,14,14,0.0,M2019-11-17D,Race(1),,
1,0,0,0,0,0,1,2,3,2,2,3,7,2,3,5,10,34,34,0.0,M2019-11-17D,Race(1),,
5,0,2,0,2,0,2,0,2,0,2,0,2,0,6,0,6,12,12,0.0,M2019-11-17D,Race(10),,
3,18,7,2,27,24,2,3,29,17,6,1,24,59,15,6,80,2.9,2.8,0.0,M2019-11-17D,Race(10),,
4,2,5,0,7,1,5,2,8,0,3,1,4,3,13,3,19,11,11,3.0,M2019-11-17D,Race(10),,
14,0,0,0,0,0,0,0,0,0,0,0,0,0,0,0,0,26,26,0.0,M2019-11-17D,Race(10),,
13,7,0,7,14,1,1,5,7,3,0,3,6,11,1,15,27,4.8,6.5,2.0,M2019-11-17D,Race(10),,
12,3,11,2,16,0,2,13,15,0,4,13,17,3,17,28,48,7,7,1.0,M2019-11-17D,Race(10),,
11,0,3,3,6,1,0,2,3,3,1,1,5,4,4,6,14,21,21,0.0,M2019-11-17D,Race(10),,
10,0,0,2,2,0,0,1,1,0,0,0,0,0,0,3,3,21,21,0.0,M2019-11-17D,Race(10),,
6,0,0,0,0,1,0,0,1,2,1,0,3,3,1,0,4,34,34,0.0,M2019-11-17D,Race(10),,
9,0,0,2,2,0,0,0,0,0,1,0,1,0,1,2,3,9.5,9,0.0,M2019-11-17D,Race(10),,
8,0,0,0,0,0,0,0,0,0,0,0,0,0,0,0,0,21,21,0.0,M2019-11-17D,Race(10),,
7,0,0,0,0,0,0,1,1,0,0,2,2,0,0,3,3,31,31,0.0,M2019-11-17D,Race(10),,
2,0,0,0,0,0,1,0,1,0,0,0,0,0,1,0,1,34,34,0.0,M2019-11-17D,Race(10),,
1,0,2,12,14,2,17,3,22,1,8,5,14,3,27,20,50,15,15,0.0,M2019-11-17D,Race(10),,
6,4,0,5,9,0,4,4,8,1,3,3,7,5,7,12,24,8,8,0.0,M2019-11-17D,Race(2),,
8,0,6,3,9,0,1,2,3,0,0,2,2,0,7,7,14,15,15,2.0,M2019-11-17D,Race(2),,
1,0,0,0,0,0,0,0,0,0,0,0,0,0,0,0,0,34,34,0.0,M2019-11-17D,Race(2),,
2,0,0,0,0,0,0,1,1,0,0,0,0,0,0,1,1,41,41,0.0,M2019-11-17D,Race(2),,
3,7,10,7,24,18,5,4,27,12,5,5,22,37,20,16,73,3.5,3.5,3.0,M2019-11-17D,Race(2),,
4,3,0,0,3,0,0,0,0,0,0,0,0,3,0,0,3,12,12,0.0,M2019-11-17D,Race(2),,
5,0,4,0,4,1,0,0,1,1,2,0,3,2,6,0,8,31,31,0.0,M2019-11-17D,Race(2),,
7,0,5,4,9,0,1,1,2,3,1,2,6,3,7,7,17,21,21,0.0,M2019-11-17D,Race(2),,
9,0,0,0,0,0,0,1,1,0,0,1,1,0,0,2,2,26,26,0.0,M2019-11-17D,Race(2),,
10,0,0,6,6,0,0,3,3,0,1,6,7,0,1,15,16,11,11,0.0,M2019-11-17D,Race(2),,
11,0,0,5,5,0,4,12,16,0,5,3,8,0,9,20,29,14,14,0.0,M2019-11-17D,Race(2),,
12,16,5,0,21,11,15,2,28,9,9,4,22,36,29,6,71,2.6,2.6,1.0,M2019-11-17D,Race(2),,
1,0,4,0,4,15,7,3,25,8,6,2,16,23,17,5,45,6,6,0.0,M2019-11-17D,Race(3),,
12,16,2,8,26,4,4,13,21,6,4,5,15,26,10,26,62,4,4,2.0,M2019-11-17D,Race(3),,
13,5,6,7,18,0,0,4,4,1,0,8,9,6,6,19,31,4,4,0.0,M2019-11-17D,Race(3),,
7,5,2,2,9,1,0,3,4,1,2,1,4,7,4,6,17,14,19,0.0,M2019-11-17D,Race(3),,
11,0,0,0,0,0,0,0,0,0,0,0,0,0,0,0,0,26,26,0.0,M2019-11-17D,Race(3),,
10,0,0,0,0,0,0,0,0,0,0,0,0,0,0,0,0,126,126,0.0,M2019-11-17D,Race(3),,
9,0,0,0,0,0,0,0,0,0,1,0,1,0,1,0,1,51,51,0.0,M2019-11-17D,Race(3),,
2,0,0,0,0,0,0,0,0,0,0,0,0,0,0,0,0,81,81,0.0,M2019-11-17D,Race(3),,
6,2,5,6,13,7,17,1,25,5,7,2,14,14,29,9,52,6,6,0.0,M2019-11-17D,Race(3),,
5,0,0,0,0,0,0,0,0,0,0,0,0,0,0,0,0,71,67,0.0,M2019-11-17D,Race(3),,
4,0,0,2,2,2,1,3,6,1,3,6,10,3,4,11,18,21,21,0.0,M2019-11-17D,Race(3),,
14,0,5,3,8,0,0,1,1,0,0,1,1,0,5,5,10,8,8,1.0,M2019-11-17D,Race(3),,
3,2,6,2,10,1,1,2,4,4,3,1,8,7,10,5,22,9,9,0.0,M2019-11-17D,Race(3),,
8,0,0,0,0,0,0,0,0,0,0,0,0,0,0,0,0,61,61,3.0,M2019-11-17D,Race(3),,
1,0,7,9,16,2,2,3,7,0,4,8,12,2,13,20,35,7,7,0.0,M2019-11-17D,Race(4),,
7,0,6,3,9,0,0,2,2,0,0,3,3,0,6,8,14,12,12,2.0,M2019-11-17D,Race(4),,
3,5,7,4,16,3,15,3,21,6,5,1,12,14,27,8,49,5.5,5.5,1.0,M2019-11-17D,Race(4),,
2,4,3,2,9,2,5,12,19,4,1,8,13,10,9,22,41,10,10,0.0,M2019-11-17D,Race(4),,
8,0,0,0,0,0,0,0,0,0,0,0,0,0,0,0,0,34,34,0.0,M2019-11-17D,Race(4),,
9,18,2,4,24,20,4,4,28,13,10,1,24,51,16,9,76,2.9,3.4,0.0,M2019-11-17D,Race(4),,
12,0,0,0,0,0,0,0,0,0,0,0,0,0,0,0,0,23,21,0.0,M2019-11-17D,Race(4),,
6,3,0,0,3,0,0,2,2,0,0,0,0,3,0,2,5,8,8,0.0,M2019-11-17D,Race(4),,
5,0,0,2,2,0,1,2,3,1,2,4,7,1,3,8,12,26,26,0.0,M2019-11-17D,Race(4),,
4,0,0,0,0,1,0,0,1,0,1,0,1,1,1,0,2,18,18,0.0,M2019-11-17D,Race(4),,
13,0,0,0,0,0,0,0,0,0,0,0,0,0,0,0,0,34,34,0.0,M2019-11-17D,Race(4),,
14,0,3,0,3,1,0,1,2,0,0,1,1,1,3,2,6,14,14,3.0,M2019-11-17D,Race(4),,
10,0,2,6,8,1,3,1,5,2,3,0,5,3,8,7,18,15,15,0.0,M2019-11-17D,Race(4),,
11,0,0,0,0,0,0,0,0,0,0,0,0,0,0,0,0,81,81,0.0,M2019-11-17D,Race(4),,
6,2,0,3,5,1,2,2,5,1,3,2,6,4,5,7,16,9,9,2.0,M2019-11-17D,Race(5),,
14,8,7,8,23,1,3,13,17,1,2,7,10,10,12,28,50,3.7,3.7,1.0,M2019-11-17D,Race(5),,
1,7,6,9,22,22,4,3,29,14,2,4,20,43,12,16,71,6,6,0.0,M2019-11-17D,Race(5),,
13,0,7,0,7,0,0,0,0,0,0,0,0,0,7,0,7,21,21,0.0,M2019-11-17D,Race(5),,
12,8,5,5,18,1,1,2,4,2,1,2,5,11,7,9,27,6.5,6.5,0.0,M2019-11-17D,Race(5),,
11,0,0,0,0,0,0,1,1,0,0,1,1,0,0,2,2,17,17,0.0,M2019-11-17D,Race(5),,
10,0,2,0,2,0,3,1,4,0,1,1,2,0,6,2,8,61,61,0.0,M2019-11-17D,Race(5),,
3,2,3,0,5,2,1,1,4,1,3,1,5,5,7,2,14,10,10,0.0,M2019-11-17D,Race(5),,
2,3,0,5,8,1,16,5,22,4,8,2,14,8,24,12,44,14,14,0.0,M2019-11-17D,Race(5),,
8,0,0,0,0,0,0,0,0,0,0,0,0,0,0,0,0,126,126,0.0,M2019-11-17D,Race(5),,
7,0,0,0,0,0,0,0,0,0,1,0,1,0,1,0,1,81,81,0.0,M2019-11-17D,Race(5),,
4,0,0,0,0,0,0,0,0,0,0,0,0,0,0,0,0,101,101,0.0,M2019-11-17D,Race(5),,
5,0,0,0,0,0,0,1,1,0,3,2,5,0,3,3,6,6.5,6.5,3.0,M2019-11-17D,Race(5),,
9,0,0,0,0,2,0,1,3,3,2,4,9,5,2,5,12,10,10,0.0,M2019-11-17D,Race(5),,
1,28,0,2,30,27,3,0,30,25,1,0,26,80,4,2,86,1.26,1.26,3.0,M2019-11-17D,Race(6),,
2,0,25,0,25,3,27,0,30,1,22,3,26,4,74,3,81,3.7,3.7,1.0,M2019-11-17D,Race(6),,
3,0,0,3,3,0,0,0,0,0,0,1,1,0,0,4,4,21,21,0.0,M2019-11-17D,Race(6),,
4,2,0,0,2,0,0,0,0,0,0,1,1,2,0,1,3,26,27,0.0,M2019-11-17D,Race(6),,
5,0,2,19,21,0,0,29,29,0,3,21,24,0,5,69,74,11,11,2.0,M2019-11-17D,Race(6),,
6,0,0,6,6,0,0,0,0,0,0,0,0,0,0,6,6,41,41,0.0,M2019-11-17D,Race(6),,
7,0,3,0,3,0,0,1,1,0,0,0,0,0,3,1,4,34,35,0.0,M2019-11-17D,Race(6),,
7,0,0,2,2,0,1,1,2,0,0,2,2,0,1,5,6,17,17,0.0,M2019-11-17D,Race(7),,
1,25,5,0,30,25,4,1,30,22,4,0,26,72,13,1,86,2.6,2.7,1.0,M2019-11-17D,Race(7),,
2,2,2,2,6,1,2,3,6,0,3,3,6,3,7,8,18,16,17,0.0,M2019-11-17D,Race(7),,
3,3,15,6,24,4,19,4,27,4,13,7,24,11,47,17,75,3.9,3.8,0.0,M2019-11-17D,Race(7),,
4,0,6,13,19,0,0,4,4,0,3,8,11,0,9,25,34,6,5,3.0,M2019-11-17D,Race(7),,
5,0,0,0,0,0,1,1,2,0,1,0,1,0,2,1,3,11,10,0.0,M2019-11-17D,Race(7),,
8,0,0,3,3,0,1,2,3,0,2,2,4,0,3,7,10,11,10,2.0,M2019-11-17D,Race(7),,
9,0,0,0,0,0,0,0,0,0,0,0,0,0,0,0,0,34,35,0.0,M2019-11-17D,Race(7),,
6,0,2,4,6,0,2,14,16,0,0,4,4,0,4,22,26,8.5,8,0.0,M2019-11-17D,Race(7),,
1,7,9,5,21,16,4,6,26,9,5,6,20,32,18,17,67,6,7,3.0,M2019-11-17D,Race(8),,
2,2,12,0,14,0,1,2,3,1,1,2,4,3,14,4,21,6,5.5,0.0,M2019-11-17D,Race(8),,
3,0,0,2,2,1,0,0,1,0,2,0,2,1,2,2,5,13,9.5,0.0,M2019-11-17D,Race(8),,
4,0,0,0,0,0,0,1,1,0,2,2,4,0,2,3,5,9.5,8,2.0,M2019-11-17D,Race(8),,
5,3,0,0,3,0,0,0,0,1,1,1,3,4,1,1,6,14,13,0.0,M2019-11-17D,Race(8),,
10,0,0,3,3,0,1,1,2,1,0,3,4,1,1,7,9,17,15,0.0,M2019-11-17D,Race(8),,
6,0,0,0,0,0,0,0,0,0,0,0,0,0,0,0,0,16,17,0.0,M2019-11-17D,Race(8),,
8,3,0,2,5,0,0,2,2,0,0,2,2,3,0,6,9,17,21,0.0,M2019-11-17D,Race(8),,
11,7,5,5,17,9,16,1,26,9,5,2,16,25,26,8,59,4.8,6,0.0,M2019-11-17D,Race(8),,
12,0,0,0,0,0,0,0,0,0,0,0,0,0,0,0,0,101,71,0.0,M2019-11-17D,Race(8),,
13,0,0,8,8,1,0,1,2,1,1,3,5,2,1,12,15,23,27,0.0,M2019-11-17D,Race(8),,
14,8,4,5,17,3,7,16,26,4,8,5,17,15,19,26,60,3.9,4.2,1.0,M2019-11-17D,Race(8),,
9,0,0,0,0,0,1,0,1,0,1,0,1,0,2,0,2,71,71,0.0,M2019-11-17D,Race(8),,
7,0,0,0,0,0,0,0,0,0,0,0,0,0,0,0,0,34,35,0.0,M2019-11-17D,Race(8),,
2,0,3,0,3,0,0,0,0,0,0,0,0,0,3,0,3,19,19,0.0,M2019-11-17D,Race(9),,
3,0,0,3,3,0,1,2,3,1,4,2,7,1,5,7,13,17,17,2.0,M2019-11-17D,Race(9),,
4,4,2,5,11,1,1,3,5,5,0,5,10,10,3,13,26,11,11,0.0,M2019-11-17D,Race(9),,
5,0,0,0,0,0,0,0,0,0,2,0,2,0,2,0,2,51,51,0.0,M2019-11-17D,Race(9),,
6,6,8,12,26,7,17,2,26,6,8,5,19,19,33,19,71,3.8,3.8,0.0,M2019-11-17D,Race(9),,
8,0,0,0,0,0,0,0,0,0,0,0,0,0,0,0,0,51,51,0.0,M2019-11-17D,Race(9),,
9,0,0,0,0,0,0,0,0,0,0,0,0,0,0,0,0,71,67,0.0,M2019-11-17D,Race(9),,
10,0,0,2,2,0,0,4,4,0,0,5,5,0,0,11,11,26,26,0.0,M2019-11-17D,Race(9),,
11,5,8,6,19,5,2,13,20,3,6,4,13,13,16,23,52,4.6,4.6,1.0,M2019-11-17D,Race(9),,
13,0,0,0,0,1,1,3,5,0,0,1,1,1,1,4,6,34,34,0.0,M2019-11-17D,Race(9),,
14,0,0,0,0,0,0,0,0,0,0,0,0,0,0,0,0,51,51,0.0,M2019-11-17D,Race(9),,
12,0,2,0,2,0,0,0,0,0,0,0,0,0,2,0,2,17,17,3.0,M2019-11-17D,Race(9),,
7,13,5,2,20,16,5,2,23,11,3,3,17,40,13,7,60,3,3,0.0,M2019-11-17D,Race(9),,
1,2,2,0,4,0,3,1,4,0,3,1,4,2,8,2,12,16,16,0.0,M2019-11-17D,Race(9),,
8,0,19,4,23,4,6,0,10,7,3,4,14,11,28,8,47,4.8,4.8,0.0,M2019-11-20D,Race(1),,
11,0,0,0,0,0,0,0,0,0,0,0,0,0,0,0,0,41,41,0.0,M2019-11-20D,Race(1),,
10,2,0,0,2,1,3,8,12,0,4,1,5,3,7,9,19,16,16,0.0,M2019-11-20D,Race(1),,
9,0,0,3,3,0,1,0,1,0,0,0,0,0,1,3,4,13,13,0.0,M2019-11-20D,Race(1),,
12,0,0,0,0,0,0,0,0,0,0,0,0,0,0,0,0,61,61,0.0,M2019-11-20D,Race(1),,
2,8,2,5,15,8,8,3,19,6,7,2,15,22,17,10,49,6.5,6.5,2.0,M2019-11-20D,Race(1),,
3,0,2,6,8,8,4,3,15,1,6,6,13,9,12,15,36,18,18,0.0,M2019-11-20D,Race(1),,
1,0,0,0,0,0,2,2,4,0,0,2,2,0,2,4,6,18,18,1.0,M2019-11-20D,Race(1),,
5,18,0,5,23,7,3,5,15,5,2,5,12,30,5,15,50,2.7,2.7,0.0,M2019-11-20D,Race(1),,
6,2,2,0,4,0,1,2,3,0,0,1,1,2,3,3,8,11,11,3.0,M2019-11-20D,Race(1),,
7,0,0,0,0,0,0,0,0,0,0,0,0,0,0,0,0,16,16,0.0,M2019-11-20D,Race(1),,
4,0,5,7,12,2,2,7,11,7,4,5,16,9,11,19,39,10,10,0.0,M2019-11-20D,Race(1),,
10,0,2,13,15,5,7,5,17,5,6,3,14,10,15,21,46,6.5,6.5,0.0,M2019-11-20D,Race(2),,
8,0,0,3,3,8,0,0,8,0,0,0,0,8,0,3,11,26,26,0.0,M2019-11-20D,Race(2),,
7,0,11,8,19,6,5,6,17,9,6,5,20,15,22,19,56,5,5,0.0,M2019-11-20D,Race(2),,
6,4,5,0,9,0,0,2,2,1,1,4,6,5,6,6,17,7,7,1.0,M2019-11-20D,Race(2),,
4,0,0,0,0,0,0,0,0,0,0,0,0,0,0,0,0,71,71,0.0,M2019-11-20D,Race(2),,
11,5,0,0,5,0,8,2,10,2,3,2,7,7,11,4,22,10,10,0.0,M2019-11-20D,Race(2),,
12,0,7,2,9,0,0,9,9,0,0,2,2,0,7,13,20,9,9,0.0,M2019-11-20D,Race(2),,
3,0,3,0,3,0,0,0,0,0,1,1,2,0,4,1,5,12,12,3.0,M2019-11-20D,Race(2),,
5,0,0,2,2,0,2,3,5,1,0,4,5,1,2,9,12,9,9,0.0,M2019-11-20D,Race(2),,
1,21,2,2,25,11,8,3,22,7,9,5,21,39,19,10,68,3.6,3.6,2.0,M2019-11-20D,Race(2),,
9,0,0,0,0,0,0,0,0,0,0,0,0,0,0,0,0,31,31,0.0,M2019-11-20D,Race(2),,
2,0,0,0,0,0,0,0,0,1,0,0,1,1,0,0,1,71,67,0.0,M2019-11-20D,Race(2),,
9,3,2,0,5,0,0,0,0,1,0,0,1,4,2,0,6,11,11,0.0,M2019-11-20D,Race(3),,
8,0,0,0,0,0,8,3,11,0,1,7,8,0,9,10,19,20,20,0.0,M2019-11-20D,Race(3),,
10,0,2,7,9,2,2,5,9,1,4,6,11,3,8,18,29,7,7,0.0,M2019-11-20D,Race(3),,
12,0,0,0,0,0,0,0,0,0,0,0,0,0,0,0,0,71,67,0.0,M2019-11-20D,Race(3),,
11,0,0,0,0,0,0,0,0,0,0,0,0,0,0,0,0,51,51,3.0,M2019-11-20D,Race(3),,
7,0,0,0,0,0,0,0,0,0,1,0,1,0,1,0,1,31,31,0.0,M2019-11-20D,Race(3),,
6,0,0,2,2,0,0,0,0,0,0,0,0,0,0,2,2,51,51,0.0,M2019-11-20D,Race(3),,
5,0,0,2,2,8,0,0,8,0,0,0,0,8,0,2,10,71,67,0.0,M2019-11-20D,Race(3),,
4,8,3,8,19,7,5,7,19,7,7,5,19,22,15,20,57,5,5,2.0,M2019-11-20D,Race(3),,
3,9,10,6,25,3,6,10,19,5,6,2,13,17,22,18,57,3,3,1.0,M2019-11-20D,Race(3),,
2,2,5,2,9,0,4,3,7,1,1,5,7,3,10,10,23,9,9,0.0,M2019-11-20D,Race(3),,
1,8,8,3,19,10,5,2,17,11,6,1,18,29,19,6,54,4,4,0.0,M2019-11-20D,Race(3),,
9,14,9,0,23,3,8,5,16,1,2,7,10,18,19,12,49,4,4,0.0,M2019-11-20D,Race(4),,
6,0,0,0,0,0,0,0,0,0,0,0,0,0,0,0,0,101,101,0.0,M2019-11-20D,Race(4),,
7,0,0,3,3,1,0,0,1,1,1,0,2,2,1,3,6,26,26,0.0,M2019-11-20D,Race(4),,
4,7,3,0,10,6,4,1,11,6,4,2,12,19,11,3,33,4.6,4.6,0.0,M2019-11-20D,Race(4),,
5,2,0,2,4,0,0,2,2,2,0,2,4,4,0,6,10,10,10,3.0,M2019-11-20D,Race(4),,
3,5,5,11,21,7,5,4,16,5,1,2,8,17,11,17,45,3.7,3.7,0.0,M2019-11-20D,Race(4),,
12,0,0,3,3,0,0,0,0,0,0,0,0,0,0,3,3,26,26,1.0,M2019-11-20D,Race(4),,
2,0,0,0,0,8,2,0,10,2,2,0,4,10,4,0,14,21,21,0.0,M2019-11-20D,Race(4),,
11,0,3,2,5,2,0,4,6,2,2,6,10,4,5,12,21,13,13,0.0,M2019-11-20D,Race(4),,
8,0,0,0,0,0,3,1,4,0,6,1,7,0,9,2,11,14,14,0.0,M2019-11-20D,Race(4),,
10,2,10,7,19,3,8,5,16,7,8,3,18,12,26,15,53,10,10,2.0,M2019-11-20D,Race(4),,
1,0,0,2,2,0,0,8,8,0,0,3,3,0,0,13,13,17,17,0.0,M2019-11-20D,Race(4),,
9,0,0,3,3,0,0,0,0,0,0,0,0,0,0,3,3,34,34,0.0,M2019-11-20D,Race(5),,
5,7,5,2,14,2,3,3,8,0,2,1,3,9,10,6,25,4.6,4.6,1.0,M2019-11-20D,Race(5),,
12,0,0,0,0,0,0,0,0,0,0,0,0,0,0,0,0,81,81,0.0,M2019-11-20D,Race(5),,
1,13,10,2,25,9,8,3,20,8,10,2,20,30,28,7,65,3,3,0.0,M2019-11-20D,Race(5),,
2,0,6,2,8,1,2,9,12,3,1,11,15,4,9,22,35,13,13,0.0,M2019-11-20D,Race(5),,
3,0,2,16,18,9,8,2,19,11,8,3,22,20,18,21,59,5.5,5.5,0.0,M2019-11-20D,Race(5),,
4,3,0,0,3,0,0,9,9,0,1,1,2,3,1,10,14,7.5,7.5,3.0,M2019-11-20D,Race(5),,
6,2,0,0,2,1,8,2,11,2,2,3,7,5,10,5,20,9,9,0.0,M2019-11-20D,Race(5),,
7,0,0,0,0,0,0,0,0,0,0,0,0,0,0,0,0,31,31,0.0,M2019-11-20D,Race(5),,
8,0,0,0,0,0,0,0,0,0,0,0,0,0,0,0,0,126,126,0.0,M2019-11-20D,Race(5),,
10,2,0,0,2,0,0,0,0,2,1,2,5,4,1,2,7,31,31,2.0,M2019-11-20D,Race(5),,
11,3,7,5,15,8,1,2,11,0,1,3,4,11,9,10,30,9,9,0.0,M2019-11-20D,Race(5),,
7,0,0,0,0,0,0,0,0,0,0,0,0,0,0,0,0,101,101,0.0,M2019-11-20D,Race(6),,
8,0,2,5,7,0,0,0,0,0,0,0,0,0,2,5,7,13,13,0.0,M2019-11-20D,Race(6),,
9,0,0,2,2,0,0,1,1,3,2,0,5,3,2,3,8,21,21,0.0,M2019-11-20D,Race(6),,
2,4,0,6,10,5,2,5,12,6,1,5,12,15,3,16,34,9,9,2.0,M2019-11-20D,Race(6),,
11,0,0,3,3,8,1,0,9,1,0,1,2,9,1,4,14,34,34,0.0,M2019-11-20D,Race(6),,
12,12,8,10,30,5,12,4,21,6,14,3,23,23,34,17,74,3.2,3.2,1.0,M2019-11-20D,Race(6),,
6,0,3,0,3,0,0,0,0,0,0,0,0,0,3,0,3,21,21,0.0,M2019-11-20D,Race(6),,
10,0,8,2,10,5,8,6,19,2,1,6,9,7,17,14,38,7,7,0.0,M2019-11-20D,Race(6),,
5,0,0,0,0,1,0,0,1,2,1,1,4,3,1,1,5,21,21,0.0,M2019-11-20D,Race(6),,
3,0,0,0,0,0,0,8,8,0,1,0,1,0,1,8,9,34,34,0.0,M2019-11-20D,Race(6),,
4,0,0,0,0,0,2,4,6,0,2,7,9,0,4,11,15,15,15,0.0,M2019-11-20D,Race(6),,
1,14,9,2,25,6,5,2,13,6,4,3,13,26,18,7,51,2.75,2.8,3.0,M2019-11-20D,Race(6),,
2,0,2,8,10,1,2,2,5,4,0,4,8,5,4,14,23,11,11,0.0,M2019-11-20D,Race(7),,
6,2,0,0,2,0,0,1,1,0,0,0,0,2,0,1,3,17,17,0.0,M2019-11-20D,Race(7),,
12,2,3,2,7,0,4,0,4,1,2,0,3,3,9,2,14,10,10,0.0,M2019-11-20D,Race(7),,
11,0,2,6,8,0,0,0,0,0,0,0,0,0,2,6,8,21,21,1.0,M2019-11-20D,Race(7),,
10,4,0,5,9,1,9,3,13,0,2,2,4,5,11,10,26,5,5,0.0,M2019-11-20D,Race(7),,
9,0,0,3,3,0,0,2,2,0,1,4,5,0,1,9,10,17,17,2.0,M2019-11-20D,Race(7),,
1,0,3,0,3,0,4,8,12,1,5,3,9,1,12,11,24,34,34,0.0,M2019-11-20D,Race(7),,
3,16,7,2,25,23,3,4,30,15,6,4,25,54,16,10,80,2.8,2.8,3.0,M2019-11-20D,Race(7),,
4,0,0,0,0,0,3,2,5,0,2,3,5,0,5,5,10,17,17,0.0,M2019-11-20D,Race(7),,
8,0,0,0,0,0,0,0,0,0,0,0,0,0,0,0,0,31,31,0.0,M2019-11-20D,Race(7),,
5,6,13,0,19,1,2,4,7,2,5,5,12,9,20,9,38,6.5,6.5,0.0,M2019-11-20D,Race(7),,
7,0,0,4,4,4,3,4,11,3,3,1,7,7,6,9,22,11,11,0.0,M2019-11-20D,Race(7),,
9,0,0,0,0,1,0,0,1,1,0,0,1,2,0,0,2,21,21,0.0,M2019-11-20D,Race(8),,
10,8,2,3,13,3,10,5,18,2,5,5,12,13,17,13,43,3.2,3.2,2.0,M2019-11-20D,Race(8),,
5,6,3,5,14,0,1,2,3,0,1,3,4,6,5,10,21,12,12,0.0,M2019-11-20D,Race(8),,
2,0,0,0,0,0,0,0,0,1,1,0,2,1,1,0,2,13,13,0.0,M2019-11-20D,Race(8),,
3,0,0,5,5,0,0,0,0,2,2,1,5,2,2,6,10,10,10,3.0,M2019-11-20D,Race(8),,
1,5,8,7,20,16,3,8,27,9,2,6,17,30,13,21,64,5.5,5.5,1.0,M2019-11-20D,Race(8),,
8,3,5,7,15,0,1,1,2,1,2,1,4,4,8,9,21,16,16,0.0,M2019-11-20D,Race(8),,
12,3,2,0,5,1,0,0,1,1,0,1,2,5,2,1,8,31,31,0.0,M2019-11-20D,Race(8),,
11,0,0,0,0,2,2,0,4,2,2,0,4,4,4,0,8,12,12,0.0,M2019-11-20D,Race(8),,
4,5,0,0,5,3,5,9,17,2,2,4,8,10,7,13,30,10,10,0.0,M2019-11-20D,Race(8),,
7,0,8,3,11,4,8,5,17,5,9,5,19,9,25,13,47,7,7,0.0,M2019-11-20D,Race(8),,
6,0,2,0,2,0,0,0,0,0,0,0,0,0,2,0,2,19,19,0.0,M2019-11-20D,Race(8),,
8,0,0,0,0,0,0,0,0,0,0,0,0,0,0,0,0,19,19,0.0,M2019-11-20D,Race(9),,
4,0,4,0,4,0,10,2,12,1,0,0,1,1,14,2,17,10,10,0.0,M2019-11-20D,Race(9),,
5,0,0,0,0,5,4,2,11,6,9,2,17,11,13,4,28,15,15,1.0,M2019-11-20D,Race(9),,
6,0,7,7,14,1,1,2,4,3,4,1,8,4,12,10,26,7.5,7.5,3.0,M2019-11-20D,Race(9),,
7,2,0,3,5,1,1,2,4,0,0,7,7,3,1,12,16,19,19,0.0,M2019-11-20D,Race(9),,
9,0,0,0,0,0,0,0,0,0,0,0,0,0,0,0,0,51,51,0.0,M2019-11-20D,Race(9),,
1,14,11,3,28,10,8,2,20,7,5,4,16,31,24,9,64,3,3,0.0,M2019-11-20D,Race(9),,
10,2,0,7,9,2,0,9,11,3,0,2,5,7,0,18,25,21,21,0.0,M2019-11-20D,Race(9),,
11,6,5,7,18,12,8,7,27,5,7,8,20,23,20,22,65,3.5,3.5,2.0,M2019-11-20D,Race(9),,
12,0,0,0,0,0,0,0,0,0,0,0,0,0,0,0,0,21,21,0.0,M2019-11-20D,Race(9),,
2,6,3,3,12,0,0,1,1,1,0,1,2,7,3,5,15,14,14,0.0,M2019-11-20D,Race(9),,
3,0,0,0,0,0,0,0,0,0,1,1,2,0,1,1,2,15,15,0.0,M2019-11-20D,Race(9),,
1,0,0,0,0,1,0,0,1,1,0,0,1,2,0,0,2,16,16,0.0,M2019-11-23D,Race(1),,
6,0,0,2,2,0,0,0,0,0,0,0,0,0,0,2,2,81,81,3.0,M2019-11-23D,Race(1),,
10,0,0,0,0,1,1,1,3,1,0,1,2,2,1,2,5,4.8,4.8,0.0,M2019-11-23D,Race(1),,
7,4,0,0,4,0,2,0,2,0,3,3,6,4,5,3,12,21,21,0.0,M2019-11-23D,Race(1),,
8,6,3,3,12,3,0,5,8,6,4,4,14,15,7,12,34,4.6,4.6,0.0,M2019-11-23D,Race(1),,
9,0,0,0,0,0,0,0,0,0,0,0,0,0,0,0,0,81,81,0.0,M2019-11-23D,Race(1),,
11,0,4,5,9,0,1,1,2,0,0,5,5,0,5,11,16,10,10,0.0,M2019-11-23D,Race(1),,
12,2,2,0,4,0,1,0,1,0,1,0,1,2,4,0,6,19,19,0.0,M2019-11-23D,Race(1),,
5,3,2,5,10,4,4,14,22,1,5,7,13,8,11,26,45,9,9,2.0,M2019-11-23D,Race(1),,
3,12,5,13,30,20,4,3,27,13,4,1,18,45,13,17,75,4,4,0.0,M2019-11-23D,Race(1),,
4,0,3,2,5,0,2,0,2,2,1,0,3,2,6,2,10,19,19,0.0,M2019-11-23D,Race(1),,
2,3,11,0,14,1,15,6,22,2,8,5,15,6,34,11,51,6.5,6.5,1.0,M2019-11-23D,Race(1),,
11,3,6,3,12,0,2,1,3,0,6,2,8,3,14,6,23,17,17,0.0,M2019-11-23D,Race(10),,
12,2,0,5,7,0,0,1,1,0,0,0,0,2,0,6,8,14,14,3.0,M2019-11-23D,Race(10),,
13,0,2,0,2,0,0,2,2,0,0,5,5,0,2,7,9,31,31,0.0,M2019-11-23D,Race(10),,
14,0,0,0,0,0,0,0,0,1,0,0,1,1,0,0,1,61,61,0.0,M2019-11-23D,Race(10),,
2,0,5,0,5,0,1,1,2,0,1,0,1,0,7,1,8,21,21,0.0,M2019-11-23D,Race(10),,
1,22,3,5,30,27,3,0,30,24,2,0,26,73,8,5,86,2,2,1.0,M2019-11-23D,Race(10),,
3,0,0,0,0,1,0,1,2,0,0,0,0,1,0,1,2,34,34,0.0,M2019-11-23D,Race(10),,
4,0,0,0,0,1,0,1,2,1,1,1,3,2,1,2,5,18,18,0.0,M2019-11-23D,Race(10),,
5,0,0,3,3,1,1,0,2,0,2,0,2,1,3,3,7,26,26,0.0,M2019-11-23D,Race(10),,
6,0,0,0,0,0,0,0,0,0,0,0,0,0,0,0,0,31,31,0.0,M2019-11-23D,Race(10),,
7,3,10,8,21,0,18,4,22,0,6,10,16,3,34,22,59,6,6,0.0,M2019-11-23D,Race(10),,
8,0,4,2,6,0,4,14,18,0,7,2,9,0,15,18,33,8.5,8.5,2.0,M2019-11-23D,Race(10),,
9,0,0,2,2,0,1,3,4,0,1,5,6,0,2,10,12,19,19,0.0,M2019-11-23D,Race(10),,
10,0,0,2,2,0,0,2,2,0,0,1,1,0,0,5,5,17,17,0.0,M2019-11-23D,Race(10),,
10,0,2,0,2,1,0,0,1,0,0,1,1,1,2,1,4,26,26,0.0,M2019-11-23D,Race(2),,
8,0,0,0,0,0,2,3,5,0,0,1,1,0,2,4,6,15,15,0.0,M2019-11-23D,Race(2),,
2,16,10,4,30,6,16,5,27,10,7,0,17,32,33,9,74,2.8,2.8,3.0,M2019-11-23D,Race(2),,
3,0,0,0,0,0,0,0,0,0,0,4,4,0,0,4,4,126,126,0.0,M2019-11-23D,Race(2),,
9,6,7,12,25,18,8,2,28,10,9,3,22,34,24,17,75,3.3,3.3,0.0,M2019-11-23D,Race(2),,
5,2,3,3,8,3,2,17,22,4,5,8,17,9,10,28,47,11,11,1.0,M2019-11-23D,Race(2),,
6,2,2,0,4,0,0,0,0,0,0,3,3,2,2,3,7,21,21,0.0,M2019-11-23D,Race(2),,
1,0,0,3,3,1,1,1,3,0,2,2,4,1,3,6,10,12,12,0.0,M2019-11-23D,Race(2),,
4,2,6,5,13,1,1,1,3,2,2,1,5,5,9,7,21,6,7,2.0,M2019-11-23D,Race(2),,
12,0,0,3,3,0,0,1,1,0,0,2,2,0,0,6,6,21,21,0.0,M2019-11-23D,Race(2),,
14,2,0,0,2,0,0,0,0,0,0,0,0,2,0,0,2,34,34,0.0,M2019-11-23D,Race(2),,
11,0,0,0,0,0,0,0,0,0,0,0,0,0,0,0,0,81,81,0.0,M2019-11-23D,Race(2),,
7,0,0,0,0,0,0,0,0,0,1,1,2,0,1,1,2,41,41,0.0,M2019-11-23D,Race(2),,
13,0,0,0,0,0,0,0,0,0,0,0,0,0,0,0,0,41,41,0.0,M2019-11-23D,Race(2),,
8,0,0,0,0,0,0,1,1,0,0,2,2,0,0,3,3,31,31,3.0,M2019-11-23D,Race(3),,
14,0,0,0,0,0,0,1,1,0,0,2,2,0,0,3,3,41,41,0.0,M2019-11-23D,Race(3),,
13,0,0,2,2,0,0,0,0,0,0,0,0,0,0,2,2,17,17,0.0,M2019-11-23D,Race(3),,
12,2,0,0,2,0,0,0,0,0,0,1,1,2,0,1,3,21,21,2.0,M2019-11-23D,Race(3),,
9,0,0,2,2,0,2,1,3,0,1,4,5,0,3,7,10,17,17,0.0,M2019-11-23D,Race(3),,
7,0,0,0,0,0,0,0,0,0,0,0,0,0,0,0,0,61,61,0.0,M2019-11-23D,Race(3),,
5,0,11,2,13,2,1,17,20,2,2,6,10,4,14,25,43,7.5,7.5,0.0,M2019-11-23D,Race(3),,
4,23,5,0,28,25,3,2,30,16,7,1,24,64,15,3,82,1.95,2,1.0,M2019-11-23D,Race(3),,
3,0,0,7,7,0,0,4,4,0,0,4,4,0,0,15,15,16,16,0.0,M2019-11-23D,Race(3),,
11,0,0,0,0,0,0,0,0,0,0,0,0,0,0,0,0,101,101,0.0,M2019-11-23D,Race(3),,
1,5,12,6,23,2,21,2,25,7,12,2,21,14,45,10,69,5,5,0.0,M2019-11-23D,Race(3),,
10,0,0,0,0,1,0,0,1,0,0,0,0,1,0,0,1,41,41,0.0,M2019-11-23D,Race(3),,
6,0,2,11,13,0,3,2,5,1,4,4,9,1,9,17,27,10,10,0.0,M2019-11-23D,Race(3),,
2,0,0,0,0,0,0,0,0,0,0,0,0,0,0,0,0,101,101,0.0,M2019-11-23D,Race(3),,
4,3,3,5,11,3,1,1,5,3,5,1,9,9,9,7,25,10,10,0.0,M2019-11-23D,Race(4),,
12,0,0,0,0,0,0,0,0,0,0,1,1,0,0,1,1,81,81,0.0,M2019-11-23D,Race(4),,
8,3,5,7,15,4,13,2,19,8,11,1,20,15,29,10,54,6.5,6.5,1.0,M2019-11-23D,Race(4),,
7,0,0,0,0,0,0,0,0,0,0,0,0,0,0,0,0,81,81,0.0,M2019-11-23D,Race(4),,
5,2,0,0,2,0,0,0,0,0,0,0,0,2,0,0,2,34,34,0.0,M2019-11-23D,Race(4),,
9,0,0,0,0,0,0,0,0,0,0,0,0,0,0,0,0,51,51,0.0,M2019-11-23D,Race(4),,
2,0,0,0,0,1,2,0,3,1,2,0,3,2,4,0,6,19,19,0.0,M2019-11-23D,Race(4),,
1,2,0,3,5,0,1,1,2,3,0,2,5,5,1,6,12,21,21,0.0,M2019-11-23D,Race(4),,
10,0,3,0,3,0,1,0,1,0,2,0,2,0,6,0,6,19,19,2.0,M2019-11-23D,Race(4),,
3,7,4,3,14,4,1,2,7,0,2,4,6,11,7,9,27,5.5,5.5,3.0,M2019-11-23D,Race(4),,
11,5,8,3,16,4,5,14,23,4,3,6,13,13,16,23,52,4.2,4.2,0.0,M2019-11-23D,Race(4),,
13,2,3,3,8,12,3,6,21,7,1,3,11,21,7,12,40,13,13,0.0,M2019-11-23D,Race(4),,
14,6,2,2,10,1,1,3,5,0,0,6,6,7,3,11,21,4,4,0.0,M2019-11-23D,Race(4),,
6,0,2,4,6,1,2,1,4,0,0,2,2,1,4,7,12,19,19,0.0,M2019-11-23D,Race(4),,
7,9,9,5,23,17,7,3,27,12,7,3,22,38,23,11,72,3.2,3.2,1.0,M2019-11-23D,Race(5),,
12,0,0,0,0,0,0,0,0,0,0,0,0,0,0,0,0,17,17,3.0,M2019-11-23D,Race(5),,
5,3,0,0,3,0,1,0,1,2,1,0,3,5,2,0,7,9.5,10,0.0,M2019-11-23D,Race(5),,
4,0,3,0,3,0,1,1,2,0,1,1,2,0,5,2,7,15,13,0.0,M2019-11-23D,Race(5),,
9,0,4,11,15,1,4,3,8,0,3,8,11,1,11,22,34,9,9,0.0,M2019-11-23D,Race(5),,
8,2,2,5,9,0,0,3,3,2,1,3,6,4,3,11,18,8,8,0.0,M2019-11-23D,Race(5),,
3,0,0,0,0,0,0,1,1,0,0,0,0,0,0,1,1,71,67,0.0,M2019-11-23D,Race(5),,
10,0,0,0,0,0,0,1,1,0,0,2,2,0,0,3,3,34,34,0.0,M2019-11-23D,Race(5),,
1,11,2,4,17,9,13,5,27,5,6,5,16,25,21,14,60,7,7,0.0,M2019-11-23D,Race(5),,
2,0,0,0,0,0,0,0,0,0,0,0,0,0,0,0,0,71,67,2.0,M2019-11-23D,Race(5),,
6,5,7,3,15,3,4,13,20,5,7,4,16,13,18,20,51,4.4,4.4,0.0,M2019-11-23D,Race(5),,
11,0,3,2,5,0,0,0,0,0,0,0,0,0,3,2,5,15,15,0.0,M2019-11-23D,Race(5),,
1,0,2,0,2,0,2,1,3,0,1,5,6,0,5,6,11,7,7,0.0,M2019-11-23D,Race(6),,
5,11,13,6,30,8,14,4,26,6,9,4,19,25,36,14,75,3.3,3.3,0.0,M2019-11-23D,Race(6),,
8,0,8,10,18,4,4,12,20,9,4,4,17,13,16,26,55,9,9,0.0,M2019-11-23D,Race(6),,
9,0,0,3,3,1,2,2,5,0,2,1,3,1,4,6,11,14,14,0.0,M2019-11-23D,Race(6),,
10,0,0,0,0,0,1,4,5,1,1,3,5,1,2,7,10,6.5,6.5,3.0,M2019-11-23D,Race(6),,
11,2,0,3,5,2,1,2,5,2,2,3,7,6,3,8,17,9,9,2.0,M2019-11-23D,Race(6),,
12,0,0,0,0,0,0,0,0,1,0,0,1,1,0,0,1,71,71,0.0,M2019-11-23D,Race(6),,
13,0,0,0,0,0,0,0,0,0,0,0,0,0,0,0,0,51,51,0.0,M2019-11-23D,Race(6),,
14,6,0,0,6,0,0,1,1,0,1,0,1,6,1,1,8,16,16,0.0,M2019-11-23D,Race(6),,
3,0,0,0,0,0,0,0,0,0,0,0,0,0,0,0,0,34,34,0.0,M2019-11-23D,Race(6),,
7,0,3,0,3,0,0,1,1,1,0,1,2,1,3,2,6,26,26,0.0,M2019-11-23D,Race(6),,
6,0,0,2,2,0,0,0,0,0,0,0,0,0,0,2,2,81,81,0.0,M2019-11-23D,Race(6),,
4,0,0,0,0,0,0,0,0,0,1,0,1,0,1,0,1,101,101,0.0,M2019-11-23D,Race(6),,
2,11,4,6,21,15,6,3,24,6,5,5,16,32,15,14,61,5,5,1.0,M2019-11-23D,Race(6),,
2,5,2,5,12,15,5,2,22,11,1,2,14,31,8,9,48,5,5,0.0,M2019-11-23D,Race(7),,
1,0,5,5,10,7,12,4,23,2,4,5,11,9,21,14,44,8.5,8.5,0.0,M2019-11-23D,Race(7),,
5,0,0,0,0,0,0,0,0,0,2,0,2,0,2,0,2,31,31,0.0,M2019-11-23D,Race(7),,
7,0,0,3,3,0,1,1,2,0,0,1,1,0,1,5,6,31,31,0.0,M2019-11-23D,Race(7),,
8,7,13,3,23,4,2,12,18,9,2,4,15,20,17,19,56,4.6,4.5,2.0,M2019-11-23D,Race(7),,
9,0,0,0,0,0,0,0,0,0,0,0,0,0,0,0,0,34,34,0.0,M2019-11-23D,Race(7),,
10,0,0,0,0,0,0,0,0,0,1,0,1,0,1,0,1,15,15,0.0,M2019-11-23D,Race(7),,
11,5,0,7,12,1,1,5,7,0,3,7,10,6,4,19,29,6,6,1.0,M2019-11-23D,Race(7),,
3,13,7,2,22,3,5,4,12,2,6,3,11,18,18,9,45,5,5,0.0,M2019-11-23D,Race(7),,
4,0,0,0,0,0,2,0,2,1,3,0,4,1,5,0,6,26,26,0.0,M2019-11-23D,Race(7),,
14,0,3,0,3,0,0,0,0,0,1,0,1,0,4,0,4,26,26,0.0,M2019-11-23D,Race(7),,
6,0,0,0,0,0,1,2,3,0,3,4,7,0,4,6,10,13,13,0.0,M2019-11-23D,Race(7),,
13,0,0,2,2,0,1,0,1,1,0,0,1,1,1,2,4,34,34,3.0,M2019-11-23D,Race(7),,
12,0,0,3,3,0,0,0,0,0,0,0,0,0,0,3,3,34,34,0.0,M2019-11-23D,Race(7),,
1,3,0,6,9,0,1,1,2,0,3,3,6,3,4,10,17,15,15,0.0,M2019-11-23D,Race(8),,
2,2,10,6,18,2,2,22,26,2,1,11,14,6,13,39,58,4,4,0.0,M2019-11-23D,Race(8),,
3,0,3,0,3,0,0,0,0,1,1,0,2,1,4,0,5,19,19,3.0,M2019-11-23D,Race(8),,
4,3,7,3,13,0,0,2,2,0,2,4,6,3,9,9,21,4.8,4.8,2.0,M2019-11-23D,Race(8),,
6,0,0,0,0,0,0,0,0,0,0,0,0,0,0,0,0,26,26,0.0,M2019-11-23D,Race(8),,
7,10,0,9,19,19,8,3,30,13,9,4,26,42,17,16,75,3.2,3.2,0.0,M2019-11-23D,Race(8),,
5,0,0,0,0,0,0,0,0,0,0,0,0,0,0,0,0,71,67,0.0,M2019-11-23D,Race(8),,
12,0,0,0,0,0,0,0,0,0,0,0,0,0,0,0,0,81,81,0.0,M2019-11-23D,Race(8),,
11,0,0,0,0,0,0,0,0,0,0,1,1,0,0,1,1,41,41,0.0,M2019-11-23D,Race(8),,
10,0,0,0,0,0,0,0,0,0,0,0,0,0,0,0,0,81,81,0.0,M2019-11-23D,Race(8),,
9,10,10,6,26,9,19,2,30,10,10,3,23,29,39,11,79,4.2,4.2,1.0,M2019-11-23D,Race(8),,
8,2,0,0,2,0,0,0,0,0,0,0,0,2,0,0,2,21,21,0.0,M2019-11-23D,Race(8),,
2,16,12,0,28,14,5,7,26,7,4,10,21,37,21,17,75,2.45,2.4,0.0,M2019-11-23D,Race(9),,
14,0,2,0,2,0,0,0,0,0,0,0,0,0,2,0,2,15,16,0.0,M2019-11-23D,Race(9),,
13,0,0,0,0,0,0,0,0,0,0,0,0,0,0,0,0,10,10,0.0,M2019-11-23D,Race(9),,
3,0,3,3,6,1,0,0,1,0,1,0,1,1,4,3,8,31,31,0.0,M2019-11-23D,Race(9),,
4,6,2,0,8,5,5,2,12,8,4,3,15,19,11,5,35,11,11,1.0,M2019-11-23D,Race(9),,
11,0,0,0,0,0,0,0,0,0,0,0,0,0,0,0,0,61,61,0.0,M2019-11-23D,Race(9),,
10,0,0,0,0,0,0,0,0,0,0,0,0,0,0,0,0,81,81,0.0,M2019-11-23D,Race(9),,
9,0,0,0,0,0,0,0,0,0,0,0,0,0,0,0,0,41,41,0.0,M2019-11-23D,Race(9),,
8,6,4,10,20,3,3,12,18,2,5,7,14,11,12,29,52,5,5,0.0,M2019-11-23D,Race(9),,
7,0,3,0,3,0,0,2,2,0,2,1,3,0,5,3,8,12,12,0.0,M2019-11-23D,Race(9),,
6,0,2,5,7,0,1,1,2,0,0,0,0,0,3,6,9,51,51,0.0,M2019-11-23D,Race(9),,
5,0,0,0,0,0,0,0,0,0,0,0,0,0,0,0,0,23,26,0.0,M2019-11-23D,Race(9),,
12,0,0,7,7,1,0,0,1,2,0,1,3,3,0,8,11,16,16,3.0,M2019-11-23D,Race(9),,
1,2,2,5,9,6,16,6,28,7,10,4,21,15,28,15,58,8.5,8.5,2.0,M2019-11-23D,Race(9),,
1,6,10,9,25,11,7,4,22,4,4,4,12,21,21,17,59,5.5,5.5,0.0,M2019-11-27D,Race(1),,
11,0,0,3,3,0,0,0,0,0,2,3,5,0,2,6,8,11,11,0.0,M2019-11-27D,Race(1),,
10,0,0,0,0,0,0,0,0,0,0,0,0,0,0,0,0,71,67,0.0,M2019-11-27D,Race(1),,
9,0,0,0,0,0,0,0,0,1,1,0,2,1,1,0,2,31,31,0.0,M2019-11-27D,Race(1),,
8,0,0,0,0,0,0,0,0,0,0,1,1,0,0,1,1,26,26,0.0,M2019-11-27D,Race(1),,
6,5,6,4,15,0,6,9,15,1,6,5,12,6,18,18,42,6,6,1.0,M2019-11-27D,Race(1),,
5,0,0,0,0,0,0,0,0,0,0,0,0,0,0,0,0,51,51,0.0,M2019-11-27D,Race(1),,
4,11,9,2,22,16,5,8,29,13,3,3,19,40,17,13,70,3.4,3.4,3.0,M2019-11-27D,Race(1),,
3,0,0,5,5,0,1,0,1,0,0,0,0,0,1,5,6,15,15,0.0,M2019-11-27D,Race(1),,
2,0,0,2,2,1,2,0,3,1,5,0,6,2,7,2,11,14,14,2.0,M2019-11-27D,Race(1),,
12,0,0,0,0,0,0,0,0,0,0,0,0,0,0,0,0,26,26,0.0,M2019-11-27D,Race(1),,
7,8,5,5,18,2,9,9,20,6,5,10,21,16,19,24,59,3.8,3.8,0.0,M2019-11-27D,Race(1),,
4,0,0,2,2,0,1,0,1,0,0,0,0,0,1,2,3,51,51,0.0,M2019-11-27D,Race(2),,
11,0,0,2,2,0,0,8,8,0,0,4,4,0,0,14,14,21,21,2.0,M2019-11-27D,Race(2),,
10,5,0,0,5,0,2,1,3,3,6,2,11,8,8,3,19,9.5,9.5,0.0,M2019-11-27D,Race(2),,
9,5,2,10,17,0,4,7,11,0,2,8,10,5,8,25,38,8.5,9.5,0.0,M2019-11-27D,Race(2),,
8,0,0,3,3,0,0,0,0,1,0,0,1,1,0,3,4,34,34,0.0,M2019-11-27D,Race(2),,
12,6,5,7,18,9,13,3,25,4,13,3,20,19,31,13,63,4.4,4.5,0.0,M2019-11-27D,Race(2),,
7,0,0,0,0,0,0,1,1,0,0,0,0,0,0,1,1,34,34,3.0,M2019-11-27D,Race(2),,
6,0,0,0,0,0,0,0,0,1,0,0,1,1,0,0,1,31,31,0.0,M2019-11-27D,Race(2),,
5,3,7,3,13,1,1,9,11,1,0,7,8,5,8,19,32,6.5,6.5,0.0,M2019-11-27D,Race(2),,
3,0,0,0,0,0,0,0,0,0,0,0,0,0,0,0,0,151,151,0.0,M2019-11-27D,Race(2),,
1,9,16,0,25,20,9,1,30,16,4,2,22,45,29,3,77,2.15,2.15,1.0,M2019-11-27D,Race(2),,
2,2,0,3,5,0,0,0,0,0,1,0,1,2,1,3,6,16,16,0.0,M2019-11-27D,Race(2),,
2,3,2,0,5,10,5,10,25,5,5,3,13,18,12,13,43,11,11,0.0,M2019-11-27D,Race(3),,
12,11,4,3,18,11,6,3,20,5,10,3,18,27,20,9,56,2.8,2.8,2.0,M2019-11-27D,Race(3),,
6,0,2,0,2,0,0,0,0,0,0,0,0,0,2,0,2,26,26,3.0,M2019-11-27D,Race(3),,
10,0,0,0,0,0,0,0,0,0,0,0,0,0,0,0,0,19,19,0.0,M2019-11-27D,Race(3),,
9,0,3,4,7,1,0,1,2,4,1,3,8,5,4,8,17,19,19,0.0,M2019-11-27D,Race(3),,
8,0,0,3,3,0,0,0,0,0,0,0,0,0,0,3,3,21,21,0.0,M2019-11-27D,Race(3),,
7,0,3,5,8,1,1,1,3,4,0,1,5,5,4,7,16,7.5,7.5,0.0,M2019-11-27D,Race(3),,
5,4,5,0,9,0,0,2,2,1,0,5,6,5,5,7,17,11,11,0.0,M2019-11-27D,Race(3),,
4,0,0,0,0,0,0,0,0,0,0,0,0,0,0,0,0,51,51,0.0,M2019-11-27D,Race(3),,
3,7,5,8,20,6,7,5,18,7,6,6,19,20,18,19,57,6.5,6.5,1.0,M2019-11-27D,Race(3),,
1,5,6,7,18,1,10,7,18,0,3,4,7,6,19,18,43,5.5,5.5,0.0,M2019-11-27D,Race(3),,
11,0,0,0,0,0,1,1,2,0,1,1,2,0,2,2,4,17,17,0.0,M2019-11-27D,Race(3),,
11,0,0,0,0,0,0,0,0,0,0,0,0,0,0,0,0,15,15,0.0,M2019-11-27D,Race(4),,
10,17,5,2,24,9,8,1,18,9,11,0,20,35,24,3,62,3.1,3.1,2.0,M2019-11-27D,Race(4),,
7,0,0,5,5,0,0,0,0,0,2,0,2,0,2,5,7,11,11,0.0,M2019-11-27D,Race(4),,
6,8,15,0,23,7,7,6,20,6,4,6,16,21,26,12,59,5.5,5.5,1.0,M2019-11-27D,Race(4),,
5,2,5,9,16,0,6,5,11,1,5,6,12,3,16,20,39,10,10,0.0,M2019-11-27D,Race(4),,
9,0,0,0,0,0,0,0,0,0,0,0,0,0,0,0,0,126,126,0.0,M2019-11-27D,Race(4),,
3,0,2,0,2,1,1,1,3,0,0,2,2,1,3,3,7,26,26,0.0,M2019-11-27D,Race(4),,
12,0,0,0,0,1,0,9,10,2,2,2,6,3,2,11,16,9,9,3.0,M2019-11-27D,Race(4),,
4,0,0,3,3,1,0,0,1,1,0,0,1,2,0,3,5,26,26,0.0,M2019-11-27D,Race(4),,
1,0,0,0,0,0,0,0,0,2,2,0,4,2,2,0,4,13,13,0.0,M2019-11-27D,Race(4),,
8,3,3,9,15,8,0,4,12,3,0,6,9,14,3,19,36,5,5,0.0,M2019-11-27D,Race(4),,
2,0,0,2,2,3,8,4,15,2,0,4,6,5,8,10,23,23,23,0.0,M2019-11-27D,Race(4),,
1,2,0,8,10,1,5,3,9,3,5,4,12,6,10,15,31,7.5,7.5,0.0,M2019-11-27D,Race(5),,
2,0,2,2,4,1,2,5,8,1,1,7,9,2,5,14,21,14,14,0.0,M2019-11-27D,Race(5),,
3,3,0,3,6,2,1,8,11,1,3,1,5,6,4,12,22,12,12,0.0,M2019-11-27D,Race(5),,
5,0,0,0,0,0,0,0,0,0,0,0,0,0,0,0,0,51,51,0.0,M2019-11-27D,Race(5),,
4,15,5,5,25,15,3,2,20,15,3,2,20,45,11,9,65,2.6,2.6,2.0,M2019-11-27D,Race(5),,
12,0,0,0,0,0,0,0,0,0,0,0,0,0,0,0,0,151,151,0.0,M2019-11-27D,Race(5),,
9,0,0,0,0,0,0,0,0,0,0,0,0,0,0,0,0,51,51,0.0,M2019-11-27D,Race(5),,
8,3,8,10,21,0,4,5,9,0,5,6,11,3,17,21,41,5,5,0.0,M2019-11-27D,Race(5),,
10,2,13,2,17,11,5,6,22,6,4,5,15,19,22,13,54,6.5,6.5,1.0,M2019-11-27D,Race(5),,
7,0,0,0,0,0,0,0,0,0,0,0,0,0,0,0,0,34,34,0.0,M2019-11-27D,Race(5),,
6,5,2,0,7,0,10,1,11,0,5,1,6,5,17,2,24,6.5,6.5,3.0,M2019-11-27D,Race(5),,
11,0,0,0,0,0,0,0,0,0,0,0,0,0,0,0,0,41,41,0.0,M2019-11-27D,Race(5),,
2,0,2,2,4,0,5,5,10,1,9,3,13,1,16,10,27,14,14,0.0,M2019-11-27D,Race(6),,
11,2,8,3,13,0,0,10,10,0,1,4,5,2,9,17,28,17,17,0.0,M2019-11-27D,Race(6),,
4,0,0,0,0,0,0,1,1,1,0,2,3,1,0,3,4,15,15,0.0,M2019-11-27D,Race(6),,
5,0,0,0,0,0,1,1,2,0,0,2,2,0,1,3,4,9,9,0.0,M2019-11-27D,Race(6),,
6,3,7,5,15,2,11,6,19,0,7,7,14,5,25,18,48,3.7,3.7,1.0,M2019-11-27D,Race(6),,
1,14,6,7,27,18,9,1,28,17,4,3,24,49,19,11,79,3.1,3.1,0.0,M2019-11-27D,Race(6),,
7,0,0,0,0,0,0,0,0,0,0,0,0,0,0,0,0,126,126,0.0,M2019-11-27D,Race(6),,
8,0,0,0,0,0,0,1,1,0,0,0,0,0,0,1,1,34,34,0.0,M2019-11-27D,Race(6),,
3,0,0,2,2,0,0,1,1,0,0,1,1,0,0,4,4,31,31,0.0,M2019-11-27D,Race(6),,
9,0,0,0,0,0,0,0,0,0,0,2,2,0,0,2,2,19,19,0.0,M2019-11-27D,Race(6),,
12,2,0,3,5,0,0,0,0,0,0,0,0,2,0,3,5,21,21,3.0,M2019-11-27D,Race(6),,
10,9,7,8,24,10,4,4,18,7,5,2,14,26,16,14,56,4.8,4.8,2.0,M2019-11-27D,Race(6),,
1,0,0,0,0,0,0,0,0,1,1,0,2,1,1,0,2,34,34,0.0,M2019-11-27D,Race(7),,
2,2,0,5,7,5,2,1,8,8,2,0,10,15,4,6,25,8.5,8.5,0.0,M2019-11-27D,Race(7),,
3,4,3,5,12,11,7,7,25,4,5,4,13,19,15,16,50,3.7,3.7,2.0,M2019-11-27D,Race(7),,
4,3,9,5,17,1,3,4,8,2,3,5,10,6,15,14,35,5.5,5.5,1.0,M2019-11-27D,Race(7),,
5,0,0,0,0,0,0,0,0,0,0,0,0,0,0,0,0,61,61,0.0,M2019-11-27D,Race(7),,
6,0,0,0,0,0,0,0,0,0,0,0,0,0,0,0,0,41,41,0.0,M2019-11-27D,Race(7),,
7,5,11,2,18,5,4,6,15,3,4,10,17,13,19,18,50,5.5,5.5,0.0,M2019-11-27D,Race(7),,
8,0,0,0,0,0,0,0,0,0,0,0,0,0,0,0,0,71,67,0.0,M2019-11-27D,Race(7),,
10,3,0,2,5,5,1,1,7,1,3,1,5,9,4,4,17,7,7,3.0,M2019-11-27D,Race(7),,
9,0,4,3,7,1,3,9,13,3,3,5,11,4,10,17,31,17,17,0.0,M2019-11-27D,Race(7),,
11,3,3,3,9,0,0,2,2,0,1,1,2,3,4,6,13,12,12,0.0,M2019-11-27D,Race(7),,
12,10,0,5,15,2,10,0,12,4,4,0,8,16,14,5,35,6.5,6.5,0.0,M2019-11-27D,Race(7),,
12,0,0,5,5,0,0,0,0,1,1,0,2,1,1,5,7,19,19,0.0,M2019-11-27D,Race(8),,
11,0,3,11,14,2,0,1,3,1,0,0,1,3,3,12,18,7,7,0.0,M2019-11-27D,Race(8),,
10,3,2,2,7,1,1,1,3,2,5,2,9,6,8,5,19,14,14,2.0,M2019-11-27D,Race(8),,
9,2,0,2,4,0,1,0,1,0,0,0,0,2,1,2,5,8.5,8.5,3.0,M2019-11-27D,Race(8),,
8,0,0,0,0,0,0,0,0,0,0,2,2,0,0,2,2,26,26,0.0,M2019-11-27D,Race(8),,
7,0,3,0,3,0,0,0,0,0,0,0,0,0,3,0,3,9.5,9.5,1.0,M2019-11-27D,Race(8),,
6,2,2,0,4,3,6,5,14,2,6,3,11,7,14,8,29,6.5,6.5,0.0,M2019-11-27D,Race(8),,
5,4,6,0,10,0,5,1,6,2,5,3,10,6,16,4,26,16,16,0.0,M2019-11-27D,Race(8),,
3,6,0,2,8,4,10,5,19,5,5,6,16,15,15,13,43,5,5,0.0,M2019-11-27D,Race(8),,
4,0,4,3,7,0,5,10,15,0,0,4,4,0,9,17,26,15,15,0.0,M2019-11-27D,Race(8),,
1,11,7,2,20,10,1,2,13,4,2,3,9,25,10,7,42,5,5,0.0,M2019-11-27D,Race(8),,
2,2,3,3,8,10,1,5,16,9,2,3,14,21,6,11,38,15,15,0.0,M2019-11-27D,Race(8),,
5,7,5,10,22,11,10,4,25,11,6,3,20,29,21,17,67,3.4,3.4,2.0,M2019-11-27D,Race(9),,
6,0,2,0,2,0,1,1,2,2,1,5,8,2,4,6,12,11,11,0.0,M2019-11-27D,Race(9),,
7,0,0,2,2,1,2,10,13,1,4,1,6,2,6,13,21,12,12,3.0,M2019-11-27D,Race(9),,
8,2,3,2,7,3,1,2,6,2,1,2,5,7,5,6,18,13,13,0.0,M2019-11-27D,Race(9),,
9,0,6,3,9,1,2,0,3,2,5,1,8,3,13,4,20,11,11,0.0,M2019-11-27D,Race(9),,
10,17,2,5,24,10,7,8,25,1,5,7,13,28,14,20,62,4.6,4.6,1.0,M2019-11-27D,Race(9),,
11,0,0,0,0,0,0,0,0,0,0,0,0,0,0,0,0,61,61,0.0,M2019-11-27D,Race(9),,
12,2,2,0,4,0,3,1,4,0,2,4,6,2,7,5,14,13,13,0.0,M2019-11-27D,Race(9),,
1,0,2,2,4,0,2,1,3,0,0,0,0,0,4,3,7,12,12,0.0,M2019-11-27D,Race(9),,
2,2,0,3,5,0,0,0,0,1,0,1,2,3,0,4,7,21,21,0.0,M2019-11-27D,Race(9),,
3,0,8,3,11,4,2,3,9,6,2,2,10,10,12,8,30,5.5,5.5,0.0,M2019-11-27D,Race(9),,
4,0,0,0,0,0,0,0,0,0,0,0,0,0,0,0,0,51,51,0.0,M2019-11-27D,Race(9),,
5,0,0,5,5,0,0,0,0,0,0,0,0,0,0,5,5,19,19,0.0,M2019-12-01D,Race(1),,
13,0,0,2,2,0,0,0,0,0,0,0,0,0,0,2,2,31,31,3.0,M2019-12-01D,Race(1),,
12,0,3,2,5,1,1,4,6,1,3,6,10,2,7,12,21,10,10,0.0,M2019-12-01D,Race(1),,
11,0,0,0,0,0,0,1,1,0,0,0,0,0,0,1,1,41,41,0.0,M2019-12-01D,Race(1),,
10,10,4,12,26,22,6,2,30,16,4,4,24,48,14,18,80,4.4,4.5,1.0,M2019-12-01D,Race(1),,
8,5,11,2,18,2,15,6,23,2,9,3,14,9,35,11,55,2.6,2.6,0.0,M2019-12-01D,Race(1),,
7,0,7,2,9,0,1,1,2,2,2,4,8,2,10,7,19,8.5,8.5,0.0,M2019-12-01D,Race(1),,
6,0,0,0,0,0,0,0,0,0,0,0,0,0,0,0,0,126,126,0.0,M2019-12-01D,Race(1),,
4,0,0,0,0,0,0,1,1,0,0,1,1,0,0,2,2,31,31,0.0,M2019-12-01D,Race(1),,
9,0,0,0,0,1,1,0,2,1,3,0,4,2,4,0,6,81,81,0.0,M2019-12-01D,Race(1),,
2,0,0,0,0,0,0,0,0,0,0,0,0,0,0,0,0,21,21,0.0,M2019-12-01D,Race(1),,
1,15,5,5,25,4,6,15,25,4,5,8,17,23,16,28,67,5,5,0.0,M2019-12-01D,Race(1),,
14,0,0,0,0,0,0,0,0,0,0,0,0,0,0,0,0,34,34,0.0,M2019-12-01D,Race(1),,
3,0,0,0,0,0,0,0,0,0,0,0,0,0,0,0,0,61,61,2.0,M2019-12-01D,Race(1),,
7,0,0,0,0,0,0,0,0,0,0,0,0,0,0,0,0,71,71,0.0,M2019-12-01D,Race(10),,
1,7,2,4,13,19,4,1,24,14,5,2,21,40,11,7,58,10,10,0.0,M2019-12-01D,Race(10),,
11,0,6,8,14,0,0,1,1,0,1,4,5,0,7,13,20,9.5,9.5,0.0,M2019-12-01D,Race(10),,
14,0,0,0,0,0,0,0,0,0,0,0,0,0,0,0,0,91,91,0.0,M2019-12-01D,Race(10),,
13,0,0,0,0,1,0,3,4,1,0,5,6,2,0,8,10,10,10,3.0,M2019-12-01D,Race(10),,
2,0,0,0,0,0,0,0,0,0,0,2,2,0,0,2,2,61,61,0.0,M2019-12-01D,Race(10),,
10,0,0,0,0,1,0,0,1,0,0,1,1,1,0,1,2,61,61,2.0,M2019-12-01D,Race(10),,
8,12,10,4,26,3,14,6,23,3,10,6,19,18,34,16,68,4,4,0.0,M2019-12-01D,Race(10),,
3,0,4,0,4,0,0,0,0,0,0,0,0,0,4,0,4,26,26,0.0,M2019-12-01D,Race(10),,
4,0,0,0,0,0,0,2,2,0,3,4,7,0,3,6,9,12,12,0.0,M2019-12-01D,Race(10),,
5,0,5,5,10,1,5,2,8,0,1,1,2,1,11,8,20,4.4,4.4,1.0,M2019-12-01D,Race(10),,
6,0,0,3,3,0,0,2,2,0,0,1,1,0,0,6,6,31,31,0.0,M2019-12-01D,Race(10),,
12,11,3,6,20,4,6,13,23,8,6,0,14,23,15,19,57,4.6,4.6,0.0,M2019-12-01D,Race(10),,
9,0,0,0,0,1,1,0,2,0,0,0,0,1,1,0,2,15,15,0.0,M2019-12-01D,Race(10),,
13,0,0,0,0,0,0,0,0,0,0,0,0,0,0,0,0,81,81,0.0,M2019-12-01D,Race(2),,
11,3,0,17,20,1,6,17,24,2,7,8,17,6,13,42,61,4,4,2.0,M2019-12-01D,Race(2),,
12,9,14,4,27,3,0,5,8,3,3,5,11,15,17,14,46,4.6,4.5,0.0,M2019-12-01D,Race(2),,
9,0,6,2,8,1,0,1,2,1,0,1,2,2,6,4,12,7,7,0.0,M2019-12-01D,Race(2),,
2,0,0,0,0,0,0,0,0,0,1,0,1,0,1,0,1,18,19,0.0,M2019-12-01D,Race(2),,
1,16,7,7,30,7,15,2,24,9,4,3,16,32,26,12,70,3.2,3.2,3.0,M2019-12-01D,Race(2),,
6,0,3,0,3,0,0,1,1,1,0,1,2,1,3,2,6,10,10,1.0,M2019-12-01D,Race(2),,
5,0,0,0,0,0,1,0,1,1,3,0,4,1,4,0,5,17,17,0.0,M2019-12-01D,Race(2),,
4,0,0,0,0,0,0,0,0,0,0,0,0,0,0,0,0,34,34,0.0,M2019-12-01D,Race(2),,
7,0,0,0,0,17,7,3,27,0,0,0,0,17,7,3,27,0,0,0.0,M2019-12-01D,Race(2),,
10,0,0,0,0,0,0,0,0,0,0,1,1,0,0,1,1,51,51,0.0,M2019-12-01D,Race(2),,
3,0,0,0,0,1,1,0,2,0,1,0,1,1,2,0,3,41,41,0.0,M2019-12-01D,Race(2),,
8,0,0,0,0,0,0,1,1,0,0,3,3,0,0,4,4,18,18,0.0,M2019-12-01D,Race(2),,
6,0,0,0,0,0,0,0,0,0,0,0,0,0,0,0,0,101,101,0.0,M2019-12-01D,Race(3),,
1,21,7,0,28,25,4,0,29,21,2,0,23,67,13,0,80,1.8,1.85,1.0,M2019-12-01D,Race(3),,
2,3,2,9,14,0,1,2,3,0,2,3,5,3,5,14,22,9,9.5,0.0,M2019-12-01D,Race(3),,
3,0,16,6,22,0,4,19,23,0,4,9,13,0,24,34,58,7,7,0.0,M2019-12-01D,Race(3),,
4,0,0,0,0,0,0,0,0,0,0,0,0,0,0,0,0,71,67,0.0,M2019-12-01D,Race(3),,
5,0,0,8,8,0,0,0,0,0,0,0,0,0,0,8,8,31,31,0.0,M2019-12-01D,Race(3),,
7,0,0,5,5,0,1,1,2,1,1,1,3,1,2,7,10,7.5,7.5,3.0,M2019-12-01D,Race(3),,
11,0,0,2,2,2,1,3,6,0,3,3,6,2,4,8,14,12,14,0.0,M2019-12-01D,Race(3),,
8,2,0,0,2,0,1,1,2,0,3,2,5,2,4,3,9,14,14,0.0,M2019-12-01D,Race(3),,
9,0,0,0,0,0,0,0,0,0,1,0,1,0,1,0,1,151,151,0.0,M2019-12-01D,Race(3),,
10,2,0,0,2,0,0,1,1,0,0,2,2,2,0,3,5,26,26,0.0,M2019-12-01D,Race(3),,
12,2,5,0,7,0,0,0,0,4,10,6,20,6,15,6,27,9,9,2.0,M2019-12-01D,Race(3),,
11,0,2,3,5,1,0,2,3,0,1,5,6,1,3,10,14,11,11,1.0,M2019-12-01D,Race(4),,
12,3,10,5,18,4,14,5,23,8,4,8,20,15,28,18,61,4.4,4.4,2.0,M2019-12-01D,Race(4),,
7,2,0,2,4,0,1,1,2,0,2,0,2,2,3,3,8,11,11,3.0,M2019-12-01D,Race(4),,
3,0,0,2,2,0,0,0,0,0,2,1,3,0,2,3,5,19,19,0.0,M2019-12-01D,Race(4),,
10,4,3,0,7,1,2,1,4,2,2,0,4,7,7,1,15,14,14,0.0,M2019-12-01D,Race(4),,
9,0,0,0,0,0,0,0,0,0,0,0,0,0,0,0,0,41,41,0.0,M2019-12-01D,Race(4),,
8,0,0,0,0,0,1,1,2,0,0,0,0,0,1,1,2,81,81,0.0,M2019-12-01D,Race(4),,
6,8,5,7,20,4,5,11,20,4,4,6,14,16,14,24,54,4.2,4.4,0.0,M2019-12-01D,Race(4),,
5,0,5,6,11,15,5,4,24,5,3,1,9,20,13,11,44,7.5,7.5,0.0,M2019-12-01D,Race(4),,
4,0,0,3,3,1,0,0,1,1,1,0,2,2,1,3,6,13,13,0.0,M2019-12-01D,Race(4),,
1,10,3,0,13,2,1,1,4,2,2,2,6,14,6,3,23,6.5,6.5,0.0,M2019-12-01D,Race(4),,
2,3,2,2,7,2,1,4,7,4,5,3,12,9,8,9,26,8.5,8.5,0.0,M2019-12-01D,Race(4),,
9,14,7,4,25,20,5,3,28,16,7,0,23,50,19,7,76,3.5,3.5,0.0,M2019-12-01D,Race(5),,
14,0,5,3,8,5,14,6,25,5,6,6,17,10,25,15,50,3.7,3.7,0.0,M2019-12-01D,Race(5),,
13,0,0,0,0,0,0,1,1,0,0,0,0,0,0,1,1,51,51,0.0,M2019-12-01D,Race(5),,
12,2,0,2,4,1,2,11,14,1,4,4,9,4,6,17,27,12,12,1.0,M2019-12-01D,Race(5),,
10,0,3,0,3,0,0,1,1,0,0,1,1,0,3,2,5,34,34,0.0,M2019-12-01D,Race(5),,
8,0,3,0,3,0,0,1,1,0,0,0,0,0,3,1,4,26,26,0.0,M2019-12-01D,Race(5),,
7,2,0,0,2,0,1,0,1,0,0,0,0,2,1,0,3,18,18,0.0,M2019-12-01D,Race(5),,
11,0,0,3,3,0,0,0,0,0,0,2,2,0,0,5,5,19,19,0.0,M2019-12-01D,Race(5),,
5,0,0,0,0,0,0,0,0,0,0,0,0,0,0,0,0,21,21,0.0,M2019-12-01D,Race(5),,
4,5,5,6,16,2,2,2,6,3,0,7,10,10,7,15,32,9,9,0.0,M2019-12-01D,Race(5),,
3,0,0,2,2,0,0,0,0,0,0,0,0,0,0,2,2,21,21,2.0,M2019-12-01D,Race(5),,
1,2,7,5,14,2,0,3,5,1,1,3,5,5,8,11,24,14,14,0.0,M2019-12-01D,Race(5),,
2,0,0,0,0,0,3,1,4,0,4,2,6,0,7,3,10,19,19,0.0,M2019-12-01D,Race(5),,
6,5,0,5,10,0,3,1,4,0,4,1,5,5,7,7,19,9,9,3.0,M2019-12-01D,Race(5),,
1,2,3,7,12,1,13,8,22,0,5,6,11,3,21,21,45,5,5,0.0,M2019-12-01D,Race(6),,
11,0,0,0,0,0,0,0,0,0,0,0,0,0,0,0,0,21,21,0.0,M2019-12-01D,Race(6),,
6,3,4,5,12,1,1,0,2,3,1,1,5,7,6,6,19,9,9,3.0,M2019-12-01D,Race(6),,
5,11,12,5,28,22,6,2,30,16,7,3,26,49,25,10,84,2.6,2.6,1.0,M2019-12-01D,Race(6),,
4,0,0,0,0,0,0,0,0,0,0,0,0,0,0,0,0,26,26,0.0,M2019-12-01D,Race(6),,
2,3,2,5,10,1,4,1,6,0,7,3,10,4,13,9,26,13,13,0.0,M2019-12-01D,Race(6),,
8,4,0,2,6,4,3,15,22,4,1,6,11,12,4,23,39,5.5,5.5,0.0,M2019-12-01D,Race(6),,
7,0,0,0,0,0,0,0,0,0,0,0,0,0,0,0,0,81,81,0.0,M2019-12-01D,Race(6),,
9,0,0,3,3,0,0,0,0,0,0,0,0,0,0,3,3,34,34,0.0,M2019-12-01D,Race(6),,
10,3,6,0,9,1,3,4,8,2,4,3,9,6,13,7,26,13,13,2.0,M2019-12-01D,Race(6),,
12,2,0,3,5,0,0,0,0,1,0,1,2,3,0,4,7,18,18,0.0,M2019-12-01D,Race(6),,
3,2,3,0,5,0,0,0,0,0,0,0,0,2,3,0,5,16,16,0.0,M2019-12-01D,Race(6),,
13,0,2,0,2,0,0,0,0,0,0,0,0,0,2,0,2,51,51,0.0,M2019-12-01D,Race(7),,
14,0,0,0,0,0,0,0,0,0,0,0,0,0,0,0,0,41,41,0.0,M2019-12-01D,Race(7),,
12,0,0,2,2,0,1,0,1,0,1,0,1,0,2,2,4,17,17,0.0,M2019-12-01D,Race(7),,
8,0,0,5,5,1,0,2,3,3,0,3,6,4,0,10,14,11,11,0.0,M2019-12-01D,Race(7),,
10,12,6,12,30,18,5,3,26,8,9,5,22,38,20,20,78,3.1,3.4,1.0,M2019-12-01D,Race(7),,
9,0,10,8,18,0,3,4,7,0,4,2,6,0,17,14,31,4.8,5,0.0,M2019-12-01D,Race(7),,
7,11,12,0,23,9,17,3,29,14,7,2,23,34,36,5,75,4.6,4.6,3.0,M2019-12-01D,Race(7),,
6,0,0,0,0,0,0,0,0,0,0,0,0,0,0,0,0,91,91,0.0,M2019-12-01D,Race(7),,
1,0,0,0,0,0,0,0,0,0,0,0,0,0,0,0,0,20,20,0.0,M2019-12-01D,Race(7),,
2,0,0,0,0,1,1,1,3,0,1,2,3,1,2,3,6,10,10,2.0,M2019-12-01D,Race(7),,
3,2,0,0,2,0,0,0,0,0,0,0,0,2,0,0,2,34,34,0.0,M2019-12-01D,Race(7),,
4,5,0,3,8,1,3,17,21,1,3,10,14,7,6,30,43,10,10,0.0,M2019-12-01D,Race(7),,
5,0,0,0,0,0,0,0,0,0,0,1,1,0,0,1,1,20,21,0.0,M2019-12-01D,Race(7),,
11,0,0,0,0,0,0,0,0,0,1,1,2,0,1,1,2,26,26,0.0,M2019-12-01D,Race(7),,
12,0,2,0,2,0,0,0,0,0,0,0,0,0,2,0,2,26,26,3.0,M2019-12-01D,Race(8),,
11,2,7,9,18,1,5,4,10,5,6,2,13,8,18,15,41,10,10,0.0,M2019-12-01D,Race(8),,
8,0,0,0,0,0,0,0,0,0,0,0,0,0,0,0,0,21,21,0.0,M2019-12-01D,Race(8),,
9,0,0,0,0,0,0,0,0,0,0,0,0,0,0,0,0,61,61,0.0,M2019-12-01D,Race(8),,
7,7,3,7,17,17,7,5,29,8,9,6,23,32,19,18,69,3.6,3.6,2.0,M2019-12-01D,Race(8),,
6,2,10,5,17,4,1,13,18,5,2,5,12,11,13,23,47,4.6,4.5,0.0,M2019-12-01D,Race(8),,
5,0,0,0,0,0,0,0,0,0,0,0,0,0,0,0,0,31,31,0.0,M2019-12-01D,Race(8),,
4,0,0,2,2,0,0,0,0,0,0,0,0,0,0,2,2,21,21,0.0,M2019-12-01D,Race(8),,
3,6,3,5,14,1,2,3,6,1,1,6,8,8,6,14,28,6,6,0.0,M2019-12-01D,Race(8),,
2,13,5,2,20,7,15,5,27,7,8,6,21,27,28,13,68,3.4,3.4,1.0,M2019-12-01D,Race(8),,
10,0,0,0,0,0,0,0,0,0,0,1,1,0,0,1,1,41,41,0.0,M2019-12-01D,Race(8),,
1,0,0,0,0,0,0,0,0,0,0,0,0,0,0,0,0,81,81,0.0,M2019-12-01D,Race(8),,
14,3,8,8,19,4,14,4,22,3,5,6,14,10,27,18,55,6,6,0.0,M2019-12-01D,Race(9),,
1,0,5,3,8,2,4,3,9,1,3,2,6,3,12,8,23,9,9,0.0,M2019-12-01D,Race(9),,
2,3,0,0,3,0,0,1,1,0,0,0,0,3,0,1,4,31,31,0.0,M2019-12-01D,Race(9),,
4,0,0,3,3,1,0,11,12,0,0,8,8,1,0,22,23,11,11,0.0,M2019-12-01D,Race(9),,
5,0,0,2,2,2,1,0,3,0,2,0,2,2,3,2,7,14,14,0.0,M2019-12-01D,Race(9),,
6,13,8,5,26,3,3,3,9,7,1,1,9,23,12,9,44,3.6,3.6,2.0,M2019-12-01D,Race(9),,
7,0,0,0,0,1,0,1,2,0,2,1,3,1,2,2,5,8,8,0.0,M2019-12-01D,Race(9),,
8,0,2,0,2,0,0,3,3,0,3,3,6,0,5,6,11,31,31,0.0,M2019-12-01D,Race(9),,
9,0,0,0,0,0,0,0,0,0,0,1,1,0,0,1,1,34,34,3.0,M2019-12-01D,Race(9),,
10,0,0,0,0,0,0,0,0,0,0,0,0,0,0,0,0,71,67,0.0,M2019-12-01D,Race(9),,
11,6,0,3,9,16,5,4,25,12,7,2,21,34,12,9,55,8,8,0.0,M2019-12-01D,Race(9),,
3,3,0,0,3,0,0,0,0,0,0,0,0,3,0,0,3,31,31,0.0,M2019-12-01D,Race(9),,
12,0,0,0,0,0,0,0,0,0,0,0,0,0,0,0,0,61,61,0.0,M2019-12-01D,Race(9),,
13,2,7,6,15,1,3,0,4,3,3,2,8,6,13,8,27,6.5,6.5,1.0,M2019-12-01D,Race(9),,
7,0,0,3,3,0,1,0,1,0,2,1,3,0,3,4,7,21,21,0.0,M2019-12-04D,Race(1),,
4,3,0,0,3,1,2,3,6,1,4,3,8,5,6,6,17,7,7,0.0,M2019-12-04D,Race(1),,
10,0,0,0,0,0,0,1,1,1,0,1,2,1,0,2,3,14,14,0.0,M2019-12-04D,Race(1),,
9,0,0,0,0,0,0,0,0,0,0,0,0,0,0,0,0,31,31,0.0,M2019-12-04D,Race(1),,
8,0,0,0,0,0,0,0,0,0,0,0,0,0,0,0,0,41,41,0.0,M2019-12-04D,Race(1),,
1,13,6,4,23,15,10,2,27,12,2,1,15,40,18,7,65,4,4,2.0,M2019-12-04D,Race(1),,
6,2,5,5,12,10,1,2,13,2,4,4,10,14,10,11,35,4.8,4.8,1.0,M2019-12-04D,Race(1),,
3,8,10,9,27,1,9,6,16,2,6,4,12,11,25,19,55,8,8,3.0,M2019-12-04D,Race(1),,
5,0,0,0,0,0,0,0,0,0,0,0,0,0,0,0,0,81,81,0.0,M2019-12-04D,Race(1),,
12,0,2,9,11,0,1,10,11,0,2,5,7,0,5,24,29,8.5,8.5,0.0,M2019-12-04D,Race(1),,
11,0,0,0,0,0,0,0,0,0,2,0,2,0,2,0,2,51,51,0.0,M2019-12-04D,Race(1),,
2,4,7,0,11,3,6,6,15,8,4,7,19,15,17,13,45,4.4,4.4,0.0,M2019-12-04D,Race(1),,
5,3,0,5,8,0,0,1,1,0,2,0,2,3,2,6,11,7,7,2.0,M2019-12-04D,Race(2),,
1,3,0,2,5,9,4,10,23,11,1,3,15,23,5,15,43,8.5,8.5,0.0,M2019-12-04D,Race(2),,
8,0,3,3,6,0,1,1,2,0,0,1,1,0,4,5,9,6.5,6.5,0.0,M2019-12-04D,Race(2),,
3,0,0,0,0,0,0,0,0,0,0,0,0,0,0,0,0,34,34,0.0,M2019-12-04D,Race(2),,
4,5,9,0,14,1,2,2,5,1,7,2,10,7,18,4,29,9.5,9.5,0.0,M2019-12-04D,Race(2),,
6,3,4,11,18,4,1,5,10,2,1,7,10,9,6,23,38,4.4,4.4,0.0,M2019-12-04D,Race(2),,
2,0,5,0,5,1,9,0,10,2,3,1,6,3,17,1,21,10,10,0.0,M2019-12-04D,Race(2),,
7,2,9,2,13,9,5,4,18,5,5,3,13,16,19,9,44,8.5,8.5,1.0,M2019-12-04D,Race(2),,
9,14,0,7,21,6,8,5,19,5,7,5,17,25,15,17,57,7.5,7.5,0.0,M2019-12-04D,Race(2),,
10,0,0,0,0,0,0,0,0,0,0,0,0,0,0,0,0,41,41,0.0,M2019-12-04D,Race(2),,
11,0,0,0,0,0,0,2,2,0,0,4,4,0,0,6,6,9,9,3.0,M2019-12-04D,Race(2),,
12,0,0,0,0,0,0,0,0,0,0,0,0,0,0,0,0,61,61,0.0,M2019-12-04D,Race(2),,
4,6,11,2,19,7,8,1,16,5,7,1,13,18,26,4,48,5.5,5.5,0.0,M2019-12-04D,Race(3),,
6,0,2,0,2,0,0,0,0,0,1,2,3,0,3,2,5,26,26,0.0,M2019-12-04D,Race(3),,
11,0,0,0,0,0,0,0,0,0,0,1,1,0,0,1,1,91,91,0.0,M2019-12-04D,Race(3),,
3,5,0,13,18,2,2,8,12,5,4,4,13,12,6,25,43,6.5,6.5,3.0,M2019-12-04D,Race(3),,
8,0,2,3,5,0,0,1,1,0,1,1,2,0,3,5,8,31,31,0.0,M2019-12-04D,Race(3),,
12,0,5,5,10,1,1,0,2,1,2,0,3,2,8,5,15,13,13,0.0,M2019-12-04D,Race(3),,
5,0,0,2,2,0,0,0,0,0,0,0,0,0,0,2,2,10,10,0.0,M2019-12-04D,Race(3),,
7,8,0,3,11,10,2,5,17,5,2,6,13,23,4,14,41,5,5,0.0,M2019-12-04D,Race(3),,
1,3,0,0,3,2,1,2,5,0,1,2,3,5,2,4,11,12,12,1.0,M2019-12-04D,Race(3),,
9,0,0,0,0,0,0,1,1,1,0,1,2,1,0,2,3,26,26,0.0,M2019-12-04D,Race(3),,
2,5,2,0,7,0,9,2,11,4,1,4,9,9,12,6,27,10,10,0.0,M2019-12-04D,Race(3),,
10,3,8,2,13,8,7,10,25,5,7,4,16,16,22,16,54,3.8,3.8,2.0,M2019-12-04D,Race(3),,
1,3,0,5,8,0,10,4,14,0,1,4,5,3,11,13,27,12,12,0.0,M2019-12-04D,Race(4),,
7,2,0,0,2,0,0,12,12,1,3,4,8,3,3,16,22,7,7,1.0,M2019-12-04D,Race(4),,
5,0,0,0,0,0,0,0,0,0,0,0,0,0,0,0,0,34,34,0.0,M2019-12-04D,Race(4),,
9,0,0,0,0,0,0,0,0,0,0,0,0,0,0,0,0,26,26,0.0,M2019-12-04D,Race(4),,
10,0,0,0,0,0,0,0,0,0,1,0,1,0,1,0,1,81,81,0.0,M2019-12-04D,Race(4),,
8,2,3,3,8,0,0,0,0,0,1,2,3,2,4,5,11,31,31,0.0,M2019-12-04D,Race(4),,
12,0,0,3,3,0,0,1,1,0,4,2,6,0,4,6,10,13,13,0.0,M2019-12-04D,Race(4),,
4,5,9,0,14,10,11,2,23,6,5,5,16,21,25,7,53,5,5,0.0,M2019-12-04D,Race(4),,
2,16,7,2,25,16,5,1,22,16,2,3,21,48,14,6,68,2.8,2.8,3.0,M2019-12-04D,Race(4),,
11,2,8,9,19,4,4,5,13,3,9,4,16,9,21,18,48,6,6,2.0,M2019-12-04D,Race(4),,
3,0,3,4,7,0,0,5,5,0,0,2,2,0,3,11,14,13,13,0.0,M2019-12-04D,Race(4),,
6,0,0,4,4,0,0,0,0,0,0,0,0,0,0,4,4,15,15,0.0,M2019-12-04D,Race(4),,
6,3,0,0,3,0,1,2,3,0,2,0,2,3,3,2,8,13,13,0.0,M2019-12-04D,Race(5),,
11,0,2,0,2,0,0,0,0,1,0,1,2,1,2,1,4,19,19,0.0,M2019-12-04D,Race(5),,
5,0,7,0,7,2,9,1,12,3,3,3,9,5,19,4,28,9.5,9.5,0.0,M2019-12-04D,Race(5),,
9,14,6,5,25,7,7,5,19,6,11,3,20,27,24,13,64,4,4,0.0,M2019-12-04D,Race(5),,
3,2,5,8,15,9,6,10,25,11,3,5,19,22,14,23,59,9,9,0.0,M2019-12-04D,Race(5),,
2,0,0,0,0,0,0,1,1,0,0,0,0,0,0,1,1,16,21,3.0,M2019-12-04D,Race(5),,
1,0,0,3,3,0,2,1,3,0,1,3,4,0,3,7,10,10,10,0.0,M2019-12-04D,Race(5),,
7,3,10,7,20,10,0,6,16,5,1,6,12,18,11,19,48,4.4,4.4,1.0,M2019-12-04D,Race(5),,
8,6,0,7,13,1,5,4,10,0,4,4,8,7,9,15,31,6.5,6.5,0.0,M2019-12-04D,Race(5),,
12,0,0,0,0,1,0,0,1,0,0,1,1,1,0,1,2,61,61,0.0,M2019-12-04D,Race(5),,
10,0,0,0,0,0,0,0,0,0,1,0,1,0,1,0,1,13,13,2.0,M2019-12-04D,Race(5),,
4,2,0,0,2,0,0,0,0,0,0,0,0,2,0,0,2,17,17,0.0,M2019-12-04D,Race(5),,
10,0,0,0,0,0,0,0,0,0,0,0,0,0,0,0,0,71,71,0.0,M2019-12-04D,Race(6),,
11,0,0,0,0,0,0,0,0,0,0,0,0,0,0,0,0,41,41,0.0,M2019-12-04D,Race(6),,
12,0,0,0,0,0,0,0,0,0,1,1,2,0,1,1,2,21,21,0.0,M2019-12-04D,Race(6),,
2,22,8,0,30,13,7,10,30,9,8,4,21,44,23,14,81,2.4,2.4,2.0,M2019-12-04D,Race(6),,
8,0,0,5,5,0,1,4,5,0,4,4,8,0,5,13,18,12,12,0.0,M2019-12-04D,Race(6),,
7,0,0,0,0,0,0,1,1,0,0,3,3,0,0,4,4,41,41,0.0,M2019-12-04D,Race(6),,
6,0,2,12,14,0,10,12,22,2,4,9,15,2,16,33,51,11,11,0.0,M2019-12-04D,Race(6),,
5,0,0,2,2,0,0,0,0,0,0,0,0,0,0,2,2,15,15,0.0,M2019-12-04D,Race(6),,
4,0,0,0,0,0,0,1,1,3,0,1,4,3,0,2,5,10,10,3.0,M2019-12-04D,Race(6),,
1,3,0,8,11,8,0,1,9,0,0,2,2,11,0,11,22,15,15,0.0,M2019-12-04D,Race(6),,
3,5,20,3,28,8,12,1,21,12,9,2,23,25,41,6,72,3.2,3.2,1.0,M2019-12-04D,Race(6),,
9,0,0,0,0,0,0,0,0,0,0,0,0,0,0,0,0,31,31,0.0,M2019-12-04D,Race(6),,
2,7,14,5,26,17,10,2,29,18,4,3,25,42,28,10,80,2.75,2.7,3.0,M2019-12-04D,Race(7),,
11,2,2,6,10,0,1,0,1,1,2,1,4,3,5,7,15,10,10,0.0,M2019-12-04D,Race(7),,
10,0,0,0,0,0,0,1,1,0,0,0,0,0,0,1,1,17,18,0.0,M2019-12-04D,Race(7),,
3,0,0,0,0,0,0,0,0,0,0,0,0,0,0,0,0,61,61,0.0,M2019-12-04D,Race(7),,
8,13,0,2,15,0,1,10,11,1,3,1,5,14,4,13,31,5,5,2.0,M2019-12-04D,Race(7),,
7,0,2,2,4,0,1,2,3,0,3,4,7,0,6,8,14,13,13,0.0,M2019-12-04D,Race(7),,
4,2,0,2,4,0,2,4,6,1,1,7,9,3,3,13,19,13,14,1.0,M2019-12-04D,Race(7),,
9,0,0,0,0,0,0,0,0,0,0,0,0,0,0,0,0,71,67,0.0,M2019-12-04D,Race(7),,
12,0,0,0,0,0,1,1,2,0,0,0,0,0,1,1,2,16,16,0.0,M2019-12-04D,Race(7),,
6,6,10,10,26,10,8,6,24,2,7,7,16,18,25,23,66,8,8,0.0,M2019-12-04D,Race(7),,
5,0,0,0,0,1,1,0,2,2,2,0,4,3,3,0,6,12,12,0.0,M2019-12-04D,Race(7),,
1,0,2,3,5,2,5,4,11,1,4,3,8,3,11,10,24,10,10,0.0,M2019-12-04D,Race(7),,
2,0,9,8,17,16,8,1,25,7,9,2,18,23,26,11,60,6.5,6.5,0.0,M2019-12-04D,Race(8),,
1,0,5,3,8,0,2,10,12,1,3,1,5,1,10,14,25,16,16,0.0,M2019-12-04D,Race(8),,
7,0,0,0,0,0,0,1,1,0,0,2,2,0,0,3,3,26,26,0.0,M2019-12-04D,Race(8),,
11,0,0,2,2,0,0,0,0,0,0,0,0,0,0,2,2,41,41,2.0,M2019-12-04D,Race(8),,
10,25,3,0,28,10,6,4,20,8,5,6,19,43,14,10,67,2.6,2.6,3.0,M2019-12-04D,Race(8),,
8,0,0,0,0,0,0,0,0,0,1,0,1,0,1,0,1,31,31,0.0,M2019-12-04D,Race(8),,
9,0,0,2,2,0,0,1,1,0,0,0,0,0,0,3,3,17,17,0.0,M2019-12-04D,Race(8),,
6,0,8,8,16,4,10,7,21,5,5,5,15,9,23,20,52,7,7,0.0,M2019-12-04D,Race(8),,
4,0,0,0,0,0,0,0,0,0,0,0,0,0,0,0,0,21,21,0.0,M2019-12-04D,Race(8),,
5,0,0,0,0,0,2,0,2,2,1,0,3,2,3,0,5,13,13,0.0,M2019-12-04D,Race(8),,
3,0,0,2,2,0,0,2,2,0,0,4,4,0,0,8,8,14,14,0.0,M2019-12-04D,Race(8),,
12,5,5,5,15,0,2,4,6,3,2,6,11,8,9,15,32,5.5,5.5,1.0,M2019-12-04D,Race(8),,
1,21,0,5,26,5,10,6,21,8,7,5,20,34,17,16,67,2.9,2.9,3.0,M2019-12-04D,Race(9),,
11,0,0,2,2,0,0,2,2,0,0,2,2,0,0,6,6,10,10,0.0,M2019-12-04D,Race(9),,
5,7,2,2,11,1,10,8,19,0,3,2,5,8,15,12,35,6.5,6.5,0.0,M2019-12-04D,Race(9),,
6,2,14,7,23,16,5,1,22,14,7,3,24,32,26,11,69,3.7,3.7,1.0,M2019-12-04D,Race(9),,
7,0,0,0,0,0,0,0,0,0,0,2,2,0,0,2,2,19,19,2.0,M2019-12-04D,Race(9),,
8,0,0,0,0,0,0,0,0,0,0,0,0,0,0,0,0,34,34,0.0,M2019-12-04D,Race(9),,
9,0,3,6,9,0,3,1,4,0,3,6,9,0,9,13,22,14,14,0.0,M2019-12-04D,Race(9),,
10,0,0,0,0,0,0,0,0,0,0,0,0,0,0,0,0,51,51,0.0,M2019-12-04D,Race(9),,
12,0,0,0,0,0,0,1,1,0,0,0,0,0,0,1,1,21,21,0.0,M2019-12-04D,Race(9),,
2,0,0,0,0,0,0,0,0,0,0,0,0,0,0,0,0,71,67,0.0,M2019-12-04D,Race(9),,
4,0,4,3,7,8,1,1,10,1,4,3,8,9,9,7,25,12,12,0.0,M2019-12-04D,Race(9),,
3,0,7,5,12,0,1,10,11,3,2,3,8,3,10,18,31,11,11,0.0,M2019-12-04D,Race(9),,
6,0,6,2,8,0,15,8,23,1,8,5,14,1,29,15,45,10,10,0.0,M2019-12-08D,Race(1),,
1,16,7,7,30,26,2,1,29,18,4,1,23,60,13,9,82,2.9,2.8,0.0,M2019-12-08D,Race(1),,
9,0,0,0,0,0,0,0,0,0,0,0,0,0,0,0,0,91,101,0.0,M2019-12-08D,Race(1),,
14,0,0,0,0,0,0,0,0,0,0,0,0,0,0,0,0,61,61,0.0,M2019-12-08D,Race(1),,
5,0,2,0,2,0,1,0,1,0,3,0,3,0,6,0,6,21,26,0.0,M2019-12-08D,Race(1),,
2,0,0,0,0,0,3,0,3,0,2,0,2,0,5,0,5,21,21,0.0,M2019-12-08D,Race(1),,
7,7,8,5,20,1,4,4,9,3,4,5,12,11,16,14,41,5,5,1.0,M2019-12-08D,Race(1),,
8,5,0,3,8,0,0,2,2,0,0,2,2,5,0,7,12,6.5,6.5,0.0,M2019-12-08D,Race(1),,
3,2,0,3,5,2,2,12,16,2,0,8,10,6,2,23,31,10,10,0.0,M2019-12-08D,Race(1),,
10,0,0,0,0,0,0,0,0,0,0,0,0,0,0,0,0,34,51,3.0,M2019-12-08D,Race(1),,
11,0,0,3,3,0,0,0,0,0,0,0,0,0,0,3,3,34,41,0.0,M2019-12-08D,Race(1),,
4,0,2,0,2,1,0,1,2,2,0,1,3,3,2,2,7,11,13,0.0,M2019-12-08D,Race(1),,
13,0,5,7,12,0,3,2,5,0,5,4,9,0,13,13,26,6.5,8.5,2.0,M2019-12-08D,Race(1),,
12,0,0,0,0,0,0,0,0,0,0,0,0,0,0,0,0,71,61,0.0,M2019-12-08D,Race(1),,
10,3,0,5,8,1,0,0,1,1,0,1,2,5,0,6,11,7.5,7.5,0.0,M2019-12-08D,Race(10),,
11,0,0,0,0,0,0,0,0,0,0,0,0,0,0,0,0,34,34,0.0,M2019-12-08D,Race(10),,
8,0,0,4,4,0,2,4,6,0,0,5,5,0,2,13,15,8.5,8.5,0.0,M2019-12-08D,Race(10),,
14,0,8,3,11,0,2,1,3,0,1,0,1,0,11,4,15,11,11,2.0,M2019-12-08D,Race(10),,
1,0,5,9,14,1,0,1,2,3,1,3,7,4,6,13,23,12,12,0.0,M2019-12-08D,Race(10),,
2,0,0,0,0,0,0,0,0,0,0,0,0,0,0,0,0,41,41,0.0,M2019-12-08D,Race(10),,
6,0,0,0,0,0,0,0,0,0,0,0,0,0,0,0,0,51,51,0.0,M2019-12-08D,Race(10),,
4,23,2,5,30,24,4,1,29,18,6,1,25,65,12,7,84,2.4,2.4,1.0,M2019-12-08D,Race(10),,
5,0,7,0,7,3,6,14,23,3,6,8,17,6,19,22,47,7.5,7.5,0.0,M2019-12-08D,Race(10),,
7,4,8,4,16,1,16,9,26,1,12,8,21,6,36,21,63,7,7,0.0,M2019-12-08D,Race(10),,
13,0,0,0,0,0,0,0,0,0,0,0,0,0,0,0,0,31,31,3.0,M2019-12-08D,Race(10),,
12,0,0,0,0,0,0,0,0,0,0,0,0,0,0,0,0,51,51,0.0,M2019-12-08D,Race(10),,
3,0,0,0,0,0,0,0,0,0,0,0,0,0,0,0,0,51,51,0.0,M2019-12-08D,Race(10),,
9,0,0,0,0,0,0,0,0,0,0,0,0,0,0,0,0,71,67,0.0,M2019-12-08D,Race(10),,
10,0,2,0,2,2,4,3,9,4,3,4,11,6,9,7,22,7,7,0.0,M2019-12-08D,Race(2),,
9,2,3,0,5,0,1,1,2,0,1,0,1,2,5,1,8,12,12,2.0,M2019-12-08D,Race(2),,
2,3,5,0,8,6,14,2,22,7,3,2,12,16,22,4,42,15,14,0.0,M2019-12-08D,Race(2),,
3,3,0,5,8,0,0,0,0,1,0,1,2,4,0,6,10,11,11,0.0,M2019-12-08D,Race(2),,
7,0,0,3,3,0,0,0,0,0,0,0,0,0,0,3,3,34,34,0.0,M2019-12-08D,Race(2),,
5,0,3,2,5,0,1,1,2,0,0,0,0,0,4,3,7,15,15,0.0,M2019-12-08D,Race(2),,
6,2,6,3,11,0,1,1,2,0,2,4,6,2,9,8,19,4,5,0.0,M2019-12-08D,Race(2),,
11,0,0,0,0,0,0,0,0,0,0,0,0,0,0,0,0,101,101,0.0,M2019-12-08D,Race(2),,
8,2,6,11,19,0,6,16,22,4,10,6,20,6,22,33,61,4.4,4.5,0.0,M2019-12-08D,Race(2),,
12,0,0,0,0,1,0,0,1,0,0,0,0,1,0,0,1,71,61,0.0,M2019-12-08D,Race(2),,
4,18,3,4,25,21,3,6,30,9,6,9,24,48,12,19,79,4.2,4,0.0,M2019-12-08D,Race(2),,
14,0,2,2,4,0,0,0,0,1,1,0,2,1,3,2,6,21,21,0.0,M2019-12-08D,Race(2),,
1,0,0,0,0,0,0,0,0,0,0,0,0,0,0,0,0,34,34,1.0,M2019-12-08D,Race(2),,
13,0,0,0,0,0,0,0,0,0,0,0,0,0,0,0,0,61,51,3.0,M2019-12-08D,Race(2),,
1,0,0,0,0,0,0,0,0,0,0,0,0,0,0,0,0,151,151,0.0,M2019-12-08D,Race(3),,
2,0,0,2,2,1,0,0,1,0,0,0,0,1,0,2,3,21,21,0.0,M2019-12-08D,Race(3),,
3,2,2,0,4,0,2,0,2,0,1,1,2,2,5,1,8,15,15,0.0,M2019-12-08D,Race(3),,
5,0,0,0,0,0,0,0,0,0,0,1,1,0,0,1,1,41,41,0.0,M2019-12-08D,Race(3),,
13,0,3,0,3,0,0,1,1,0,1,0,1,0,4,1,5,19,19,3.0,M2019-12-08D,Race(3),,
6,0,0,0,0,0,0,0,0,0,1,0,1,0,1,0,1,34,34,0.0,M2019-12-08D,Race(3),,
8,0,0,14,14,1,2,17,20,0,3,13,16,1,5,44,50,8,8,0.0,M2019-12-08D,Race(3),,
7,0,0,2,2,0,3,1,4,0,4,3,7,0,7,6,13,6.5,6.5,0.0,M2019-12-08D,Race(3),,
9,0,0,0,0,0,0,0,0,0,0,0,0,0,0,0,0,61,61,0.0,M2019-12-08D,Race(3),,
10,7,9,2,18,1,18,4,23,3,10,2,15,11,37,8,56,7,7,0.0,M2019-12-08D,Race(3),,
4,17,7,2,26,27,1,1,29,22,1,2,25,66,9,5,80,2.65,2.7,1.0,M2019-12-08D,Race(3),,
12,0,0,0,0,0,0,0,0,0,1,0,1,0,1,0,1,126,126,0.0,M2019-12-08D,Race(3),,
14,2,9,8,19,0,1,4,5,0,1,1,2,2,11,13,26,7,7,0.0,M2019-12-08D,Race(3),,
11,2,0,0,2,0,3,2,5,1,3,3,7,3,6,5,14,10,10,2.0,M2019-12-08D,Race(3),,
13,2,13,4,19,0,16,8,24,1,7,6,14,3,36,18,57,7,7,0.0,M2019-12-08D,Race(4),,
14,0,0,3,3,0,0,0,0,0,1,1,2,0,1,4,5,34,26,0.0,M2019-12-08D,Race(4),,
1,19,4,5,28,28,2,0,30,24,1,0,25,71,7,5,83,2.3,2.25,3.0,M2019-12-08D,Race(4),,
2,7,5,14,26,2,3,13,18,0,4,5,9,9,12,32,53,21,21,1.0,M2019-12-08D,Race(4),,
3,0,0,0,0,0,1,0,1,1,2,1,4,1,3,1,5,34,26,0.0,M2019-12-08D,Race(4),,
4,0,0,0,0,0,0,1,1,0,0,0,0,0,0,1,1,23,26,0.0,M2019-12-08D,Race(4),,
5,0,0,0,0,0,0,0,0,0,1,0,1,0,1,0,1,26,26,0.0,M2019-12-08D,Race(4),,
6,0,0,0,0,0,0,1,1,0,0,3,3,0,0,4,4,34,26,0.0,M2019-12-08D,Race(4),,
12,0,0,0,0,0,0,0,0,0,1,0,1,0,1,0,1,11,11,0.0,M2019-12-08D,Race(4),,
8,0,0,0,0,0,0,0,0,0,0,1,1,0,0,1,1,26,26,0.0,M2019-12-08D,Race(4),,
10,2,0,2,4,0,4,3,7,0,3,5,8,2,7,10,19,8.5,8.5,0.0,M2019-12-08D,Race(4),,
7,0,3,0,3,0,4,0,4,0,3,0,3,0,10,0,10,11,11,0.0,M2019-12-08D,Race(4),,
11,0,5,2,7,0,0,4,4,0,2,4,6,0,7,10,17,6,7,2.0,M2019-12-08D,Race(4),,
9,0,0,0,0,0,0,0,0,0,1,0,1,0,1,0,1,51,51,0.0,M2019-12-08D,Race(4),,
13,0,0,0,0,0,0,0,0,0,0,0,0,0,0,0,0,0,0,0.0,M2019-12-08D,Race(5),,
2,0,5,0,5,0,0,0,0,0,0,0,0,0,5,0,5,26,21,0.0,M2019-12-08D,Race(5),,
3,0,2,0,2,1,0,1,2,0,2,2,4,1,4,3,8,10,10,0.0,M2019-12-08D,Race(5),,
4,2,8,11,21,3,5,19,27,5,5,10,20,10,18,40,68,7.5,7.5,2.0,M2019-12-08D,Race(5),,
14,20,7,0,27,25,4,1,30,19,4,1,24,64,15,2,81,2,2,3.0,M2019-12-08D,Race(5),,
6,0,0,0,0,0,0,0,0,0,0,0,0,0,0,0,0,0,0,0.0,M2019-12-08D,Race(5),,
5,0,0,0,0,0,0,0,0,0,0,0,0,0,0,0,0,34,26,0.0,M2019-12-08D,Race(5),,
8,0,0,0,0,0,0,0,0,0,0,0,0,0,0,0,0,51,51,0.0,M2019-12-08D,Race(5),,
9,0,0,0,0,0,0,0,0,0,0,0,0,0,0,0,0,34,34,0.0,M2019-12-08D,Race(5),,
10,3,2,3,8,0,1,1,2,0,2,0,2,3,5,4,12,26,21,0.0,M2019-12-08D,Race(5),,
1,5,3,10,18,1,20,6,27,1,11,6,18,7,34,22,63,6.5,6,1.0,M2019-12-08D,Race(5),,
11,0,3,0,3,0,0,0,0,1,1,1,3,1,4,1,6,16,21,0.0,M2019-12-08D,Race(5),,
12,0,0,0,0,0,0,0,0,0,1,1,2,0,1,1,2,23,19,0.0,M2019-12-08D,Race(5),,
7,0,0,6,6,0,0,2,2,0,0,5,5,0,0,13,13,26,26,0.0,M2019-12-08D,Race(5),,
2,3,2,10,15,18,5,5,28,8,6,6,20,29,13,21,63,4.6,4.6,3.0,M2019-12-08D,Race(6),,
3,0,0,0,0,0,1,2,3,1,0,2,3,1,1,4,6,16,16,0.0,M2019-12-08D,Race(6),,
4,0,0,0,0,0,0,0,0,0,0,0,0,0,0,0,0,81,81,0.0,M2019-12-08D,Race(6),,
1,0,0,0,0,1,1,1,3,1,2,1,4,2,3,2,7,17,17,0.0,M2019-12-08D,Race(6),,
5,0,0,0,0,0,0,1,1,1,1,0,2,1,1,1,3,26,26,0.0,M2019-12-08D,Race(6),,
6,2,0,0,2,0,0,1,1,0,1,0,1,2,1,1,4,12,12,0.0,M2019-12-08D,Race(6),,
14,0,0,0,0,0,0,0,0,0,0,0,0,0,0,0,0,61,61,0.0,M2019-12-08D,Race(6),,
13,0,2,0,2,0,0,0,0,0,0,0,0,0,2,0,2,31,31,0.0,M2019-12-08D,Race(6),,
12,3,2,2,7,1,0,0,1,0,0,3,3,4,2,5,11,9,9,0.0,M2019-12-08D,Race(6),,
11,0,3,0,3,0,0,0,0,0,0,0,0,0,3,0,3,21,21,0.0,M2019-12-08D,Race(6),,
9,8,9,7,24,6,17,2,25,4,12,5,21,18,38,14,70,3,3,2.0,M2019-12-08D,Race(6),,
8,7,6,8,21,3,3,13,19,8,4,4,16,18,13,25,56,9,9,0.0,M2019-12-08D,Race(6),,
7,7,6,3,16,1,3,5,9,3,0,5,8,11,9,13,33,7,7,1.0,M2019-12-08D,Race(6),,
10,0,0,0,0,0,0,0,0,0,0,0,0,0,0,0,0,101,101,0.0,M2019-12-08D,Race(6),,
1,6,0,15,21,8,15,7,30,5,8,11,24,19,23,33,75,3.1,3.25,3.0,M2019-12-08D,Race(7),,
4,7,11,2,20,20,8,1,29,18,7,1,26,45,26,4,75,4.6,4.2,2.0,M2019-12-08D,Race(7),,
3,0,0,0,0,0,0,0,0,2,1,0,3,2,1,0,3,19,17,0.0,M2019-12-08D,Race(7),,
5,0,0,0,0,0,0,0,0,0,0,0,0,0,0,0,0,41,41,0.0,M2019-12-08D,Race(7),,
6,0,4,2,6,0,0,2,2,1,3,4,8,1,7,8,16,8,8,0.0,M2019-12-08D,Race(7),,
7,0,0,0,0,0,0,0,0,0,0,0,0,0,0,0,0,51,51,0.0,M2019-12-08D,Race(7),,
8,0,0,0,0,0,0,0,0,0,0,0,0,0,0,0,0,51,51,0.0,M2019-12-08D,Race(7),,
9,2,0,0,2,1,0,0,1,0,0,1,1,3,0,1,4,11,11,1.0,M2019-12-08D,Race(7),,
10,3,2,8,13,0,0,1,1,0,0,2,2,3,2,11,16,10,10,0.0,M2019-12-08D,Race(7),,
2,12,13,3,28,1,7,19,27,0,7,7,14,13,27,29,69,3.1,3.25,0.0,M2019-12-08D,Race(7),,
3,0,0,0,0,0,2,0,2,0,0,0,0,0,2,0,2,15,15,0.0,M2019-12-08D,Race(8),,
1,8,8,4,20,7,14,7,28,5,10,8,23,20,32,19,71,5,4.8,1.0,M2019-12-08D,Race(8),,
2,3,10,4,17,16,3,6,25,9,2,3,14,28,15,13,56,5,5.5,3.0,M2019-12-08D,Race(8),,
4,0,0,2,2,0,1,0,1,0,1,0,1,0,2,2,4,15,15,0.0,M2019-12-08D,Race(8),,
5,0,0,0,0,0,0,0,0,0,0,1,1,0,0,1,1,26,26,0.0,M2019-12-08D,Race(8),,
6,15,2,8,25,2,3,12,17,8,6,6,20,25,11,26,62,2.9,3.25,0.0,M2019-12-08D,Race(8),,
7,4,5,12,21,3,4,3,10,2,5,5,12,9,14,20,43,3.6,3.5,2.0,M2019-12-08D,Race(8),,
8,0,5,0,5,2,3,2,7,2,2,3,7,4,10,5,19,13,10,0.0,M2019-12-08D,Race(8),,
5,0,0,0,0,1,1,0,2,0,0,0,0,1,1,0,2,26,26,0.0,M2019-12-08D,Race(9),,
9,0,0,0,0,0,0,0,0,0,0,0,0,0,0,0,0,61,61,0.0,M2019-12-08D,Race(9),,
7,4,0,0,4,0,2,0,2,1,2,0,3,5,4,0,9,14,15,0.0,M2019-12-08D,Race(9),,
10,6,7,2,15,4,14,7,25,7,8,5,20,17,29,14,60,3.5,3.6,0.0,M2019-12-08D,Race(9),,
12,0,3,3,6,0,0,0,0,0,1,1,2,0,4,4,8,18,21,0.0,M2019-12-08D,Race(9),,
4,2,10,8,20,4,3,5,12,6,3,6,15,12,16,19,47,4.2,4.5,1.0,M2019-12-08D,Race(9),,
13,0,0,0,0,0,0,0,0,0,0,0,0,0,0,0,0,81,81,0.0,M2019-12-08D,Race(9),,
14,0,0,0,0,0,0,0,0,0,0,1,1,0,0,1,1,31,31,0.0,M2019-12-08D,Race(9),,
6,4,3,9,16,3,3,1,7,1,4,1,6,8,10,11,29,6.5,7,3.0,M2019-12-08D,Race(9),,
3,0,0,0,0,0,0,0,0,0,0,0,0,0,0,0,0,26,26,0.0,M2019-12-08D,Race(9),,
2,14,0,4,18,5,6,13,24,8,7,5,20,27,13,22,62,4.6,4.4,2.0,M2019-12-08D,Race(9),,
1,0,7,4,11,13,1,4,18,3,1,7,11,16,9,15,40,9.5,10,0.0,M2019-12-08D,Race(9),,
11,0,0,0,0,0,0,0,0,0,0,0,0,0,0,0,0,41,41,0.0,M2019-12-08D,Race(9),,
8,0,0,0,0,0,0,0,0,0,0,0,0,0,0,0,0,31,31,0.0,M2019-12-08D,Race(9),,
4,2,0,0,2,4,11,5,20,6,10,1,17,12,21,6,39,8,8,0.0,M2019-12-11D,Race(1),,
6,3,0,4,7,0,0,0,0,0,0,0,0,3,0,4,7,16,16,0.0,M2019-12-11D,Race(1),,
12,0,3,5,8,0,1,8,9,0,0,1,1,0,4,14,18,7.5,7.5,0.0,M2019-12-11D,Race(1),,
11,0,0,0,0,0,0,0,0,0,0,0,0,0,0,0,0,81,81,0.0,M2019-12-11D,Race(1),,
10,2,5,0,7,0,2,1,3,0,3,1,4,2,10,2,14,17,17,2.0,M2019-12-11D,Race(1),,
9,0,8,6,14,0,8,9,17,0,3,8,11,0,19,23,42,7.5,7.5,0.0,M2019-12-11D,Race(1),,
8,0,0,0,0,0,0,0,0,0,0,1,1,0,0,1,1,51,51,0.0,M2019-12-11D,Race(1),,
5,7,3,6,16,9,2,1,12,2,5,2,9,18,10,9,37,4.8,4.8,1.0,M2019-12-11D,Race(1),,
3,0,2,5,7,0,1,5,6,0,0,8,8,0,3,18,21,19,19,0.0,M2019-12-11D,Race(1),,
2,0,0,0,0,0,0,1,1,0,0,4,4,0,0,5,5,51,51,0.0,M2019-12-11D,Race(1),,
1,16,9,2,27,17,5,0,22,18,5,0,23,51,19,2,72,2.3,2.3,3.0,M2019-12-11D,Race(1),,
7,0,0,2,2,0,0,0,0,0,0,0,0,0,0,2,2,51,51,0.0,M2019-12-11D,Race(1),,
1,14,12,0,26,18,4,1,23,18,7,0,25,50,23,1,74,3,3,0.0,M2019-12-11D,Race(2),,
3,2,0,0,2,0,0,0,0,0,2,0,2,2,2,0,4,26,26,0.0,M2019-12-11D,Race(2),,
2,4,14,12,30,1,8,12,21,2,7,11,20,7,29,35,71,3.3,3.3,1.0,M2019-12-11D,Race(2),,
6,8,0,15,23,10,10,7,27,3,7,8,18,21,17,30,68,3.6,3.6,2.0,M2019-12-11D,Race(2),,
12,0,0,0,0,0,0,0,0,0,0,3,3,0,0,3,3,16,16,0.0,M2019-12-11D,Race(2),,
7,0,0,0,0,0,0,0,0,0,0,0,0,0,0,0,0,101,101,0.0,M2019-12-11D,Race(2),,
4,0,0,0,0,0,0,0,0,0,0,0,0,0,0,0,0,51,51,0.0,M2019-12-11D,Race(2),,
9,0,2,0,2,0,0,1,1,0,2,2,4,0,4,3,7,11,11,0.0,M2019-12-11D,Race(2),,
10,0,0,3,3,0,8,0,8,0,1,0,1,0,9,3,12,21,21,3.0,M2019-12-11D,Race(2),,
11,0,0,0,0,1,0,1,2,2,0,1,3,3,0,2,5,41,41,0.0,M2019-12-11D,Race(2),,
8,2,2,0,4,0,0,8,8,1,0,1,2,3,2,9,14,26,26,0.0,M2019-12-11D,Race(2),,
5,0,0,0,0,0,0,0,0,0,0,0,0,0,0,0,0,31,31,0.0,M2019-12-11D,Race(2),,
10,0,0,0,0,0,0,0,0,0,0,0,0,0,0,0,0,34,34,0.0,M2019-12-11D,Race(3),,
11,0,0,0,0,0,0,0,0,0,0,1,1,0,0,1,1,81,81,0.0,M2019-12-11D,Race(3),,
5,2,0,0,2,0,1,0,1,0,3,2,5,2,4,2,8,26,26,3.0,M2019-12-11D,Race(3),,
9,0,0,0,0,0,0,0,0,0,0,0,0,0,0,0,0,81,81,0.0,M2019-12-11D,Race(3),,
7,5,2,3,10,5,3,12,20,3,5,3,11,13,10,18,41,7,7,0.0,M2019-12-11D,Race(3),,
8,0,0,0,0,0,0,0,0,0,1,0,1,0,1,0,1,9,9,1.0,M2019-12-11D,Race(3),,
12,0,0,0,0,1,1,1,3,1,2,1,4,2,3,2,7,19,19,0.0,M2019-12-11D,Race(3),,
3,16,12,0,28,16,10,2,28,21,0,2,23,53,22,4,79,2.4,2.4,0.0,M2019-12-11D,Race(3),,
1,2,6,14,22,8,9,7,24,0,8,4,12,10,23,25,58,5.5,5.5,0.0,M2019-12-11D,Race(3),,
2,0,0,0,0,0,0,0,0,0,0,0,0,0,0,0,0,126,126,0.0,M2019-12-11D,Race(3),,
4,2,6,10,18,0,5,8,13,1,5,11,17,3,16,29,48,5.5,5.5,0.0,M2019-12-11D,Race(3),,
6,3,4,3,10,0,1,0,1,0,2,2,4,3,7,5,15,12,12,2.0,M2019-12-11D,Race(3),,
2,3,2,4,9,10,3,4,17,2,3,9,14,15,8,17,40,10,10,0.0,M2019-12-11D,Race(4),,
4,2,7,0,9,1,0,3,4,1,2,2,5,4,9,5,18,12,12,0.0,M2019-12-11D,Race(4),,
12,0,0,0,0,0,0,0,0,0,0,0,0,0,0,0,0,31,31,0.0,M2019-12-11D,Race(4),,
11,2,10,8,20,3,5,10,18,5,5,2,12,10,20,20,50,4.6,4.6,3.0,M2019-12-11D,Race(4),,
10,0,0,0,0,0,0,0,0,0,0,0,0,0,0,0,0,151,151,0.0,M2019-12-11D,Race(4),,
9,6,2,3,11,3,10,3,16,5,6,3,14,14,18,9,41,5,5,0.0,M2019-12-11D,Race(4),,
8,0,0,0,0,0,0,0,0,0,0,0,0,0,0,0,0,26,26,0.0,M2019-12-11D,Race(4),,
7,0,0,0,0,0,0,0,0,0,0,0,0,0,0,0,0,21,21,0.0,M2019-12-11D,Race(4),,
6,7,3,0,10,4,6,4,14,7,5,5,17,18,14,9,41,5,5,0.0,M2019-12-11D,Race(4),,
5,2,0,0,2,1,0,0,1,0,0,0,0,3,0,0,3,12,12,0.0,M2019-12-11D,Race(4),,
3,3,0,8,11,1,1,3,5,1,0,3,4,5,1,14,20,16,16,1.0,M2019-12-11D,Race(4),,
1,5,6,7,18,7,5,3,15,5,5,2,12,17,16,12,45,4.8,4.8,2.0,M2019-12-11D,Race(4),,
7,0,0,0,0,0,0,0,0,0,0,0,0,0,0,0,0,101,101,0.0,M2019-12-11D,Race(5),,
3,0,5,6,11,1,1,5,7,1,1,2,4,2,7,13,22,13,13,0.0,M2019-12-11D,Race(5),,
4,0,0,3,3,0,0,0,0,0,0,4,4,0,0,7,7,21,21,0.0,M2019-12-11D,Race(5),,
8,7,5,4,16,4,4,4,12,4,5,3,12,15,14,11,40,3.4,3.4,0.0,M2019-12-11D,Race(5),,
1,9,6,3,18,10,8,6,24,7,7,5,19,26,21,14,61,7,7,2.0,M2019-12-11D,Race(5),,
6,0,0,2,2,0,1,0,1,0,0,0,0,0,1,2,3,34,34,0.0,M2019-12-11D,Race(5),,
5,0,0,0,0,1,0,0,1,0,0,0,0,1,0,0,1,31,31,3.0,M2019-12-11D,Race(5),,
9,0,0,0,0,0,0,0,0,0,0,0,0,0,0,0,0,126,126,0.0,M2019-12-11D,Race(5),,
10,0,0,0,0,0,0,2,2,0,1,1,2,0,1,3,4,17,17,1.0,M2019-12-11D,Race(5),,
11,5,7,5,17,0,4,10,14,0,6,2,8,5,17,17,39,5.5,5.5,0.0,M2019-12-11D,Race(5),,
2,9,2,3,14,14,10,3,27,14,5,4,23,37,17,10,64,3.5,3.5,0.0,M2019-12-11D,Race(5),,
12,0,5,4,9,0,2,0,2,0,1,5,6,0,8,9,17,9,9,0.0,M2019-12-11D,Race(5),,
3,0,0,0,0,0,0,0,0,0,0,0,0,0,0,0,0,41,41,0.0,M2019-12-11D,Race(6),,
9,0,0,0,0,0,0,1,1,1,1,3,5,1,1,4,6,14,14,0.0,M2019-12-11D,Race(6),,
12,0,2,3,5,0,1,0,1,0,0,2,2,0,3,5,8,21,21,0.0,M2019-12-11D,Race(6),,
11,0,0,2,2,10,0,4,14,2,1,1,4,12,1,7,20,7,7,3.0,M2019-12-11D,Race(6),,
4,0,0,0,0,0,0,8,8,0,0,2,2,0,0,10,10,21,21,1.0,M2019-12-11D,Race(6),,
5,0,0,2,2,0,0,0,0,1,0,0,1,1,0,2,3,17,17,0.0,M2019-12-11D,Race(6),,
6,21,2,7,30,2,13,7,22,3,9,8,20,26,24,22,72,3.4,3.4,2.0,M2019-12-11D,Race(6),,
7,0,8,5,13,0,1,1,2,1,0,2,3,1,9,8,18,9,9,0.0,M2019-12-11D,Race(6),,
8,0,0,0,0,0,0,0,0,0,0,0,0,0,0,0,0,51,51,0.0,M2019-12-11D,Race(6),,
10,0,0,0,0,0,0,0,0,0,0,0,0,0,0,0,0,81,81,0.0,M2019-12-11D,Race(6),,
2,9,10,3,22,13,5,4,22,14,7,1,22,36,22,8,66,4,4,0.0,M2019-12-11D,Race(6),,
1,0,8,8,16,5,10,5,20,4,8,7,19,9,26,20,55,5,5,0.0,M2019-12-11D,Race(6),,
12,2,11,7,20,9,1,1,11,2,5,3,10,13,17,11,41,3.3,3.3,2.0,M2019-12-11D,Race(7),,
9,0,2,7,9,1,1,0,2,1,2,1,4,2,5,8,15,9,9,0.0,M2019-12-11D,Race(7),,
6,0,0,0,0,1,0,0,1,1,0,1,2,2,0,1,3,18,18,3.0,M2019-12-11D,Race(7),,
8,0,0,0,0,0,0,0,0,1,0,0,1,1,0,0,1,71,67,0.0,M2019-12-11D,Race(7),,
7,0,0,0,0,0,0,0,0,0,0,0,0,0,0,0,0,126,126,0.0,M2019-12-11D,Race(7),,
5,0,0,0,0,0,0,0,0,0,0,0,0,0,0,0,0,81,81,0.0,M2019-12-11D,Race(7),,
4,3,3,6,12,1,11,10,22,1,0,11,12,5,14,27,46,14,14,0.0,M2019-12-11D,Race(7),,
3,17,6,5,28,16,4,1,21,13,8,1,22,46,18,7,71,3.3,3.3,1.0,M2019-12-11D,Race(7),,
1,5,4,0,9,1,6,8,15,6,6,3,15,12,16,11,39,6,6,0.0,M2019-12-11D,Race(7),,
10,3,0,0,3,0,2,10,12,0,1,5,6,3,3,15,21,15,15,0.0,M2019-12-11D,Race(7),,
11,0,2,0,2,0,0,0,0,0,1,0,1,0,3,0,3,10,10,0.0,M2019-12-11D,Race(7),,
2,0,2,5,7,1,5,0,6,1,3,1,5,2,10,6,18,15,15,0.0,M2019-12-11D,Race(7),,
1,13,3,5,21,3,3,10,16,5,5,5,15,21,11,20,52,4.6,4.5,1.0,M2019-12-11D,Race(8),,
5,0,0,2,2,1,0,0,1,0,0,0,0,1,0,2,3,41,41,0.0,M2019-12-11D,Race(8),,
9,0,0,0,0,0,1,0,1,0,1,0,1,0,2,0,2,26,26,0.0,M2019-12-11D,Race(8),,
8,3,2,5,10,9,4,9,22,8,3,3,14,20,9,17,46,21,21,2.0,M2019-12-11D,Race(8),,
2,0,0,0,0,0,0,0,0,0,0,0,0,0,0,0,0,81,81,0.0,M2019-12-11D,Race(8),,
3,0,0,0,0,0,1,0,1,0,0,0,0,0,1,0,1,51,51,0.0,M2019-12-11D,Race(8),,
4,4,12,5,21,12,6,1,19,7,7,5,19,23,25,11,59,3.8,3.8,0.0,M2019-12-11D,Race(8),,
12,0,0,0,0,0,0,0,0,0,0,0,0,0,0,0,0,51,51,0.0,M2019-12-11D,Race(8),,
6,0,4,0,4,1,1,2,4,1,0,4,5,2,5,6,13,8,8,0.0,M2019-12-11D,Race(8),,
7,4,0,2,6,0,10,1,11,0,4,4,8,4,14,7,25,5,5,3.0,M2019-12-11D,Race(8),,
11,3,4,9,16,4,4,7,15,3,4,5,12,10,12,21,43,5.5,5.5,0.0,M2019-12-11D,Race(8),,
10,3,5,2,10,0,0,0,0,2,2,0,4,5,7,2,14,8,8,0.0,M2019-12-11D,Race(8),,
2,0,0,0,0,0,0,0,0,0,0,0,0,0,0,0,0,26,26,0.0,M2019-12-11D,Race(9),,
5,10,5,5,20,4,7,7,18,3,9,6,18,17,21,18,56,4,4,3.0,M2019-12-11D,Race(9),,
6,11,5,6,22,9,8,2,19,0,7,3,10,20,20,11,51,8,8,0.0,M2019-12-11D,Race(9),,
10,0,0,0,0,0,0,0,0,0,0,0,0,0,0,0,0,14,14,2.0,M2019-12-11D,Race(9),,
3,2,13,4,19,14,1,6,21,20,3,3,26,36,17,13,66,3.2,3.2,0.0,M2019-12-11D,Race(9),,
4,0,0,3,3,0,1,1,2,0,2,3,5,0,3,7,10,21,21,0.0,M2019-12-11D,Race(9),,
9,2,0,0,2,1,2,9,12,1,2,5,8,4,4,14,22,7.5,7.5,0.0,M2019-12-11D,Race(9),,
7,2,3,5,10,1,9,1,11,0,1,1,2,3,13,7,23,9,9,0.0,M2019-12-11D,Race(9),,
8,0,0,2,2,0,0,0,0,0,0,0,0,0,0,2,2,91,91,0.0,M2019-12-11D,Race(9),,
12,0,2,0,2,0,0,0,0,0,0,0,0,0,2,0,2,34,34,0.0,M2019-12-11D,Race(9),,
11,0,0,0,0,1,0,0,1,0,0,0,0,1,0,0,1,31,31,0.0,M2019-12-11D,Race(9),,
1,3,2,5,10,0,2,4,6,2,2,5,9,5,6,14,25,8.5,8.5,1.0,M2019-12-11D,Race(9),,
13,5,8,14,27,3,15,8,26,2,9,6,17,10,32,28,70,5,5,0.0,M2019-12-15D,Race(1),,
8,0,2,3,5,0,0,0,0,0,0,1,1,0,2,4,6,26,26,0.0,M2019-12-15D,Race(1),,
10,0,0,0,0,0,0,0,0,0,0,0,0,0,0,0,0,21,21,0.0,M2019-12-15D,Race(1),,
9,6,0,5,11,4,3,13,20,5,4,8,17,15,7,26,48,8.5,8.5,2.0,M2019-12-15D,Race(1),,
7,0,0,0,0,0,0,1,1,0,1,1,2,0,1,2,3,17,17,0.0,M2019-12-15D,Race(1),,
12,0,0,0,0,0,0,0,0,0,0,0,0,0,0,0,0,71,71,0.0,M2019-12-15D,Race(1),,
14,0,0,0,0,0,0,0,0,0,0,1,1,0,0,1,1,26,26,0.0,M2019-12-15D,Race(1),,
1,2,7,0,9,1,3,3,7,2,3,3,8,5,13,6,24,7,7,1.0,M2019-12-15D,Race(1),,
2,0,0,0,0,0,0,0,0,0,1,0,1,0,1,0,1,61,61,0.0,M2019-12-15D,Race(1),,
3,0,0,0,0,0,0,0,0,0,0,0,0,0,0,0,0,81,81,0.0,M2019-12-15D,Race(1),,
4,5,6,6,17,0,5,4,9,1,5,4,10,6,16,14,36,5.5,5.5,3.0,M2019-12-15D,Race(1),,
5,0,0,0,0,1,0,1,2,1,0,1,2,2,0,2,4,41,41,0.0,M2019-12-15D,Race(1),,
11,0,2,0,2,0,1,0,1,0,0,0,0,0,3,0,3,34,34,0.0,M2019-12-15D,Race(1),,
6,12,5,2,19,21,4,0,25,15,3,1,19,48,12,3,63,2.8,2.8,0.0,M2019-12-15D,Race(1),,
3,6,7,0,13,4,6,3,13,3,7,3,13,13,20,6,39,5,5,1.0,M2019-12-15D,Race(10),,
5,0,0,0,0,0,0,0,0,0,0,0,0,0,0,0,0,41,41,0.0,M2019-12-15D,Race(10),,
6,0,0,0,0,0,0,0,0,0,0,0,0,0,0,0,0,71,67,0.0,M2019-12-15D,Race(10),,
7,0,0,0,0,0,0,0,0,0,0,0,0,0,0,0,0,71,67,0.0,M2019-12-15D,Race(10),,
11,0,0,0,0,0,0,0,0,0,0,0,0,0,0,0,0,101,101,0.0,M2019-12-15D,Race(10),,
9,14,8,3,25,18,5,3,26,9,7,3,19,41,20,9,70,3.1,3.1,0.0,M2019-12-15D,Race(10),,
10,0,2,3,5,1,0,13,14,1,2,5,8,2,4,21,27,14,14,2.0,M2019-12-15D,Race(10),,
2,0,0,0,0,0,0,1,1,1,1,3,5,1,1,4,6,19,19,0.0,M2019-12-15D,Race(10),,
12,0,0,0,0,0,0,0,0,0,0,1,1,0,0,1,1,34,34,0.0,M2019-12-15D,Race(10),,
13,0,4,7,11,0,1,3,4,0,2,4,6,0,7,14,21,6,6,3.0,M2019-12-15D,Race(10),,
14,4,0,0,4,0,1,0,1,0,1,0,1,4,2,0,6,15,15,0.0,M2019-12-15D,Race(10),,
8,0,0,0,0,0,0,0,0,0,0,0,0,0,0,0,0,126,126,0.0,M2019-12-15D,Race(10),,
1,6,6,9,21,7,15,5,27,11,5,4,20,24,26,18,68,6.5,6.5,0.0,M2019-12-15D,Race(10),,
4,0,3,8,11,0,2,2,4,1,1,3,5,1,6,13,20,7,7,0.0,M2019-12-15D,Race(10),,
7,0,0,0,0,0,0,0,0,0,0,0,0,0,0,0,0,61,61,0.0,M2019-12-15D,Race(2),,
1,0,0,0,0,1,1,1,3,3,0,1,4,4,1,2,7,41,41,0.0,M2019-12-15D,Race(2),,
2,5,8,6,19,1,2,4,7,0,0,8,8,6,10,18,34,4.6,4.6,0.0,M2019-12-15D,Race(2),,
3,2,0,5,7,3,2,4,9,1,1,2,4,6,3,11,20,10,10,0.0,M2019-12-15D,Race(2),,
4,0,0,0,0,0,0,0,0,1,0,1,2,1,0,1,2,15,15,0.0,M2019-12-15D,Race(2),,
5,0,0,0,0,0,0,0,0,0,1,0,1,0,1,0,1,14,14,0.0,M2019-12-15D,Race(2),,
6,9,13,2,24,15,7,3,25,10,7,4,21,34,27,9,70,4.8,4.8,0.0,M2019-12-15D,Race(2),,
12,2,0,0,2,1,0,0,1,3,0,2,5,6,0,2,8,21,21,0.0,M2019-12-15D,Race(2),,
14,0,0,2,2,0,0,0,0,0,1,1,2,0,1,3,4,41,41,0.0,M2019-12-15D,Race(2),,
8,0,3,0,3,0,0,0,0,0,1,0,1,0,4,0,4,41,41,2.0,M2019-12-15D,Race(2),,
9,7,3,7,17,3,5,13,21,3,7,2,12,13,15,22,50,7,7,3.0,M2019-12-15D,Race(2),,
10,5,3,5,13,6,13,5,24,5,8,5,18,16,24,15,55,3.4,3.4,1.0,M2019-12-15D,Race(2),,
11,0,0,3,3,0,0,0,0,0,0,0,0,0,0,3,3,81,81,0.0,M2019-12-15D,Race(2),,
13,0,0,0,0,0,0,0,0,0,0,0,0,0,0,0,0,34,34,0.0,M2019-12-15D,Race(2),,
5,0,2,2,4,0,2,0,2,0,2,1,3,0,6,3,9,12,12,0.0,M2019-12-15D,Race(3),,
6,0,0,0,0,0,0,0,0,0,1,0,1,0,1,0,1,18,17,0.0,M2019-12-15D,Race(3),,
2,8,4,8,20,6,1,15,22,4,4,6,14,18,9,29,56,4.4,4.4,0.0,M2019-12-15D,Race(3),,
1,0,0,5,5,1,2,3,6,1,4,3,8,2,6,11,19,12,12,0.0,M2019-12-15D,Race(3),,
4,0,0,0,0,0,0,1,1,0,0,0,0,0,0,1,1,41,41,0.0,M2019-12-15D,Race(3),,
7,8,8,4,20,15,7,4,26,7,9,5,21,30,24,13,67,4.4,4.4,0.0,M2019-12-15D,Race(3),,
8,5,3,0,8,0,1,0,1,0,1,0,1,5,5,0,10,12,13,0.0,M2019-12-15D,Race(3),,
9,0,0,3,3,0,0,0,0,0,0,0,0,0,0,3,3,34,34,0.0,M2019-12-15D,Race(3),,
10,4,3,8,15,1,3,4,8,2,3,6,11,7,9,18,34,4.8,4.8,1.0,M2019-12-15D,Race(3),,
11,0,5,0,5,0,0,1,1,0,0,0,0,0,5,1,6,17,17,0.0,M2019-12-15D,Race(3),,
3,5,2,0,7,7,14,2,23,12,2,5,19,24,18,7,49,5.5,6,2.0,M2019-12-15D,Race(3),,
12,0,3,0,3,0,0,0,0,0,0,0,0,0,3,0,3,26,31,3.0,M2019-12-15D,Race(3),,
14,0,0,0,0,0,0,0,0,0,0,0,0,0,0,0,0,41,41,0.0,M2019-12-15D,Race(4),,
10,5,3,3,11,1,2,4,7,4,2,7,13,10,7,14,31,6.5,6.5,0.0,M2019-12-15D,Race(4),,
9,0,0,0,0,0,0,0,0,0,0,0,0,0,0,0,0,61,61,0.0,M2019-12-15D,Race(4),,
5,0,0,0,0,1,0,0,1,0,1,0,1,1,1,0,2,41,41,0.0,M2019-12-15D,Race(4),,
8,0,2,2,4,0,1,0,1,0,1,0,1,0,4,2,6,23,21,0.0,M2019-12-15D,Race(4),,
7,0,0,0,0,0,0,0,0,0,0,0,0,0,0,0,0,81,81,0.0,M2019-12-15D,Race(4),,
6,7,7,4,18,5,13,5,23,7,6,4,17,19,26,13,58,4.4,4.4,0.0,M2019-12-15D,Race(4),,
4,0,0,0,0,0,0,0,0,1,1,0,2,1,1,0,2,26,26,0.0,M2019-12-15D,Race(4),,
3,0,0,0,0,0,0,0,0,0,0,0,0,0,0,0,0,61,71,0.0,M2019-12-15D,Race(4),,
2,0,5,5,10,5,2,4,11,5,3,6,14,10,10,15,35,13,12,3.0,M2019-12-15D,Race(4),,
13,5,3,5,13,16,7,5,28,8,9,3,20,29,19,13,61,3.9,3.8,0.0,M2019-12-15D,Race(4),,
12,3,3,5,11,1,0,0,1,0,0,0,0,4,3,5,12,8,8,1.0,M2019-12-15D,Race(4),,
11,7,7,6,20,1,4,11,16,1,2,6,9,9,13,23,45,4.2,4.8,0.0,M2019-12-15D,Race(4),,
1,3,0,0,3,0,1,1,2,0,1,0,1,3,2,1,6,26,26,2.0,M2019-12-15D,Race(4),,
14,0,0,0,0,0,0,1,1,0,1,0,1,0,1,1,2,17,17,0.0,M2019-12-15D,Race(5),,
12,2,6,7,15,2,0,4,6,1,2,4,7,5,8,15,28,10,10,0.0,M2019-12-15D,Race(5),,
11,0,2,8,10,13,4,4,21,5,5,3,13,18,11,15,44,3.8,3.8,1.0,M2019-12-15D,Race(5),,
10,2,0,3,5,4,15,4,23,5,6,4,15,11,21,11,43,6,6,0.0,M2019-12-15D,Race(5),,
9,2,4,3,9,1,1,0,2,0,2,1,3,3,7,4,14,8.5,8.5,3.0,M2019-12-15D,Race(5),,
8,0,0,2,2,0,0,0,0,0,0,1,1,0,0,3,3,81,81,0.0,M2019-12-15D,Race(5),,
7,0,0,0,0,0,0,0,0,0,0,0,0,0,0,0,0,51,51,0.0,M2019-12-15D,Race(5),,
6,0,0,0,0,0,0,1,1,0,2,0,2,0,2,1,3,31,31,0.0,M2019-12-15D,Race(5),,
5,2,0,0,2,0,2,1,3,0,2,2,4,2,4,3,9,31,31,2.0,M2019-12-15D,Race(5),,
4,11,6,5,22,4,3,13,20,6,3,10,19,21,12,28,61,6,6,0.0,M2019-12-15D,Race(5),,
3,0,0,0,0,0,0,0,0,0,0,0,0,0,0,0,0,34,34,0.0,M2019-12-15D,Race(5),,
2,8,5,2,15,6,5,2,13,9,3,1,13,23,13,5,41,5,5,0.0,M2019-12-15D,Race(5),,
1,3,7,0,10,0,0,0,0,0,0,0,0,3,7,0,10,14,14,0.0,M2019-12-15D,Race(5),,
13,0,0,0,0,0,0,0,0,0,0,0,0,0,0,0,0,101,101,0.0,M2019-12-15D,Race(5),,
1,0,0,0,0,0,0,0,0,0,0,0,0,0,0,0,0,41,34,0.0,M2019-12-15D,Race(6),,
4,11,9,0,20,15,7,1,23,9,5,1,15,35,21,2,58,6,5,2.0,M2019-12-15D,Race(6),,
5,0,0,0,0,0,0,0,0,0,2,0,2,0,2,0,2,19,19,0.0,M2019-12-15D,Race(6),,
14,0,0,0,0,0,0,0,0,0,0,0,0,0,0,0,0,101,101,0.0,M2019-12-15D,Race(6),,
6,2,0,0,2,0,4,2,6,0,2,4,6,2,6,6,14,19,19,0.0,M2019-12-15D,Race(6),,
7,0,0,0,0,0,0,0,0,0,0,0,0,0,0,0,0,151,151,0.0,M2019-12-15D,Race(6),,
8,0,0,0,0,0,0,0,0,0,0,0,0,0,0,0,0,71,67,0.0,M2019-12-15D,Race(6),,
9,0,0,0,0,0,0,0,0,0,0,0,0,0,0,0,0,34,34,0.0,M2019-12-15D,Race(6),,
10,8,5,8,21,3,4,2,9,5,6,1,12,16,15,11,42,4.8,4.6,3.0,M2019-12-15D,Race(6),,
12,0,0,0,0,0,0,0,0,0,0,0,0,0,0,0,0,151,151,0.0,M2019-12-15D,Race(6),,
3,2,3,8,13,1,2,2,5,2,2,0,4,5,7,10,22,6,6,0.0,M2019-12-15D,Race(6),,
13,0,5,4,9,2,0,12,14,3,1,6,10,5,6,22,33,5.5,5.5,1.0,M2019-12-15D,Race(6),,
2,5,8,10,23,7,11,7,25,6,4,8,18,18,23,25,66,3.9,5,0.0,M2019-12-15D,Race(6),,
11,2,0,0,2,0,1,2,3,0,1,4,5,2,2,6,10,9,9,0.0,M2019-12-15D,Race(6),,
4,23,5,2,30,30,0,0,30,25,1,0,26,78,6,2,86,1.45,1.45,1.0,M2019-12-15D,Race(7),,
1,0,2,3,5,0,0,1,1,0,0,1,1,0,2,5,7,41,41,0.0,M2019-12-15D,Race(7),,
2,4,2,0,6,0,2,4,6,0,4,6,10,4,8,10,22,7.5,8,3.0,M2019-12-15D,Race(7),,
7,0,0,0,0,0,0,0,0,0,1,1,2,0,1,1,2,81,81,0.0,M2019-12-15D,Race(7),,
6,0,0,0,0,0,0,0,0,0,0,0,0,0,0,0,0,71,67,0.0,M2019-12-15D,Race(7),,
5,0,3,0,3,0,0,1,1,0,0,0,0,0,3,1,4,17,17,0.0,M2019-12-15D,Race(7),,
9,0,0,0,0,0,1,0,1,0,0,2,2,0,1,2,3,23,26,0.0,M2019-12-15D,Race(7),,
10,0,10,11,21,0,18,7,25,0,7,6,13,0,35,24,59,8.5,8.5,0.0,M2019-12-15D,Race(7),,
8,0,3,10,13,0,8,14,22,0,11,7,18,0,22,31,53,11,11,2.0,M2019-12-15D,Race(7),,
12,0,0,0,0,0,0,0,0,0,0,0,0,0,0,0,0,61,61,0.0,M2019-12-15D,Race(7),,
3,3,5,4,12,0,1,3,4,1,2,3,6,4,8,10,22,13,13,0.0,M2019-12-15D,Race(7),,
11,0,0,0,0,0,0,0,0,0,0,0,0,0,0,0,0,61,81,0.0,M2019-12-15D,Race(7),,
2,0,3,0,3,0,0,3,3,0,0,4,4,0,3,7,10,26,26,0.0,M2019-12-15D,Race(8),,
14,3,0,3,6,0,1,1,2,0,1,0,1,3,2,4,9,11,11,0.0,M2019-12-15D,Race(8),,
13,0,0,0,0,0,0,0,0,0,0,0,0,0,0,0,0,31,31,0.0,M2019-12-15D,Race(8),,
12,0,0,0,0,0,0,0,0,0,0,0,0,0,0,0,0,61,61,0.0,M2019-12-15D,Race(8),,
11,13,7,10,30,7,18,4,29,4,11,7,22,24,36,21,81,2.8,2.8,0.0,M2019-12-15D,Race(8),,
10,0,0,0,0,0,0,0,0,0,1,0,1,0,1,0,1,61,61,0.0,M2019-12-15D,Race(8),,
1,3,3,6,12,1,3,18,22,2,1,9,12,6,7,33,46,8,8,3.0,M2019-12-15D,Race(8),,
7,0,2,0,2,0,1,1,2,1,4,2,7,1,7,3,11,26,26,0.0,M2019-12-15D,Race(8),,
9,11,13,6,30,22,6,2,30,18,5,2,25,51,24,10,85,2.7,2.7,1.0,M2019-12-15D,Race(8),,
5,0,2,0,2,0,1,0,1,0,3,1,4,0,6,1,7,21,21,0.0,M2019-12-15D,Race(8),,
6,0,0,5,5,0,0,0,0,0,0,1,1,0,0,6,6,19,19,0.0,M2019-12-15D,Race(8),,
8,0,0,0,0,0,0,1,1,0,0,0,0,0,0,1,1,34,34,0.0,M2019-12-15D,Race(8),,
4,0,0,0,0,0,0,0,0,1,0,0,1,1,0,0,1,41,41,0.0,M2019-12-15D,Race(8),,
3,0,0,0,0,0,0,0,0,0,0,0,0,0,0,0,0,26,26,2.0,M2019-12-15D,Race(8),,
6,0,0,2,2,0,0,0,0,1,0,2,3,1,0,4,5,11,11,0.0,M2019-12-15D,Race(9),,
8,0,2,2,4,0,1,1,2,0,2,0,2,0,5,3,8,26,26,0.0,M2019-12-15D,Race(9),,
9,7,18,2,27,4,17,6,27,4,6,7,17,15,41,15,71,3.8,3.8,1.0,M2019-12-15D,Race(9),,
12,0,0,0,0,0,0,0,0,0,0,0,0,0,0,0,0,81,81,0.0,M2019-12-15D,Race(9),,
11,0,0,0,0,0,0,0,0,0,0,0,0,0,0,0,0,61,61,0.0,M2019-12-15D,Race(9),,
1,0,3,19,22,5,5,16,26,7,5,6,18,12,13,41,66,3.1,3.1,0.0,M2019-12-15D,Race(9),,
2,0,2,0,2,0,0,2,2,1,2,2,5,1,4,4,9,16,16,0.0,M2019-12-15D,Race(9),,
3,0,0,0,0,0,0,0,0,0,0,3,3,0,0,3,3,26,26,0.0,M2019-12-15D,Race(9),,
4,3,3,0,6,0,1,2,3,2,3,3,8,5,7,5,17,9.5,9.5,2.0,M2019-12-15D,Race(9),,
5,20,2,5,27,21,6,3,30,11,8,3,22,52,16,11,79,3.6,3.6,3.0,M2019-12-15D,Race(9),,
7,0,0,0,0,0,0,0,0,0,0,0,0,0,0,0,0,26,26,0.0,M2019-12-15D,Race(9),,
10,0,0,0,0,0,0,0,0,0,0,0,0,0,0,0,0,81,81,0.0,M2019-12-15D,Race(9),,
5,0,0,3,3,0,9,0,9,1,4,0,5,1,13,3,17,19,19,3.0,M2019-12-18D,Race(1),,
3,0,2,0,2,0,0,0,0,1,0,0,1,1,2,0,3,51,51,0.0,M2019-12-18D,Race(1),,
2,2,11,4,17,9,1,2,12,2,0,0,2,13,12,6,31,6,6,0.0,M2019-12-18D,Race(1),,
1,6,5,7,18,8,7,4,19,8,3,5,16,22,15,16,53,4.6,4.6,0.0,M2019-12-18D,Race(1),,
4,15,7,3,25,2,0,6,8,3,2,3,8,20,9,12,41,3.1,3.1,1.0,M2019-12-18D,Race(1),,
11,0,0,0,0,0,0,0,0,0,0,0,0,0,0,0,0,126,126,0.0,M2019-12-18D,Race(1),,
12,0,0,0,0,0,0,0,0,0,0,0,0,0,0,0,0,19,19,0.0,M2019-12-18D,Race(1),,
8,0,0,3,3,5,8,9,22,4,9,5,18,9,17,17,43,10,10,0.0,M2019-12-18D,Race(1),,
10,2,0,3,5,0,1,1,2,0,2,3,5,2,3,7,12,13,13,0.0,M2019-12-18D,Race(1),,
9,2,0,0,2,1,1,0,2,2,1,0,3,5,2,0,7,19,19,2.0,M2019-12-18D,Race(1),,
7,3,5,2,10,4,3,4,11,5,4,5,14,12,12,11,35,9,9,0.0,M2019-12-18D,Race(1),,
6,0,0,5,5,1,0,4,5,0,1,5,6,1,1,14,16,10,10,0.0,M2019-12-18D,Race(1),,
5,0,0,0,0,0,0,0,0,0,0,0,0,0,0,0,0,81,81,0.0,M2019-12-18D,Race(2),,
12,0,0,0,0,0,0,0,0,0,0,0,0,0,0,0,0,61,61,0.0,M2019-12-18D,Race(2),,
11,0,6,3,9,1,0,0,1,0,1,2,3,1,7,5,13,17,17,0.0,M2019-12-18D,Race(2),,
10,14,7,7,28,9,8,3,20,9,10,6,25,32,25,16,73,3.3,3.3,3.0,M2019-12-18D,Race(2),,
1,8,6,8,22,19,5,5,29,15,7,2,24,42,18,15,75,5,5,1.0,M2019-12-18D,Race(2),,
2,0,0,2,2,0,0,0,0,0,0,0,0,0,0,2,2,26,26,0.0,M2019-12-18D,Race(2),,
9,0,2,5,7,0,4,10,14,1,1,2,4,1,7,17,25,5,5,2.0,M2019-12-18D,Race(2),,
8,0,3,0,3,1,0,0,1,0,1,1,2,1,4,1,6,10,10,0.0,M2019-12-18D,Race(2),,
6,0,0,0,0,0,0,0,0,0,0,0,0,0,0,0,0,81,81,0.0,M2019-12-18D,Race(2),,
4,8,6,5,19,0,13,11,24,1,6,10,17,9,25,26,60,3.3,3.3,0.0,M2019-12-18D,Race(2),,
7,0,0,0,0,0,0,0,0,0,0,0,0,0,0,0,0,61,61,0.0,M2019-12-18D,Race(2),,
3,0,0,0,0,0,0,1,1,0,0,3,3,0,0,4,4,51,51,0.0,M2019-12-18D,Race(2),,
6,5,5,9,19,4,5,4,13,4,2,2,8,13,12,15,40,5.5,5.5,2.0,M2019-12-18D,Race(3),,
12,0,0,0,0,0,0,0,0,0,0,0,0,0,0,0,0,151,151,0.0,M2019-12-18D,Race(3),,
11,0,0,0,0,0,0,0,0,0,0,1,1,0,0,1,1,31,31,1.0,M2019-12-18D,Race(3),,
10,0,0,0,0,0,0,0,0,0,0,0,0,0,0,0,0,71,71,0.0,M2019-12-18D,Race(3),,
9,2,0,3,5,0,4,9,13,3,5,4,12,5,9,16,30,6.5,6.5,0.0,M2019-12-18D,Race(3),,
5,0,0,0,0,0,0,1,1,0,1,1,2,0,1,2,3,31,31,0.0,M2019-12-18D,Race(3),,
2,9,2,3,14,5,0,2,7,3,3,0,6,17,5,5,27,4.2,4.2,3.0,M2019-12-18D,Race(3),,
8,2,0,2,4,0,0,2,2,0,0,4,4,2,0,8,10,13,13,0.0,M2019-12-18D,Race(3),,
1,9,13,4,26,3,10,2,15,2,5,3,10,14,28,9,51,4.8,4.8,0.0,M2019-12-18D,Race(3),,
3,3,2,3,8,9,4,5,18,7,3,6,16,19,9,14,42,6.5,6.5,0.0,M2019-12-18D,Race(3),,
4,0,3,6,9,7,5,4,16,5,5,5,15,12,13,15,40,11,11,0.0,M2019-12-18D,Race(3),,
7,0,5,0,5,2,1,1,4,2,2,0,4,4,8,1,13,11,11,0.0,M2019-12-18D,Race(3),,
4,10,7,11,28,11,5,6,22,15,3,6,24,36,15,23,74,3.2,3.2,0.0,M2019-12-18D,Race(4),,
1,0,0,0,0,1,8,1,10,3,1,1,5,4,9,2,15,19,19,2.0,M2019-12-18D,Race(4),,
2,8,3,6,17,10,4,5,19,3,5,3,11,21,12,14,47,5,5,0.0,M2019-12-18D,Race(4),,
3,6,13,3,22,6,6,8,20,3,7,11,21,15,26,22,63,4,4,0.0,M2019-12-18D,Race(4),,
5,0,0,0,0,0,0,0,0,0,0,1,1,0,0,1,1,151,151,0.0,M2019-12-18D,Race(4),,
12,0,2,0,2,0,0,0,0,0,0,0,0,0,2,0,2,9,9,3.0,M2019-12-18D,Race(4),,
7,0,0,0,0,0,0,0,0,0,0,0,0,0,0,0,0,71,67,0.0,M2019-12-18D,Race(4),,
8,0,0,0,0,0,0,0,0,0,0,0,0,0,0,0,0,41,41,0.0,M2019-12-18D,Race(4),,
9,0,0,5,5,0,1,0,1,0,0,0,0,0,1,5,6,14,14,1.0,M2019-12-18D,Race(4),,
10,0,0,0,0,0,0,0,0,0,0,0,0,0,0,0,0,61,61,0.0,M2019-12-18D,Race(4),,
11,6,5,5,16,2,6,10,18,2,9,3,14,10,20,18,48,5.5,5.5,0.0,M2019-12-18D,Race(4),,
6,0,0,0,0,0,0,0,0,0,1,1,2,0,1,1,2,26,26,0.0,M2019-12-18D,Race(4),,
1,8,9,2,19,1,7,3,11,2,7,2,11,11,23,7,41,2.7,2.7,0.0,M2019-12-18D,Race(5),,
2,4,3,2,9,0,9,7,16,1,0,9,10,5,12,18,35,19,19,3.0,M2019-12-18D,Race(5),,
3,3,0,3,6,0,5,2,7,1,5,3,9,4,10,8,22,15,15,0.0,M2019-12-18D,Race(5),,
4,0,2,2,4,0,0,0,0,0,0,1,1,0,2,3,5,21,21,0.0,M2019-12-18D,Race(5),,
5,5,10,10,25,19,2,2,23,20,4,0,24,44,16,12,72,3.2,3.2,1.0,M2019-12-18D,Race(5),,
7,0,0,0,0,0,0,0,0,0,0,0,0,0,0,0,0,101,101,0.0,M2019-12-18D,Race(5),,
6,5,3,5,13,1,1,1,3,0,2,2,4,6,6,8,20,8,8,0.0,M2019-12-18D,Race(5),,
8,0,0,3,3,0,0,0,0,0,0,0,0,0,0,3,3,41,41,0.0,M2019-12-18D,Race(5),,
9,0,0,0,0,0,1,10,11,1,3,5,9,1,4,15,20,16,16,0.0,M2019-12-18D,Race(5),,
11,0,0,0,0,0,0,0,0,0,0,0,0,0,0,0,0,19,19,0.0,M2019-12-18D,Race(5),,
12,0,0,0,0,0,0,0,0,0,0,0,0,0,0,0,0,81,81,0.0,M2019-12-18D,Race(5),,
10,5,3,3,11,9,5,5,19,1,5,4,10,15,13,12,40,7,7,2.0,M2019-12-18D,Race(5),,
1,2,6,3,11,0,10,7,17,2,5,5,12,4,21,15,40,10,10,2.0,M2019-12-18D,Race(6),,
2,0,0,0,0,0,0,0,0,0,0,0,0,0,0,0,0,101,101,0.0,M2019-12-18D,Race(6),,
3,21,7,2,30,16,4,3,23,15,5,5,25,52,16,10,78,2.2,2.2,0.0,M2019-12-18D,Race(6),,
4,0,5,3,8,0,0,2,2,1,4,3,8,1,9,8,18,19,19,0.0,M2019-12-18D,Race(6),,
5,2,0,4,6,0,3,10,13,1,1,4,6,3,4,18,25,13,13,0.0,M2019-12-18D,Race(6),,
6,5,5,10,20,13,12,3,28,5,8,3,16,23,25,16,64,3.8,3.8,0.0,M2019-12-18D,Race(6),,
7,0,7,8,15,0,1,4,5,0,1,3,4,0,9,15,24,8.5,8.5,3.0,M2019-12-18D,Race(6),,
8,0,0,0,0,0,0,0,0,0,0,0,0,0,0,0,0,19,19,0.0,M2019-12-18D,Race(6),,
9,0,0,0,0,0,0,0,0,0,0,1,1,0,0,1,1,81,81,0.0,M2019-12-18D,Race(6),,
11,0,0,0,0,0,0,0,0,0,0,0,0,0,0,0,0,81,71,0.0,M2019-12-18D,Race(6),,
12,0,0,0,0,0,0,0,0,0,0,0,0,0,0,0,0,21,21,0.0,M2019-12-18D,Race(6),,
10,0,0,0,0,1,0,1,2,2,2,2,6,3,2,3,8,13,13,1.0,M2019-12-18D,Race(6),,
1,0,0,0,0,0,0,0,0,0,0,0,0,0,0,0,0,101,101,0.0,M2019-12-18D,Race(7),,
2,0,4,3,7,13,2,6,21,8,5,6,19,21,11,15,47,15,15,0.0,M2019-12-18D,Race(7),,
3,3,3,0,6,0,2,2,4,0,2,1,3,3,7,3,13,10,10,0.0,M2019-12-18D,Race(7),,
4,7,2,5,14,8,4,3,15,6,3,2,11,21,9,10,40,3.6,3.6,2.0,M2019-12-18D,Race(7),,
5,0,0,0,0,0,0,0,0,0,0,0,0,0,0,0,0,51,51,0.0,M2019-12-18D,Race(7),,
6,0,0,0,0,0,0,0,0,0,0,0,0,0,0,0,0,41,41,0.0,M2019-12-18D,Race(7),,
7,11,2,8,21,5,10,7,22,9,2,9,20,25,14,24,63,4.6,4.6,0.0,M2019-12-18D,Race(7),,
8,2,2,3,7,0,1,0,1,0,0,0,0,2,3,3,8,8.5,8.5,0.0,M2019-12-18D,Race(7),,
9,5,5,3,13,0,5,10,15,1,2,4,7,6,12,17,35,7,7,0.0,M2019-12-18D,Race(7),,
11,2,3,0,5,0,0,0,0,0,0,0,0,2,3,0,5,34,34,0.0,M2019-12-18D,Race(7),,
10,0,9,6,15,4,6,2,12,2,12,4,18,6,27,12,45,4,4,1.0,M2019-12-18D,Race(7),,
12,0,0,2,2,0,0,0,0,0,0,0,0,0,0,2,2,41,41,3.0,M2019-12-18D,Race(7),,
1,5,10,5,20,10,7,4,21,2,7,5,14,17,24,14,55,6.5,6.5,0.0,M2019-12-18D,Race(8),,
2,0,0,5,5,0,0,0,0,0,1,1,2,0,1,6,7,18,18,0.0,M2019-12-18D,Race(8),,
3,0,2,3,5,1,1,8,10,2,0,7,9,3,3,18,24,14,14,0.0,M2019-12-18D,Race(8),,
4,0,0,0,0,0,2,1,3,1,2,2,5,1,4,3,8,13,13,0.0,M2019-12-18D,Race(8),,
5,0,2,5,7,1,9,3,13,2,4,6,12,3,15,14,32,12,12,3.0,M2019-12-18D,Race(8),,
6,25,3,2,30,17,3,9,29,17,6,2,25,59,12,13,84,1.6,1.6,1.0,M2019-12-18D,Race(8),,
7,0,13,10,23,1,8,5,14,2,6,3,11,3,27,18,48,9,9,0.0,M2019-12-18D,Race(8),,
8,0,0,0,0,0,0,0,0,0,0,0,0,0,0,0,0,31,31,0.0,M2019-12-18D,Race(8),,
9,0,0,0,0,0,0,0,0,0,0,0,0,0,0,0,0,71,67,0.0,M2019-12-18D,Race(8),,
10,0,0,0,0,0,0,0,0,0,0,0,0,0,0,0,0,34,34,0.0,M2019-12-18D,Race(8),,
11,0,0,0,0,0,0,0,0,0,0,0,0,0,0,0,0,51,51,0.0,M2019-12-18D,Race(8),,
12,0,0,0,0,0,0,0,0,0,0,0,0,0,0,0,0,151,151,2.0,M2019-12-18D,Race(8),,
1,0,3,0,3,0,1,1,2,0,0,0,0,0,4,1,5,41,41,0.0,M2019-12-18D,Race(9),,
2,3,3,3,9,10,4,1,15,4,2,2,8,17,9,6,32,12,12,0.0,M2019-12-18D,Race(9),,
4,16,7,2,25,8,5,4,17,4,5,3,12,28,17,9,54,2.9,2.9,1.0,M2019-12-18D,Race(9),,
5,0,0,0,0,0,0,0,0,0,0,0,0,0,0,0,0,81,81,0.0,M2019-12-18D,Race(9),,
6,2,0,3,5,4,10,4,18,5,4,5,14,11,14,12,37,13,13,0.0,M2019-12-18D,Race(9),,
7,2,0,4,6,1,1,0,2,0,2,0,2,3,3,4,10,21,21,0.0,M2019-12-18D,Race(9),,
8,0,0,0,0,1,0,0,1,3,0,0,3,4,0,0,4,51,51,0.0,M2019-12-18D,Race(9),,
9,2,0,5,7,4,2,10,16,3,5,4,12,9,7,19,35,5.5,5.5,0.0,M2019-12-18D,Race(9),,
10,0,0,0,0,0,0,0,0,0,0,1,1,0,0,1,1,41,41,0.0,M2019-12-18D,Race(9),,
11,0,14,0,14,0,4,3,7,2,2,3,7,2,20,6,28,6.5,7.5,3.0,M2019-12-18D,Race(9),,
3,0,0,6,6,1,2,3,6,3,4,2,9,4,6,11,21,15,15,2.0,M2019-12-18D,Race(9),,
12,5,3,7,15,2,1,4,7,2,2,6,10,9,6,17,32,3.8,3.8,0.0,M2019-12-18D,Race(9),,
1,17,5,0,22,19,8,1,28,14,4,0,18,50,17,1,68,2.8,2.8,0.0,M2019-12-21D,Race(1),,
3,8,11,7,26,5,13,7,25,8,6,5,19,21,30,19,70,3.1,3.1,3.0,M2019-12-21D,Race(1),,
7,0,0,7,7,0,2,3,5,0,3,4,7,0,5,14,19,11,11,2.0,M2019-12-21D,Race(1),,
4,0,0,0,0,0,0,0,0,0,0,2,2,0,0,2,2,81,81,0.0,M2019-12-21D,Race(1),,
5,2,10,8,20,3,1,5,9,0,7,5,12,5,18,18,41,5,5,1.0,M2019-12-21D,Race(1),,
6,0,0,0,0,0,0,0,0,0,0,0,0,0,0,0,0,34,34,0.0,M2019-12-21D,Race(1),,
9,0,2,0,2,0,2,0,2,0,2,0,2,0,6,0,6,18,18,0.0,M2019-12-21D,Race(1),,
8,3,2,8,13,3,4,14,21,3,4,10,17,9,10,32,51,5,5,0.0,M2019-12-21D,Race(1),,
2,0,0,0,0,0,0,0,0,0,0,0,0,0,0,0,0,81,81,0.0,M2019-12-21D,Race(1),,
13,0,0,0,0,0,0,0,0,0,0,0,0,0,0,0,0,51,51,0.0,M2019-12-21D,Race(10),,
12,0,0,7,7,0,0,0,0,0,0,2,2,0,0,9,9,16,16,0.0,M2019-12-21D,Race(10),,
14,0,0,2,2,1,1,2,4,2,3,3,8,3,4,7,14,15,15,3.0,M2019-12-21D,Race(10),,
9,0,0,0,0,0,0,0,0,0,0,0,0,0,0,0,0,26,26,0.0,M2019-12-21D,Race(10),,
8,22,6,0,28,15,8,2,25,11,6,1,18,48,20,3,71,4,4,1.0,M2019-12-21D,Race(10),,
7,2,3,3,8,5,3,12,20,3,7,2,12,10,13,17,40,11,11,0.0,M2019-12-21D,Race(10),,
6,2,0,0,2,0,0,1,1,0,0,1,1,2,0,2,4,26,26,0.0,M2019-12-21D,Race(10),,
5,2,0,3,5,2,1,5,8,0,1,8,9,4,2,16,22,7.5,7.5,0.0,M2019-12-21D,Race(10),,
3,0,2,5,7,0,1,2,3,1,4,3,8,1,7,10,18,12,12,0.0,M2019-12-21D,Race(10),,
2,0,9,4,13,5,13,5,23,6,4,4,14,11,26,13,50,7.5,7.5,0.0,M2019-12-21D,Race(10),,
1,0,0,0,0,0,0,0,0,0,0,0,0,0,0,0,0,71,71,0.0,M2019-12-21D,Race(10),,
4,2,8,6,16,2,0,0,2,1,1,2,4,5,9,8,22,6,6,0.0,M2019-12-21D,Race(10),,
10,0,0,0,0,0,0,0,0,0,0,0,0,0,0,0,0,61,61,0.0,M2019-12-21D,Race(10),,
11,0,2,0,2,0,3,1,4,2,0,0,2,2,5,1,8,6,6,2.0,M2019-12-21D,Race(10),,
11,2,2,3,7,1,2,5,8,2,1,4,7,5,5,12,22,8,8,2.0,M2019-12-21D,Race(2),,
5,2,0,0,2,1,1,1,3,2,1,3,6,5,2,4,11,11,11,0.0,M2019-12-21D,Race(2),,
6,5,8,10,23,3,3,14,20,3,3,8,14,11,14,32,57,3.5,3.5,1.0,M2019-12-21D,Race(2),,
7,0,0,0,0,0,1,1,2,0,1,1,2,0,2,2,4,31,31,0.0,M2019-12-21D,Race(2),,
8,0,0,0,0,3,0,0,3,2,1,0,3,5,1,0,6,21,21,0.0,M2019-12-21D,Race(2),,
9,0,3,0,3,0,0,0,0,2,1,0,3,2,4,0,6,21,21,3.0,M2019-12-21D,Race(2),,
4,0,0,0,0,0,0,0,0,0,1,0,1,0,1,0,1,41,41,0.0,M2019-12-21D,Race(2),,
3,0,0,0,0,0,0,0,0,0,0,0,0,0,0,0,0,126,126,0.0,M2019-12-21D,Race(2),,
14,2,0,0,2,0,0,0,0,0,0,0,0,2,0,0,2,13,13,0.0,M2019-12-21D,Race(2),,
1,0,2,0,2,0,0,1,1,0,0,2,2,0,2,3,5,51,51,0.0,M2019-12-21D,Race(2),,
10,0,3,5,8,1,1,2,4,0,2,3,5,1,6,10,17,10,10,0.0,M2019-12-21D,Race(2),,
12,16,2,4,22,14,9,2,25,7,10,2,19,37,21,8,66,3.7,3.7,0.0,M2019-12-21D,Race(2),,
2,3,10,8,21,7,13,4,24,8,5,3,16,18,28,15,61,7.5,7.5,0.0,M2019-12-21D,Race(2),,
13,0,0,0,0,0,0,0,0,0,0,0,0,0,0,0,0,61,61,0.0,M2019-12-21D,Race(2),,
14,0,3,2,5,0,0,0,0,0,0,0,0,0,3,2,5,10,10,0.0,M2019-12-21D,Race(3),,
13,0,0,0,0,0,0,2,2,0,0,3,3,0,0,5,5,31,31,2.0,M2019-12-21D,Race(3),,
11,2,3,8,13,7,6,13,26,6,9,1,16,15,18,22,55,9.5,9.5,3.0,M2019-12-21D,Race(3),,
10,0,0,0,0,0,0,0,0,0,0,0,0,0,0,0,0,101,101,0.0,M2019-12-21D,Race(3),,
9,0,0,0,0,0,0,0,0,0,0,0,0,0,0,0,0,101,101,0.0,M2019-12-21D,Race(3),,
12,9,6,5,20,2,14,4,20,1,13,4,18,12,33,13,58,3.3,3.3,1.0,M2019-12-21D,Race(3),,
7,0,0,0,0,0,0,1,1,0,1,0,1,0,1,1,2,51,51,0.0,M2019-12-21D,Race(3),,
5,17,6,7,30,17,7,3,27,14,2,6,22,48,15,16,79,3.8,3.8,0.0,M2019-12-21D,Race(3),,
4,0,0,0,0,0,0,1,1,0,0,1,1,0,0,2,2,18,18,0.0,M2019-12-21D,Race(3),,
3,0,0,6,6,1,0,0,1,1,0,0,1,2,0,6,8,31,31,0.0,M2019-12-21D,Race(3),,
2,0,0,0,0,0,0,0,0,0,0,0,0,0,0,0,0,71,67,0.0,M2019-12-21D,Race(3),,
8,0,2,0,2,1,0,1,2,0,0,3,3,1,2,4,7,7.5,7.5,0.0,M2019-12-21D,Race(3),,
1,2,6,2,10,2,2,5,9,4,1,7,12,8,9,14,31,6,6,0.0,M2019-12-21D,Race(3),,
6,0,4,0,4,0,1,0,1,0,0,1,1,0,5,1,6,31,31,0.0,M2019-12-21D,Race(3),,
9,4,6,5,15,2,1,4,7,1,1,4,6,7,8,13,28,4.6,4.6,1.0,M2019-12-21D,Race(4),,
14,0,0,0,0,0,0,0,0,0,0,0,0,0,0,0,0,51,51,0.0,M2019-12-21D,Race(4),,
5,0,0,0,0,1,0,4,5,3,3,6,12,4,3,10,17,17,17,0.0,M2019-12-21D,Race(4),,
13,0,0,0,0,0,0,0,0,0,0,0,0,0,0,0,0,61,61,0.0,M2019-12-21D,Race(4),,
12,0,0,6,6,1,0,0,1,0,0,0,0,1,0,6,7,17,17,0.0,M2019-12-21D,Race(4),,
10,0,0,0,0,0,0,0,0,0,0,0,0,0,0,0,0,101,101,0.0,M2019-12-21D,Race(4),,
8,14,5,4,23,18,7,2,27,11,3,6,20,43,15,12,70,2.6,2.6,2.0,M2019-12-21D,Race(4),,
11,0,0,5,5,0,0,0,0,0,0,1,1,0,0,6,6,51,51,0.0,M2019-12-21D,Race(4),,
3,0,0,3,3,0,0,0,0,0,1,0,1,0,1,3,4,31,31,0.0,M2019-12-21D,Race(4),,
2,0,7,0,7,3,3,14,20,5,3,6,14,8,13,20,41,9.5,9.5,0.0,M2019-12-21D,Race(4),,
4,0,0,0,0,0,0,0,0,0,0,0,0,0,0,0,0,71,67,0.0,M2019-12-21D,Race(4),,
1,12,7,5,24,5,15,4,24,6,8,3,17,23,30,12,65,4.6,4.6,0.0,M2019-12-21D,Race(4),,
6,0,0,0,0,0,0,0,0,0,1,0,1,0,1,0,1,19,19,3.0,M2019-12-21D,Race(4),,
7,0,5,2,7,0,4,2,6,0,6,0,6,0,15,4,19,14,14,0.0,M2019-12-21D,Race(4),,
1,10,13,4,27,25,4,1,30,18,6,2,26,53,23,7,83,3.3,3.3,2.0,M2019-12-21D,Race(5),,
10,0,0,0,0,0,0,0,0,0,0,0,0,0,0,0,0,101,101,0.0,M2019-12-21D,Race(5),,
9,0,0,0,0,0,0,0,0,0,0,0,0,0,0,0,0,126,126,0.0,M2019-12-21D,Race(5),,
8,3,0,0,3,0,2,0,2,0,1,2,3,3,3,2,8,9,9,0.0,M2019-12-21D,Race(5),,
7,0,0,3,3,0,0,2,2,0,0,5,5,0,0,10,10,31,31,1.0,M2019-12-21D,Race(5),,
6,0,0,0,0,0,0,0,0,0,0,0,0,0,0,0,0,41,41,0.0,M2019-12-21D,Race(5),,
5,0,0,0,0,0,0,0,0,0,0,0,0,0,0,0,0,51,51,0.0,M2019-12-21D,Race(5),,
3,0,5,10,15,0,2,3,5,0,2,3,5,0,9,16,25,9.5,9.5,0.0,M2019-12-21D,Race(5),,
13,0,0,0,0,0,0,0,0,0,0,0,0,0,0,0,0,31,31,0.0,M2019-12-21D,Race(5),,
12,0,2,3,5,0,0,0,0,0,2,0,2,0,4,3,7,10,10,0.0,M2019-12-21D,Race(5),,
2,5,0,7,12,4,5,17,26,5,3,11,19,14,8,35,57,3.6,3.6,0.0,M2019-12-21D,Race(5),,
4,12,10,3,25,1,17,7,25,3,12,3,18,16,39,13,68,4.6,4.6,0.0,M2019-12-21D,Race(5),,
11,0,0,0,0,0,0,0,0,0,0,0,0,0,0,0,0,51,51,0.0,M2019-12-21D,Race(5),,
14,0,0,0,0,0,0,0,0,0,0,0,0,0,0,0,0,51,51,3.0,M2019-12-21D,Race(5),,
6,0,2,3,5,3,8,15,26,3,12,6,21,6,22,24,52,10,10,0.0,M2019-12-21D,Race(6),,
10,3,2,0,5,0,0,1,1,0,0,1,1,3,2,2,7,9,9,0.0,M2019-12-21D,Race(6),,
7,0,0,0,0,0,0,0,0,0,1,0,1,0,1,0,1,41,41,0.0,M2019-12-21D,Race(6),,
8,0,0,0,0,0,0,0,0,0,0,0,0,0,0,0,0,81,81,0.0,M2019-12-21D,Race(6),,
9,3,3,3,9,0,0,1,1,0,0,3,3,3,3,7,13,16,16,0.0,M2019-12-21D,Race(6),,
11,7,5,8,20,19,5,4,28,13,4,5,22,39,14,17,70,2.7,2.7,0.0,M2019-12-21D,Race(6),,
12,0,0,0,0,0,0,0,0,0,0,0,0,0,0,0,0,81,81,0.0,M2019-12-21D,Race(6),,
13,0,0,2,2,0,0,1,1,0,0,1,1,0,0,4,4,34,34,0.0,M2019-12-21D,Race(6),,
14,0,5,2,7,0,0,1,1,0,1,1,2,0,6,4,10,13,13,0.0,M2019-12-21D,Race(6),,
1,15,8,7,30,8,15,4,27,8,6,6,20,31,29,17,77,4,4,3.0,M2019-12-21D,Race(6),,
5,0,0,0,0,0,0,0,0,0,0,0,0,0,0,0,0,51,51,1.0,M2019-12-21D,Race(6),,
4,0,2,3,5,0,1,2,3,1,1,1,3,1,4,6,11,19,19,0.0,M2019-12-21D,Race(6),,
2,0,0,0,0,0,0,0,0,0,0,0,0,0,0,0,0,41,41,0.0,M2019-12-21D,Race(6),,
3,2,3,2,7,0,1,1,2,1,1,2,4,3,5,5,13,7.5,7.5,2.0,M2019-12-21D,Race(6),,
6,0,0,0,0,0,0,0,0,0,0,0,0,0,0,0,0,41,34,0.0,M2019-12-21D,Race(7),,
10,0,0,0,0,0,0,1,1,0,1,2,3,0,1,3,4,41,41,0.0,M2019-12-21D,Race(7),,
1,0,21,7,28,20,6,3,29,14,10,1,25,34,37,11,82,3.4,3.3,2.0,M2019-12-21D,Race(7),,
9,5,0,5,10,1,3,15,19,0,0,6,6,6,3,26,35,8.5,8,0.0,M2019-12-21D,Race(7),,
2,0,0,5,5,0,1,3,4,0,2,4,6,0,3,12,15,34,31,0.0,M2019-12-21D,Race(7),,
3,25,3,2,30,9,19,2,30,12,11,3,26,46,33,7,86,1.95,2,1.0,M2019-12-21D,Race(7),,
4,0,0,0,0,0,0,0,0,0,0,0,0,0,0,0,0,81,81,0.0,M2019-12-21D,Race(7),,
5,0,0,0,0,0,0,0,0,0,0,0,0,0,0,0,0,151,126,0.0,M2019-12-21D,Race(7),,
8,0,0,0,0,0,0,0,0,0,0,1,1,0,0,1,1,34,26,0.0,M2019-12-21D,Race(7),,
11,0,0,0,0,0,0,0,0,0,0,0,0,0,0,0,0,51,41,0.0,M2019-12-21D,Race(7),,
7,0,0,0,0,0,0,2,2,0,0,3,3,0,0,5,5,81,71,0.0,M2019-12-21D,Race(7),,
12,0,0,5,5,0,0,1,1,0,0,2,2,0,0,8,8,20,17,3.0,M2019-12-21D,Race(7),,
13,0,0,0,0,0,0,0,0,0,0,0,0,0,0,0,0,151,126,0.0,M2019-12-21D,Race(7),,
14,0,6,6,12,0,1,3,4,0,2,4,6,0,9,13,22,10,10,0.0,M2019-12-21D,Race(7),,
5,0,0,0,0,0,0,0,0,0,0,0,0,0,0,0,0,41,41,0.0,M2019-12-21D,Race(8),,
8,0,0,0,0,0,0,0,0,0,0,0,0,0,0,0,0,101,101,0.0,M2019-12-21D,Race(8),,
6,2,3,9,14,1,1,17,19,0,3,12,15,3,7,38,48,4.8,4.8,0.0,M2019-12-21D,Race(8),,
4,5,16,7,28,6,23,0,29,13,10,1,24,24,49,8,81,4.4,4.4,1.0,M2019-12-21D,Race(8),,
1,0,0,0,0,0,0,0,0,1,0,0,1,1,0,0,1,101,101,0.0,M2019-12-21D,Race(8),,
2,0,0,0,0,0,0,0,0,0,0,0,0,0,0,0,0,61,61,0.0,M2019-12-21D,Race(8),,
9,0,2,8,10,0,0,6,6,0,0,3,3,0,2,17,19,16,16,0.0,M2019-12-21D,Race(8),,
7,0,2,2,4,1,2,3,6,0,4,5,9,1,8,10,19,19,19,2.0,M2019-12-21D,Race(8),,
11,0,0,0,0,0,0,0,0,0,0,0,0,0,0,0,0,151,201,0.0,M2019-12-21D,Race(8),,
12,0,0,0,0,0,0,0,0,0,0,0,0,0,0,0,0,51,51,3.0,M2019-12-21D,Race(8),,
13,2,0,2,4,0,0,1,1,0,0,3,3,2,0,6,8,31,31,0.0,M2019-12-21D,Race(8),,
14,0,0,0,0,0,0,0,0,0,0,0,0,0,0,0,0,51,51,0.0,M2019-12-21D,Race(8),,
3,0,0,0,0,0,0,0,0,0,0,0,0,0,0,0,0,81,81,0.0,M2019-12-21D,Race(8),,
10,21,7,2,30,22,4,3,29,12,9,2,23,55,20,7,82,1.7,1.7,0.0,M2019-12-21D,Race(8),,
1,0,0,2,2,0,2,0,2,0,2,0,2,0,4,2,6,41,31,0.0,M2019-12-21D,Race(9),,
2,0,0,0,0,0,0,1,1,2,0,0,2,2,0,1,3,18,17,0.0,M2019-12-21D,Race(9),,
3,0,4,2,6,1,1,1,3,2,3,0,5,3,8,3,14,9,8.5,0.0,M2019-12-21D,Race(9),,
5,12,0,2,14,5,13,5,23,2,7,2,11,19,20,9,48,7,6.5,3.0,M2019-12-21D,Race(9),,
7,0,0,0,0,0,0,0,0,0,0,0,0,0,0,0,0,81,81,0.0,M2019-12-21D,Race(9),,
6,0,0,0,0,2,2,1,5,3,2,2,7,5,4,3,12,14,13,0.0,M2019-12-21D,Race(9),,
13,0,2,5,7,1,1,0,2,1,0,1,2,2,3,6,11,9,11,0.0,M2019-12-21D,Race(9),,
12,0,0,0,0,0,0,0,0,0,0,1,1,0,0,1,1,23,34,0.0,M2019-12-21D,Race(9),,
10,2,11,3,16,1,0,3,4,0,1,5,6,3,12,11,26,8.5,8,1.0,M2019-12-21D,Race(9),,
9,0,3,7,10,1,3,12,16,0,3,5,8,1,9,24,34,9.5,9,0.0,M2019-12-21D,Race(9),,
8,0,0,0,0,0,0,1,1,0,1,2,3,0,1,3,4,23,21,0.0,M2019-12-21D,Race(9),,
4,0,3,6,9,1,3,1,5,1,2,5,8,2,8,12,22,23,26,0.0,M2019-12-21D,Race(9),,
11,16,7,3,26,18,5,5,28,15,5,3,23,49,17,11,77,2.65,2.6,2.0,M2019-12-21D,Race(9),,
3,0,0,5,5,0,1,4,5,0,1,6,7,0,2,15,17,16,16,0.0,M2019-12-26D,Race(1),,
1,22,6,2,30,15,6,1,22,17,7,2,26,54,19,5,78,1.8,1.8,0.0,M2019-12-26D,Race(1),,
5,0,0,5,5,1,1,7,9,1,1,9,11,2,2,21,25,18,18,0.0,M2019-12-26D,Race(1),,
6,0,6,2,8,1,10,4,15,2,3,3,8,3,19,9,31,8,8,0.0,M2019-12-26D,Race(1),,
7,0,0,0,0,0,0,0,0,0,0,0,0,0,0,0,0,101,101,0.0,M2019-12-26D,Race(1),,
8,0,0,0,0,0,0,0,0,0,0,0,0,0,0,0,0,101,101,0.0,M2019-12-26D,Race(1),,
9,0,0,0,0,0,0,0,0,0,0,0,0,0,0,0,0,61,61,0.0,M2019-12-26D,Race(1),,
10,0,0,3,3,0,0,1,1,0,0,0,0,0,0,4,4,21,21,2.0,M2019-12-26D,Race(1),,
11,0,2,0,2,0,0,0,0,1,0,0,1,1,2,0,3,34,34,1.0,M2019-12-26D,Race(1),,
2,4,16,8,28,11,11,4,26,3,12,4,19,18,39,16,73,6,6,0.0,M2019-12-26D,Race(1),,
12,4,0,2,6,1,0,0,1,1,0,0,1,6,0,2,8,8,8,3.0,M2019-12-26D,Race(1),,
4,0,0,3,3,1,1,9,11,1,2,2,5,2,3,14,19,13,13,0.0,M2019-12-26D,Race(1),,
3,5,9,9,23,2,11,10,23,4,9,6,19,11,29,25,65,5.5,5.5,2.0,M2019-12-26D,Race(2),,
4,23,5,2,30,20,10,0,30,20,5,0,25,63,20,2,85,2.05,2.1,3.0,M2019-12-26D,Race(2),,
5,0,0,0,0,0,2,4,6,0,0,4,4,0,2,8,10,13,13,0.0,M2019-12-26D,Race(2),,
6,2,8,5,15,8,3,5,16,2,5,4,11,12,16,14,42,5,5,1.0,M2019-12-26D,Race(2),,
7,0,2,0,2,0,2,5,7,0,5,3,8,0,9,8,17,15,15,0.0,M2019-12-26D,Race(2),,
8,0,0,4,4,0,0,1,1,0,0,2,2,0,0,7,7,26,26,0.0,M2019-12-26D,Race(2),,
2,0,0,0,0,0,0,1,1,0,0,0,0,0,0,1,1,61,61,0.0,M2019-12-26D,Race(2),,
9,0,3,5,8,0,1,0,1,0,2,0,2,0,6,5,11,8,8,0.0,M2019-12-26D,Race(2),,
10,0,3,5,8,0,0,4,4,0,0,6,6,0,3,15,18,14,14,0.0,M2019-12-26D,Race(2),,
1,0,0,0,0,0,1,0,1,0,0,1,1,0,1,1,2,41,41,0.0,M2019-12-26D,Race(2),,
1,0,14,3,17,5,10,4,19,6,7,5,18,11,31,12,54,6,6.5,0.0,M2019-12-26D,Race(3),,
2,0,0,0,0,11,1,3,15,2,1,2,5,13,2,5,20,19,20,0.0,M2019-12-26D,Race(3),,
5,2,0,7,9,0,4,4,8,1,6,6,13,3,10,17,30,16,16,0.0,M2019-12-26D,Race(3),,
12,0,3,0,3,0,0,0,0,0,0,0,0,0,3,0,3,11,11,0.0,M2019-12-26D,Race(3),,
11,0,0,0,0,0,0,0,0,0,0,0,0,0,0,0,0,31,31,0.0,M2019-12-26D,Race(3),,
4,0,0,0,0,1,0,1,2,0,2,3,5,1,2,4,7,18,18,0.0,M2019-12-26D,Race(3),,
9,0,0,0,0,0,0,0,0,0,0,0,0,0,0,0,0,126,126,0.0,M2019-12-26D,Race(3),,
10,0,0,3,3,0,0,0,0,0,0,0,0,0,0,3,3,71,71,0.0,M2019-12-26D,Race(3),,
3,23,5,2,30,13,5,2,20,17,6,1,24,53,16,5,74,2,1.9,2.0,M2019-12-26D,Race(3),,
7,2,6,10,18,0,2,10,12,0,2,5,7,2,10,25,37,6,6,1.0,M2019-12-26D,Race(3),,
8,0,0,0,0,0,0,1,1,0,0,0,0,0,0,1,1,17,17,0.0,M2019-12-26D,Race(3),,
6,3,2,5,10,0,8,5,13,0,1,4,5,3,11,14,28,14,15,3.0,M2019-12-26D,Race(3),,
9,0,0,0,0,0,1,0,1,0,1,0,1,0,2,0,2,16,16,0.0,M2019-12-26D,Race(4),,
11,10,4,6,20,3,3,1,7,4,0,5,9,17,7,12,36,4.8,4.5,0.0,M2019-12-26D,Race(4),,
12,0,0,0,0,0,0,0,0,0,0,0,0,0,0,0,0,81,81,0.0,M2019-12-26D,Race(4),,
2,11,3,9,23,3,9,4,16,2,8,2,12,16,20,15,51,4.2,4.2,2.0,M2019-12-26D,Race(4),,
1,0,0,0,0,0,1,0,1,0,0,0,0,0,1,0,1,51,51,0.0,M2019-12-26D,Race(4),,
4,0,11,6,17,0,5,4,9,0,6,4,10,0,22,14,36,9,9,0.0,M2019-12-26D,Race(4),,
5,7,4,2,13,10,5,3,18,2,5,3,10,19,14,8,41,6.5,6.5,3.0,M2019-12-26D,Race(4),,
6,2,6,0,8,2,1,4,7,3,1,7,11,7,8,11,26,5.5,5.5,0.0,M2019-12-26D,Race(4),,
7,0,0,5,5,11,4,4,19,13,3,2,18,24,7,11,42,6,6,0.0,M2019-12-26D,Race(4),,
10,0,2,2,4,1,1,10,12,2,1,3,6,3,4,15,22,15,15,1.0,M2019-12-26D,Race(4),,
8,0,0,0,0,0,0,0,0,0,0,0,0,0,0,0,0,31,31,0.0,M2019-12-26D,Race(4),,
3,0,0,0,0,0,0,0,0,0,1,0,1,0,1,0,1,101,101,0.0,M2019-12-26D,Race(4),,
11,0,2,0,2,0,0,0,0,0,0,2,2,0,2,2,4,16,16,0.0,M2019-12-26D,Race(5),,
4,0,0,2,2,0,1,0,1,0,0,0,0,0,1,2,3,8,8,0.0,M2019-12-26D,Race(5),,
2,4,15,6,25,9,13,1,23,10,14,0,24,23,42,7,72,4.6,4.6,1.0,M2019-12-26D,Race(5),,
5,3,0,0,3,0,0,0,0,0,2,0,2,3,2,0,5,9,9,2.0,M2019-12-26D,Race(5),,
6,0,0,0,0,0,0,0,0,0,1,1,2,0,1,1,2,126,126,0.0,M2019-12-26D,Race(5),,
7,2,0,0,2,1,0,0,1,2,0,0,2,5,0,0,5,101,101,0.0,M2019-12-26D,Race(5),,
3,0,3,0,3,1,1,10,12,0,0,1,1,1,4,11,16,15,15,0.0,M2019-12-26D,Race(5),,
8,0,0,0,0,0,0,0,0,0,0,0,0,0,0,0,0,31,31,0.0,M2019-12-26D,Race(5),,
9,0,2,3,5,0,0,0,0,0,0,0,0,0,2,3,5,26,26,0.0,M2019-12-26D,Race(5),,
10,2,6,7,15,9,4,11,24,3,6,12,21,14,16,30,60,6,6,0.0,M2019-12-26D,Race(5),,
12,3,0,7,10,0,1,0,1,0,0,1,1,3,1,8,12,9.5,9.5,3.0,M2019-12-26D,Race(5),,
1,16,2,5,23,10,10,8,28,11,3,9,23,37,15,22,74,3,3,0.0,M2019-12-26D,Race(5),,
12,5,0,6,11,0,0,2,2,0,0,1,1,5,0,9,14,6,6,3.0,M2019-12-26D,Race(6),,
1,4,5,4,13,9,4,6,19,3,3,9,15,16,12,19,47,5.5,5.5,0.0,M2019-12-26D,Race(6),,
6,0,0,3,3,0,0,1,1,1,1,1,3,1,1,5,7,14,14,0.0,M2019-12-26D,Race(6),,
3,0,0,0,0,0,1,0,1,0,2,0,2,0,3,0,3,31,31,0.0,M2019-12-26D,Race(6),,
7,0,0,0,0,0,0,0,0,0,0,0,0,0,0,0,0,51,51,0.0,M2019-12-26D,Race(6),,
9,2,0,0,2,0,0,0,0,0,0,0,0,2,0,0,2,61,61,0.0,M2019-12-26D,Race(6),,
2,12,9,0,21,8,9,10,27,8,10,3,21,28,28,13,69,5,5,1.0,M2019-12-26D,Race(6),,
10,5,11,11,27,4,9,6,19,4,5,7,16,13,25,24,62,4,4,0.0,M2019-12-26D,Race(6),,
11,0,0,0,0,0,0,1,1,0,0,0,0,0,0,1,1,15,15,0.0,M2019-12-26D,Race(6),,
4,2,5,6,13,9,7,4,20,10,5,5,20,21,17,15,53,4.2,4.2,2.0,M2019-12-26D,Race(6),,
8,0,0,0,0,0,0,0,0,0,0,0,0,0,0,0,0,41,41,0.0,M2019-12-26D,Race(6),,
5,0,0,0,0,0,0,0,0,0,0,0,0,0,0,0,0,81,81,0.0,M2019-12-26D,Race(6),,
1,3,0,0,3,5,10,0,15,4,2,2,8,12,12,2,26,11,11,0.0,M2019-12-26D,Race(7),,
6,0,6,13,19,5,9,4,18,5,9,4,18,10,24,21,55,5,5,0.0,M2019-12-26D,Race(7),,
2,0,5,2,7,2,0,2,4,1,2,1,4,3,7,5,15,11,11,0.0,M2019-12-26D,Race(7),,
9,7,5,8,20,2,6,4,12,5,6,4,15,14,17,16,47,6.5,5.5,1.0,M2019-12-26D,Race(7),,
7,0,0,0,0,0,0,1,1,0,0,0,0,0,0,1,1,18,18,0.0,M2019-12-26D,Race(7),,
8,0,0,0,0,0,0,2,2,0,0,3,3,0,0,5,5,18,18,0.0,M2019-12-26D,Race(7),,
5,0,2,3,5,10,3,4,17,6,4,3,13,16,9,10,35,10,10,3.0,M2019-12-26D,Race(7),,
4,2,0,0,2,0,2,0,2,0,1,2,3,2,3,2,7,41,41,0.0,M2019-12-26D,Race(7),,
3,4,3,0,7,0,0,0,0,0,0,0,0,4,3,0,7,8,8,2.0,M2019-12-26D,Race(7),,
10,14,5,4,23,6,0,10,16,5,1,3,9,25,6,17,48,3.4,3.4,0.0,M2019-12-26D,Race(7),,
11,0,2,0,2,0,0,1,1,0,0,0,0,0,2,1,3,41,41,0.0,M2019-12-26D,Race(7),,
12,0,2,0,2,0,0,0,0,0,0,2,2,0,2,2,4,16,16,0.0,M2019-12-26D,Race(7),,
5,2,7,8,17,4,4,7,15,3,8,5,16,9,19,20,48,7,7,0.0,M2019-12-26D,Race(8),,
6,3,0,5,8,0,0,1,1,0,0,1,1,3,0,7,10,7.5,7.5,1.0,M2019-12-26D,Race(8),,
7,0,0,0,0,0,0,0,0,0,0,0,0,0,0,0,0,41,41,0.0,M2019-12-26D,Race(8),,
8,3,8,6,17,6,2,10,18,7,2,7,16,16,12,23,51,3.2,3.2,0.0,M2019-12-26D,Race(8),,
9,2,0,2,4,0,9,2,11,0,0,0,0,2,9,4,15,13,13,0.0,M2019-12-26D,Race(8),,
10,3,4,2,9,0,1,2,3,1,1,1,3,4,6,5,15,12,12,0.0,M2019-12-26D,Race(8),,
11,13,9,0,22,9,2,2,13,3,4,5,12,25,15,7,47,4.6,4.5,3.0,M2019-12-26D,Race(8),,
12,0,0,0,0,0,0,0,0,0,0,0,0,0,0,0,0,26,26,0.0,M2019-12-26D,Race(8),,
1,2,0,2,4,6,6,2,14,5,7,2,14,13,13,6,32,13,13,0.0,M2019-12-26D,Race(8),,
4,0,0,2,2,4,5,2,11,6,4,2,12,10,9,6,25,16,16,2.0,M2019-12-26D,Race(8),,
3,0,0,0,0,0,0,1,1,0,0,1,1,0,0,2,2,81,81,0.0,M2019-12-26D,Race(8),,
2,2,2,3,7,1,1,1,3,1,0,2,3,4,3,6,13,11,11,0.0,M2019-12-26D,Race(8),,
5,3,7,8,18,2,5,4,11,4,3,7,14,9,15,19,43,5,5,0.0,M2019-12-26D,Race(9),,
2,0,0,7,7,2,6,9,17,4,6,9,19,6,12,25,43,12,12,3.0,M2019-12-26D,Race(9),,
6,2,3,0,5,0,0,4,4,0,1,3,4,2,4,7,13,12,12,0.0,M2019-12-26D,Race(9),,
7,2,0,0,2,0,0,0,0,0,0,0,0,2,0,0,2,19,19,0.0,M2019-12-26D,Race(9),,
8,8,0,6,14,9,0,2,11,0,2,4,6,17,2,12,31,10,10,0.0,M2019-12-26D,Race(9),,
9,0,5,2,7,0,0,0,0,0,0,0,0,0,5,2,7,9,10,1.0,M2019-12-26D,Race(9),,
11,0,0,0,0,0,0,0,0,0,0,1,1,0,0,1,1,17,17,0.0,M2019-12-26D,Race(9),,
12,2,0,0,2,0,0,1,1,0,0,0,0,2,0,1,3,26,26,0.0,M2019-12-26D,Race(9),,
10,0,0,0,0,0,0,0,0,0,0,0,0,0,0,0,0,81,81,0.0,M2019-12-26D,Race(9),,
1,0,8,2,10,1,9,9,19,1,10,1,12,2,27,12,41,6,6,0.0,M2019-12-26D,Race(9),,
4,13,7,5,25,16,10,1,27,17,0,1,18,46,17,7,70,2.7,2.7,2.0,M2019-12-26D,Race(9),,
3,0,0,0,0,0,0,0,0,0,4,0,4,0,4,0,4,81,81,0.0,M2019-12-26D,Race(9),,
8,0,4,0,4,0,0,0,0,0,0,0,0,0,4,0,4,61,61,0.0,M2019-12-29D,Race(1),,
2,21,5,2,28,21,7,2,30,11,11,2,24,53,23,6,82,1.85,1.8,1.0,M2019-12-29D,Race(1),,
3,3,12,8,23,8,17,4,29,11,9,5,25,22,38,17,77,3.7,3.6,0.0,M2019-12-29D,Race(1),,
4,0,0,0,0,0,0,0,0,0,0,0,0,0,0,0,0,61,61,0.0,M2019-12-29D,Race(1),,
5,0,0,0,0,0,0,0,0,0,0,0,0,0,0,0,0,101,91,0.0,M2019-12-29D,Race(1),,
6,6,3,0,9,0,1,7,8,0,2,9,11,6,6,16,28,7,7,3.0,M2019-12-29D,Race(1),,
7,0,0,12,12,1,5,16,22,2,4,6,12,3,9,34,46,6,6,2.0,M2019-12-29D,Race(1),,
1,0,6,8,14,0,0,1,1,2,0,4,6,2,6,13,21,10,9.5,0.0,M2019-12-29D,Race(1),,
1,0,0,0,0,0,0,0,0,0,0,0,0,0,0,0,0,41,41,0.0,M2019-12-29D,Race(10),,
3,2,8,3,13,1,0,3,4,1,0,4,5,4,8,10,22,15,15,0.0,M2019-12-29D,Race(10),,
5,16,5,5,26,18,7,4,29,15,8,0,23,49,20,9,78,2.7,2.7,0.0,M2019-12-29D,Race(10),,
6,2,0,2,4,0,2,1,3,0,1,3,4,2,3,6,11,6.5,6.5,0.0,M2019-12-29D,Race(10),,
7,0,3,0,3,1,0,0,1,0,0,3,3,1,3,3,7,15,15,1.0,M2019-12-29D,Race(10),,
8,0,5,0,5,0,1,1,2,0,3,2,5,0,9,3,12,26,26,0.0,M2019-12-29D,Race(10),,
9,0,0,0,0,0,0,0,0,0,0,0,0,0,0,0,0,101,101,0.0,M2019-12-29D,Race(10),,
4,2,0,0,2,0,0,0,0,0,0,0,0,2,0,0,2,71,67,0.0,M2019-12-29D,Race(10),,
11,8,2,2,12,5,1,7,13,3,1,3,7,16,4,12,32,7.5,7.5,3.0,M2019-12-29D,Race(10),,
12,0,0,5,5,1,0,6,7,1,0,2,3,2,0,13,15,8,8,0.0,M2019-12-29D,Race(10),,
13,0,5,5,10,0,3,3,6,1,3,5,9,1,11,13,25,15,15,0.0,M2019-12-29D,Race(10),,
14,0,2,0,2,0,0,0,0,0,0,0,0,0,2,0,2,51,51,2.0,M2019-12-29D,Race(10),,
2,0,0,6,6,0,0,2,2,0,0,2,2,0,0,10,10,21,21,0.0,M2019-12-29D,Race(10),,
10,0,0,2,2,4,16,3,23,5,10,2,17,9,26,7,42,7,7,0.0,M2019-12-29D,Race(10),,
7,0,0,0,0,0,0,0,0,0,1,0,1,0,1,0,1,19,19,0.0,M2019-12-29D,Race(2),,
6,0,0,0,0,0,0,0,0,0,0,0,0,0,0,0,0,21,21,3.0,M2019-12-29D,Race(2),,
5,2,0,4,6,0,1,1,2,1,2,3,6,3,3,8,14,8,8,0.0,M2019-12-29D,Race(2),,
10,15,9,2,26,18,8,2,28,12,9,1,22,45,26,5,76,3.1,3.1,0.0,M2019-12-29D,Race(2),,
3,0,0,3,3,0,1,0,1,1,2,1,4,1,3,4,8,26,26,0.0,M2019-12-29D,Race(2),,
12,2,4,16,22,0,1,8,9,0,3,11,14,2,8,35,45,5.5,5.5,0.0,M2019-12-29D,Race(2),,
11,0,0,0,0,0,0,0,0,0,0,0,0,0,0,0,0,41,41,0.0,M2019-12-29D,Race(2),,
8,0,9,0,9,3,3,15,21,2,3,5,10,5,15,20,40,9,9,1.0,M2019-12-29D,Race(2),,
13,0,0,0,0,0,0,0,0,0,0,1,1,0,0,1,1,21,21,0.0,M2019-12-29D,Race(2),,
1,11,8,2,21,9,15,4,28,8,6,4,18,28,29,10,67,5,5,2.0,M2019-12-29D,Race(2),,
2,0,0,3,3,0,0,0,0,1,0,0,1,1,0,3,4,26,26,0.0,M2019-12-29D,Race(2),,
14,0,0,0,0,0,0,0,0,0,0,0,0,0,0,0,0,51,51,0.0,M2019-12-29D,Race(2),,
4,0,0,0,0,0,1,0,1,0,0,0,0,0,1,0,1,31,31,0.0,M2019-12-29D,Race(2),,
9,0,0,0,0,0,0,0,0,0,0,0,0,0,0,0,0,26,26,0.0,M2019-12-29D,Race(2),,
4,0,0,2,2,0,0,0,0,0,0,0,0,0,0,2,2,21,21,1.0,M2019-12-29D,Race(3),,
5,0,0,0,0,0,0,0,0,1,1,0,2,1,1,0,2,31,31,0.0,M2019-12-29D,Race(3),,
6,0,10,2,12,1,3,14,18,1,3,8,12,2,16,24,42,8.5,8.5,2.0,M2019-12-29D,Race(3),,
7,10,5,5,20,3,18,3,24,3,11,5,19,16,34,13,63,4,4,0.0,M2019-12-29D,Race(3),,
3,18,7,3,28,23,3,3,29,19,6,0,25,60,16,6,82,3.5,3.5,0.0,M2019-12-29D,Race(3),,
1,0,0,0,0,1,0,0,1,0,0,0,0,1,0,0,1,19,19,0.0,M2019-12-29D,Race(3),,
2,0,2,4,6,0,1,0,1,0,0,0,0,0,3,4,7,19,19,0.0,M2019-12-29D,Race(3),,
11,2,6,2,10,1,2,6,9,2,2,9,13,5,10,17,32,4.6,4.6,3.0,M2019-12-29D,Race(3),,
12,0,0,0,0,0,0,0,0,0,0,0,0,0,0,0,0,151,151,0.0,M2019-12-29D,Race(3),,
13,0,0,0,0,0,0,0,0,0,0,0,0,0,0,0,0,31,31,0.0,M2019-12-29D,Race(3),,
14,0,0,0,0,0,0,0,0,0,0,0,0,0,0,0,0,51,51,0.0,M2019-12-29D,Race(3),,
8,0,0,0,0,0,0,0,0,0,0,0,0,0,0,0,0,81,81,0.0,M2019-12-29D,Race(3),,
10,0,0,9,9,1,3,3,7,0,3,3,6,1,6,15,22,9.5,9.5,0.0,M2019-12-29D,Race(3),,
9,0,0,3,3,0,0,1,1,0,0,1,1,0,0,5,5,21,21,0.0,M2019-12-29D,Race(3),,
11,9,4,3,16,18,3,5,26,14,4,4,22,41,11,12,64,3.1,3.1,0.0,M2019-12-29D,Race(4),,
2,0,2,7,9,1,0,0,1,1,1,1,3,2,3,8,13,12,12,0.0,M2019-12-29D,Race(4),,
7,0,2,6,8,0,1,0,1,2,3,0,5,2,6,6,14,11,11,0.0,M2019-12-29D,Race(4),,
8,3,3,9,15,4,5,6,15,4,5,5,14,11,13,20,44,6.5,6.5,0.0,M2019-12-29D,Race(4),,
5,0,2,0,2,0,1,0,1,0,0,0,0,0,3,0,3,41,41,0.0,M2019-12-29D,Race(4),,
12,0,0,0,0,0,0,0,0,0,0,0,0,0,0,0,0,151,151,0.0,M2019-12-29D,Race(4),,
13,0,0,0,0,0,0,1,1,0,0,3,3,0,0,4,4,9,9,3.0,M2019-12-29D,Race(4),,
10,2,0,0,2,0,0,0,0,0,0,1,1,2,0,1,3,61,61,0.0,M2019-12-29D,Race(4),,
6,2,0,0,2,0,0,0,0,0,0,0,0,2,0,0,2,26,26,0.0,M2019-12-29D,Race(4),,
4,0,9,0,9,2,4,13,19,0,5,6,11,2,18,19,39,16,16,0.0,M2019-12-29D,Race(4),,
9,0,0,5,5,0,0,0,0,0,0,1,1,0,0,6,6,61,61,0.0,M2019-12-29D,Race(4),,
3,11,6,0,17,5,3,1,9,4,4,2,10,20,13,3,36,5,5,2.0,M2019-12-29D,Race(4),,
1,3,2,0,5,0,13,4,17,1,3,3,7,4,18,7,29,9,9.5,1.0,M2019-12-29D,Race(4),,
14,0,0,0,0,0,0,0,0,0,1,0,1,0,1,0,1,21,21,0.0,M2019-12-29D,Race(4),,
2,12,8,5,25,20,4,3,27,14,2,5,21,46,14,13,73,4.2,4,3.0,M2019-12-29D,Race(5),,
11,0,0,0,0,0,0,0,0,0,0,0,0,0,0,0,0,34,34,0.0,M2019-12-29D,Race(5),,
4,0,0,2,2,0,0,0,0,0,0,1,1,0,0,3,3,34,34,2.0,M2019-12-29D,Race(5),,
5,0,0,0,0,0,0,0,0,0,0,0,0,0,0,0,0,81,81,0.0,M2019-12-29D,Race(5),,
6,0,0,0,0,0,1,3,4,0,1,5,6,0,2,8,10,12,12,0.0,M2019-12-29D,Race(5),,
8,8,2,0,10,0,4,2,6,0,4,4,8,8,10,6,24,3.9,4.8,0.0,M2019-12-29D,Race(5),,
9,3,10,2,15,5,4,10,19,10,6,2,18,18,20,14,52,4.2,4,1.0,M2019-12-29D,Race(5),,
10,5,2,12,19,4,13,10,27,2,8,7,17,11,23,29,63,8,8,0.0,M2019-12-29D,Race(5),,
12,0,0,0,0,0,0,0,0,0,1,0,1,0,1,0,1,51,51,0.0,M2019-12-29D,Race(5),,
7,0,3,0,3,0,0,0,0,0,0,0,0,0,3,0,3,21,21,0.0,M2019-12-29D,Race(5),,
1,0,5,6,11,0,2,2,4,0,2,2,4,0,9,10,19,20,20,0.0,M2019-12-29D,Race(5),,
14,0,0,0,0,0,0,0,0,0,0,0,0,0,0,0,0,101,101,0.0,M2019-12-29D,Race(5),,
3,2,0,3,5,1,2,0,3,0,2,0,2,3,4,3,10,9.5,9,0.0,M2019-12-29D,Race(5),,
13,0,0,0,0,0,0,0,0,0,0,0,0,0,0,0,0,20,19,0.0,M2019-12-29D,Race(5),,
8,0,0,0,0,0,0,0,0,0,0,0,0,0,0,0,0,61,61,3.0,M2019-12-29D,Race(6),,
9,0,0,2,2,0,0,0,0,0,0,0,0,0,0,2,2,34,34,0.0,M2019-12-29D,Race(6),,
10,0,0,2,2,2,1,1,4,1,1,1,3,3,2,4,9,14,14,0.0,M2019-12-29D,Race(6),,
7,3,0,0,3,0,0,0,0,0,2,1,3,3,2,1,6,31,31,0.0,M2019-12-29D,Race(6),,
12,2,8,9,19,6,15,6,27,6,9,4,19,14,32,19,65,4,4,2.0,M2019-12-29D,Race(6),,
13,0,0,0,0,0,0,0,0,0,0,0,0,0,0,0,0,126,126,0.0,M2019-12-29D,Race(6),,
6,3,4,3,10,5,6,3,14,6,3,3,12,14,13,9,36,4,4,0.0,M2019-12-29D,Race(6),,
14,0,0,0,0,0,0,0,0,0,0,0,0,0,0,0,0,71,67,0.0,M2019-12-29D,Race(6),,
11,2,2,3,7,0,2,1,3,1,3,4,8,3,7,8,18,13,16,0.0,M2019-12-29D,Race(6),,
2,0,0,0,0,0,0,0,0,0,0,0,0,0,0,0,0,26,26,0.0,M2019-12-29D,Race(6),,
4,11,11,5,27,16,4,6,26,11,4,7,22,38,19,18,75,3.8,3.8,1.0,M2019-12-29D,Race(6),,
3,6,5,4,15,1,2,11,14,1,2,4,7,8,9,19,36,6,6,0.0,M2019-12-29D,Race(6),,
5,0,0,0,0,0,0,0,0,0,0,1,1,0,0,1,1,41,41,0.0,M2019-12-29D,Race(6),,
1,3,0,2,5,0,0,2,2,0,2,1,3,3,2,5,10,19,19,0.0,M2019-12-29D,Race(6),,
1,0,2,9,11,2,4,16,22,5,5,6,16,7,11,31,49,8.5,8.5,0.0,M2019-12-29D,Race(7),,
2,0,0,0,0,0,0,0,0,0,0,0,0,0,0,0,0,19,16,0.0,M2019-12-29D,Race(7),,
3,4,0,7,11,6,15,3,24,8,3,5,16,18,18,15,51,7,6,0.0,M2019-12-29D,Race(7),,
4,13,15,2,30,17,7,4,28,8,11,5,24,38,33,11,82,2.05,2.05,3.0,M2019-12-29D,Race(7),,
5,8,0,7,15,0,1,3,4,0,3,5,8,8,4,15,27,8,7,2.0,M2019-12-29D,Race(7),,
6,0,2,5,7,0,0,0,0,0,0,0,0,0,2,5,7,23,21,0.0,M2019-12-29D,Race(7),,
7,5,11,0,16,5,3,4,12,5,4,5,14,15,18,9,42,3.5,3.7,1.0,M2019-12-29D,Race(7),,
7,0,2,2,4,1,0,0,1,1,0,1,2,2,2,3,7,31,31,0.0,M2019-12-29D,Race(8),,
8,0,0,0,0,0,0,0,0,0,0,0,0,0,0,0,0,41,41,0.0,M2019-12-29D,Race(8),,
9,2,0,0,2,0,1,0,1,0,1,0,1,2,2,0,4,26,26,0.0,M2019-12-29D,Race(8),,
11,6,7,7,20,15,6,6,27,7,8,4,19,28,21,17,66,3.8,3.8,3.0,M2019-12-29D,Race(8),,
6,0,0,0,0,0,0,0,0,0,1,0,1,0,1,0,1,17,17,0.0,M2019-12-29D,Race(8),,
5,0,3,0,3,1,0,1,2,1,0,2,3,2,3,3,8,17,17,0.0,M2019-12-29D,Race(8),,
4,2,0,0,2,1,1,3,5,1,2,3,6,4,3,6,13,8.5,8.5,2.0,M2019-12-29D,Race(8),,
3,6,6,6,18,5,4,9,18,5,4,2,11,16,14,17,47,13,13,0.0,M2019-12-29D,Race(8),,
12,0,0,3,3,0,1,2,3,0,0,2,2,0,1,7,8,19,21,0.0,M2019-12-29D,Race(8),,
1,2,3,0,5,0,1,1,2,0,1,2,3,2,5,3,10,13,13,0.0,M2019-12-29D,Race(8),,
13,9,5,5,19,7,14,4,25,9,5,6,20,25,24,15,64,4,4,1.0,M2019-12-29D,Race(8),,
14,0,2,0,2,0,0,2,2,0,2,2,4,0,4,4,8,14,14,0.0,M2019-12-29D,Race(8),,
10,0,0,0,0,0,0,0,0,0,1,0,1,0,1,0,1,101,101,0.0,M2019-12-29D,Race(8),,
2,3,2,7,12,0,2,2,4,2,1,2,5,5,5,11,21,6,6,0.0,M2019-12-29D,Race(8),,
2,2,0,6,8,1,0,2,3,0,1,2,3,3,1,10,14,10,10,0.0,M2019-12-29D,Race(9),,
3,0,0,0,0,0,0,2,2,0,0,2,2,0,0,4,4,26,26,0.0,M2019-12-29D,Race(9),,
4,0,0,2,2,0,0,0,0,0,0,0,0,0,0,2,2,26,26,0.0,M2019-12-29D,Race(9),,
6,2,3,2,7,0,1,17,18,0,1,8,9,2,5,27,34,6.5,6.5,1.0,M2019-12-29D,Race(9),,
7,0,0,0,0,0,0,0,0,0,0,0,0,0,0,0,0,51,51,0.0,M2019-12-29D,Race(9),,
9,0,0,3,3,0,0,1,1,0,0,2,2,0,0,6,6,18,18,0.0,M2019-12-29D,Race(9),,
10,0,6,3,9,0,0,2,2,0,1,2,3,0,7,7,14,15,15,0.0,M2019-12-29D,Race(9),,
11,0,15,5,20,6,23,1,30,1,20,4,25,7,58,10,75,3.8,3.8,3.0,M2019-12-29D,Race(9),,
12,0,0,0,0,0,0,0,0,0,0,0,0,0,0,0,0,51,51,0.0,M2019-12-29D,Race(9),,
13,0,0,0,0,0,0,0,0,0,0,0,0,0,0,0,0,31,31,0.0,M2019-12-29D,Race(9),,
1,21,3,2,26,23,5,2,30,22,0,2,24,66,8,6,80,3,3,2.0,M2019-12-29D,Race(9),,
8,3,3,4,10,0,1,2,3,2,3,2,7,5,7,8,20,11,11,0.0,M2019-12-29D,Race(9),,
5,2,0,3,5,0,0,1,1,1,0,2,3,3,0,6,9,15,15,0.0,M2019-12-29D,Race(9),,
4,3,5,11,19,11,6,14,31,7,8,7,22,21,19,32,72,5,5,3.0,M2020-01-01D,Race(1),,
2,0,0,0,0,0,0,0,0,0,0,0,0,0,0,0,0,34,34,0.0,M2020-01-01D,Race(1),,
5,20,2,0,22,18,10,1,29,16,4,3,23,54,16,4,74,2.05,2.05,0.0,M2020-01-01D,Race(1),,
6,0,12,2,14,0,5,2,7,0,4,2,6,0,21,6,27,4.8,4.8,1.0,M2020-01-01D,Race(1),,
7,2,3,0,5,0,1,0,1,0,1,0,1,2,5,0,7,26,26,0.0,M2020-01-01D,Race(1),,
8,3,2,3,8,1,3,8,12,1,6,6,13,5,11,17,33,13,13,2.0,M2020-01-01D,Race(1),,
9,0,2,2,4,0,2,0,2,0,0,1,1,0,4,3,7,26,26,0.0,M2020-01-01D,Race(1),,
10,0,0,6,6,0,0,0,0,2,0,2,4,2,0,8,10,21,21,0.0,M2020-01-01D,Race(1),,
11,2,2,6,10,0,3,2,5,0,3,2,5,2,8,10,20,8.5,8.5,0.0,M2020-01-01D,Race(1),,
12,0,0,0,0,0,0,0,0,0,0,0,0,0,0,0,0,151,151,0.0,M2020-01-01D,Race(1),,
1,0,0,0,0,0,0,0,0,0,0,0,0,0,0,0,0,61,61,0.0,M2020-01-01D,Race(1),,
3,0,2,0,2,0,0,0,0,0,0,0,0,0,2,0,2,101,101,0.0,M2020-01-01D,Race(1),,
2,11,12,0,23,10,6,10,26,13,4,1,18,34,22,11,67,3.5,3.4,0.0,M2020-01-01D,Race(10),,
4,8,11,2,21,13,5,6,24,2,5,7,14,23,21,15,59,4.4,4.2,0.0,M2020-01-01D,Race(10),,
3,0,0,0,0,0,0,0,0,0,0,0,0,0,0,0,0,17,17,0.0,M2020-01-01D,Race(10),,
8,0,0,5,5,0,1,1,2,0,2,2,4,0,3,8,11,26,26,0.0,M2020-01-01D,Race(10),,
6,0,0,0,0,0,2,1,3,0,3,1,4,0,5,2,7,15,15,0.0,M2020-01-01D,Race(10),,
7,0,0,5,5,0,0,1,1,0,2,2,4,0,2,8,10,21,21,0.0,M2020-01-01D,Race(10),,
1,0,0,0,0,0,0,1,1,0,0,0,0,0,0,1,1,41,41,0.0,M2020-01-01D,Race(10),,
14,2,4,10,16,3,2,6,11,4,4,5,13,9,10,21,40,6,6,0.0,M2020-01-01D,Race(10),,
13,0,0,0,0,0,0,0,0,0,0,0,0,0,0,0,0,61,61,3.0,M2020-01-01D,Race(10),,
12,0,0,3,3,0,1,1,2,0,1,3,4,0,2,7,9,20,21,0.0,M2020-01-01D,Race(10),,
11,0,0,0,0,0,0,0,0,0,0,0,0,0,0,0,0,41,41,0.0,M2020-01-01D,Race(10),,
5,0,0,0,0,1,0,0,1,0,0,0,0,1,0,0,1,41,41,1.0,M2020-01-01D,Race(10),,
9,9,3,5,17,3,13,3,19,7,5,4,16,19,21,12,52,4.6,5,2.0,M2020-01-01D,Race(10),,
10,0,0,0,0,0,0,0,0,0,0,0,0,0,0,0,0,31,31,0.0,M2020-01-01D,Race(10),,
6,0,7,2,9,1,4,4,9,0,7,2,9,1,18,8,27,4.6,4.5,0.0,M2020-01-01D,Race(2),,
2,0,0,2,2,0,0,1,1,0,0,2,2,0,0,5,5,14,14,0.0,M2020-01-01D,Race(2),,
3,5,3,6,14,8,6,3,17,8,3,7,18,21,12,16,49,5,5,0.0,M2020-01-01D,Race(2),,
4,0,0,9,9,11,5,4,20,5,3,3,11,16,8,16,40,9,9,0.0,M2020-01-01D,Race(2),,
8,3,5,0,8,2,9,3,14,1,7,4,12,6,21,7,34,9.5,9.5,2.0,M2020-01-01D,Race(2),,
1,5,8,0,13,1,1,5,7,2,3,3,8,8,12,8,28,6.5,6.5,3.0,M2020-01-01D,Race(2),,
7,7,3,3,13,0,1,0,1,0,1,0,1,7,5,3,15,10,10,0.0,M2020-01-01D,Race(2),,
10,2,0,0,2,0,0,0,0,0,0,1,1,2,0,1,3,61,61,1.0,M2020-01-01D,Race(2),,
11,0,0,0,0,0,0,0,0,0,0,0,0,0,0,0,0,81,81,0.0,M2020-01-01D,Race(2),,
12,8,2,8,18,7,4,9,20,9,2,4,15,24,8,21,53,5,5,0.0,M2020-01-01D,Race(2),,
9,0,2,0,2,0,0,1,1,1,0,0,1,1,2,1,4,12,12,0.0,M2020-01-01D,Race(2),,
5,0,0,0,0,0,0,0,0,0,0,0,0,0,0,0,0,0,0,0.0,M2020-01-01D,Race(2),,
6,18,7,3,28,18,10,1,29,17,3,1,21,53,20,5,78,2.3,2.3,1.0,M2020-01-01D,Race(3),,
10,0,0,0,0,0,0,0,0,0,0,0,0,0,0,0,0,81,81,0.0,M2020-01-01D,Race(3),,
1,2,2,8,12,10,5,4,19,3,3,6,12,15,10,18,43,5,5,2.0,M2020-01-01D,Race(3),,
3,0,0,0,0,0,0,0,0,0,0,0,0,0,0,0,0,91,91,0.0,M2020-01-01D,Race(3),,
4,0,2,0,2,0,1,2,3,0,0,2,2,0,3,4,7,34,34,0.0,M2020-01-01D,Race(3),,
5,0,2,2,4,0,0,0,0,0,2,1,3,0,4,3,7,19,19,0.0,M2020-01-01D,Race(3),,
7,0,0,0,0,0,0,2,2,0,1,2,3,0,1,4,5,26,26,0.0,M2020-01-01D,Race(3),,
9,3,12,2,17,2,5,14,21,3,7,8,18,8,24,24,56,5,5,0.0,M2020-01-01D,Race(3),,
11,2,0,0,2,0,0,0,0,0,0,0,0,2,0,0,2,41,41,0.0,M2020-01-01D,Race(3),,
12,2,0,3,5,0,1,0,1,0,2,0,2,2,3,3,8,26,26,0.0,M2020-01-01D,Race(3),,
8,0,0,0,0,0,0,0,0,0,0,0,0,0,0,0,0,61,61,0.0,M2020-01-01D,Race(3),,
2,3,5,12,20,0,8,7,15,3,8,6,17,6,21,25,52,4.4,4.5,3.0,M2020-01-01D,Race(3),,
10,2,2,0,4,0,0,1,1,0,0,0,0,2,2,1,5,15,15,0.0,M2020-01-01D,Race(4),,
3,6,7,9,22,13,8,8,29,14,7,2,23,33,22,19,74,3,3,2.0,M2020-01-01D,Race(4),,
9,3,0,5,8,1,10,13,24,1,5,12,18,5,15,30,50,7,7,0.0,M2020-01-01D,Race(4),,
8,0,0,0,0,0,0,0,0,0,0,2,2,0,0,2,2,10,10,0.0,M2020-01-01D,Race(4),,
7,0,0,0,0,0,0,0,0,0,0,1,1,0,0,1,1,91,91,0.0,M2020-01-01D,Race(4),,
6,5,8,5,18,0,0,0,0,1,3,2,6,6,11,7,24,5,5,0.0,M2020-01-01D,Race(4),,
13,0,0,0,0,0,0,0,0,0,0,0,0,0,0,0,0,31,31,0.0,M2020-01-01D,Race(4),,
4,14,8,6,28,16,9,5,30,9,9,7,25,39,26,18,83,4.6,4.6,0.0,M2020-01-01D,Race(4),,
11,0,0,0,0,0,0,0,0,0,0,0,0,0,0,0,0,81,81,3.0,M2020-01-01D,Race(4),,
2,0,2,5,7,0,3,2,5,1,2,0,3,1,7,7,15,21,21,1.0,M2020-01-01D,Race(4),,
1,0,0,0,0,0,0,0,0,0,0,0,0,0,0,0,0,51,51,0.0,M2020-01-01D,Race(4),,
5,0,3,0,3,0,0,1,1,0,0,0,0,0,3,1,4,13,13,0.0,M2020-01-01D,Race(4),,
12,0,0,0,0,0,0,0,0,0,0,0,0,0,0,0,0,101,101,0.0,M2020-01-01D,Race(4),,
14,0,0,0,0,0,0,0,0,0,0,0,0,0,0,0,0,101,101,0.0,M2020-01-01D,Race(4),,
1,10,3,9,22,13,8,5,26,15,1,6,22,38,12,20,70,6,6,0.0,M2020-01-01D,Race(5),,
2,0,0,3,3,0,7,3,10,0,11,0,11,0,18,6,24,16,16,0.0,M2020-01-01D,Race(5),,
3,0,2,2,4,1,1,1,3,2,0,2,4,3,3,5,11,15,15,0.0,M2020-01-01D,Race(5),,
12,0,0,0,0,0,0,0,0,0,0,0,0,0,0,0,0,19,19,0.0,M2020-01-01D,Race(5),,
8,0,0,0,0,0,0,0,0,0,1,0,1,0,1,0,1,81,81,0.0,M2020-01-01D,Race(5),,
13,0,3,9,12,0,1,1,2,0,1,1,2,0,5,11,16,11,11,0.0,M2020-01-01D,Race(5),,
6,0,0,0,0,0,1,1,2,0,1,0,1,0,2,1,3,9,9,0.0,M2020-01-01D,Race(5),,
5,0,5,0,5,1,0,1,2,2,0,1,3,3,5,2,10,19,19,2.0,M2020-01-01D,Race(5),,
14,0,0,0,0,0,0,0,0,0,0,0,0,0,0,0,0,26,26,0.0,M2020-01-01D,Race(5),,
9,0,0,0,0,0,0,0,0,0,0,0,0,0,0,0,0,41,41,0.0,M2020-01-01D,Race(5),,
4,12,3,4,19,12,8,11,31,4,4,5,13,28,15,20,63,4.4,4.5,3.0,M2020-01-01D,Race(5),,
10,0,0,0,0,0,0,0,0,0,0,0,0,0,0,0,0,151,251,0.0,M2020-01-01D,Race(5),,
11,8,12,3,23,3,4,7,14,2,6,9,17,13,22,19,54,3.1,3.1,1.0,M2020-01-01D,Race(5),,
7,0,2,0,2,0,0,0,0,0,0,0,0,0,2,0,2,19,19,0.0,M2020-01-01D,Race(5),,
1,0,0,0,0,0,0,0,0,0,0,0,0,0,0,0,0,34,34,0.0,M2020-01-01D,Race(6),,
4,0,2,0,2,0,2,3,5,0,4,6,10,0,8,9,17,11,11,0.0,M2020-01-01D,Race(6),,
7,0,2,3,5,0,0,0,0,1,2,1,4,1,4,4,9,18,18,0.0,M2020-01-01D,Race(6),,
8,2,8,2,12,5,2,10,17,7,3,0,10,14,13,12,39,6,6,0.0,M2020-01-01D,Race(6),,
9,0,2,0,2,0,0,0,0,0,0,0,0,0,2,0,2,41,41,0.0,M2020-01-01D,Race(6),,
10,2,0,0,2,0,2,3,5,0,1,1,2,2,3,4,9,16,16,0.0,M2020-01-01D,Race(6),,
11,0,6,2,8,0,1,1,2,0,2,4,6,0,9,7,16,13,13,2.0,M2020-01-01D,Race(6),,
12,0,0,0,0,0,0,0,0,0,0,0,0,0,0,0,0,101,101,0.0,M2020-01-01D,Race(6),,
13,0,0,0,0,0,0,0,0,0,0,1,1,0,0,1,1,101,101,0.0,M2020-01-01D,Race(6),,
14,0,0,0,0,0,0,2,2,0,0,2,2,0,0,4,4,26,26,3.0,M2020-01-01D,Race(6),,
6,2,2,14,18,4,3,1,8,4,0,0,4,10,5,15,30,3.8,3.8,1.0,M2020-01-01D,Race(6),,
5,10,3,2,15,3,14,6,23,4,7,7,18,17,24,15,56,6,6,0.0,M2020-01-01D,Race(6),,
2,0,0,0,0,0,0,0,0,0,0,0,0,0,0,0,0,51,51,0.0,M2020-01-01D,Race(6),,
3,14,5,7,26,18,6,4,28,10,7,4,21,42,18,15,75,3.8,3.8,0.0,M2020-01-01D,Race(6),,
1,3,2,5,10,1,6,14,21,3,2,6,11,7,10,25,42,19,19,0.0,M2020-01-01D,Race(7),,
2,0,3,10,13,9,2,4,15,5,2,4,11,14,7,18,39,5,5,0.0,M2020-01-01D,Race(7),,
3,0,0,0,0,0,0,0,0,0,1,0,1,0,1,0,1,41,41,0.0,M2020-01-01D,Race(7),,
4,3,4,2,9,1,8,9,18,0,8,5,13,4,20,16,40,6.5,6.5,0.0,M2020-01-01D,Race(7),,
5,6,3,5,14,0,3,0,3,1,5,3,9,7,11,8,26,8,8,3.0,M2020-01-01D,Race(7),,
6,0,3,0,3,0,0,0,0,0,0,1,1,0,3,1,4,13,13,0.0,M2020-01-01D,Race(7),,
7,3,5,3,11,0,1,2,3,0,5,5,10,3,11,10,24,18,18,2.0,M2020-01-01D,Race(7),,
8,15,10,5,30,19,10,1,30,17,3,2,22,51,23,8,82,1.75,1.75,1.0,M2020-01-01D,Race(7),,
1,0,2,0,2,1,1,0,2,1,2,0,3,2,5,0,7,41,41,0.0,M2020-01-01D,Race(8),,
2,23,5,0,28,19,3,8,30,19,2,2,23,61,10,10,81,2.15,2.2,0.0,M2020-01-01D,Race(8),,
10,0,0,0,0,0,0,0,0,0,0,0,0,0,0,0,0,151,201,0.0,M2020-01-01D,Race(8),,
12,0,0,0,0,0,0,0,0,0,0,0,0,0,0,0,0,101,101,0.0,M2020-01-01D,Race(8),,
5,0,10,6,16,0,2,0,2,0,3,0,3,0,15,6,21,11,11,2.0,M2020-01-01D,Race(8),,
6,0,0,2,2,0,1,0,1,0,2,0,2,0,3,2,5,23,21,0.0,M2020-01-01D,Race(8),,
7,0,0,0,0,0,0,0,0,0,0,0,0,0,0,0,0,31,31,0.0,M2020-01-01D,Race(8),,
8,7,11,5,23,10,10,5,25,3,11,5,19,20,32,15,67,3.1,3.2,1.0,M2020-01-01D,Race(8),,
9,0,0,7,7,0,12,12,24,0,4,10,14,0,16,29,45,8,8,0.0,M2020-01-01D,Race(8),,
11,0,2,3,5,0,0,2,2,0,2,3,5,0,4,8,12,19,17,0.0,M2020-01-01D,Race(8),,
4,0,0,0,0,0,0,0,0,0,0,0,0,0,0,0,0,101,101,0.0,M2020-01-01D,Race(8),,
3,0,0,7,7,0,1,3,4,3,0,6,9,3,1,16,20,9.5,9.5,3.0,M2020-01-01D,Race(8),,
1,6,7,5,18,10,6,9,25,10,6,1,17,26,19,15,60,3.8,3.8,0.0,M2020-01-01D,Race(9),,
8,0,0,0,0,0,0,0,0,0,0,0,0,0,0,0,0,19,19,0.0,M2020-01-01D,Race(9),,
9,0,0,0,0,0,0,0,0,0,0,0,0,0,0,0,0,81,81,0.0,M2020-01-01D,Race(9),,
10,0,0,0,0,0,0,0,0,0,0,0,0,0,0,0,0,34,34,0.0,M2020-01-01D,Race(9),,
11,0,0,0,0,0,1,0,1,0,2,1,3,0,3,1,4,61,61,0.0,M2020-01-01D,Race(9),,
12,3,12,6,21,2,3,6,11,1,6,6,13,6,21,18,45,7,7,3.0,M2020-01-01D,Race(9),,
13,0,0,0,0,0,0,0,0,0,0,1,1,0,0,1,1,34,34,1.0,M2020-01-01D,Race(9),,
14,4,2,0,6,1,1,3,5,3,1,1,5,8,4,4,16,8,8,0.0,M2020-01-01D,Race(9),,
4,5,2,10,17,5,17,4,26,7,7,5,19,17,26,19,62,4.8,4.8,2.0,M2020-01-01D,Race(9),,
5,0,0,0,0,0,0,0,0,0,0,0,0,0,0,0,0,41,41,0.0,M2020-01-01D,Race(9),,
3,7,3,9,19,10,0,4,14,3,2,3,8,20,5,16,41,8.5,8.5,0.0,M2020-01-01D,Race(9),,
2,0,2,0,2,0,1,1,2,0,1,1,2,0,4,2,6,26,26,0.0,M2020-01-01D,Race(9),,
7,5,2,0,7,2,1,3,6,2,1,6,9,9,4,9,22,5,5,0.0,M2020-01-01D,Race(9),,
6,0,0,0,0,0,0,0,0,0,0,1,1,0,0,1,1,51,51,0.0,M2020-01-01D,Race(9),,
4,5,3,5,13,1,3,2,6,1,8,4,13,7,14,11,32,6.5,6.5,0.0,M2020-01-05D,Race(1),,
14,0,0,0,0,0,0,0,0,0,0,0,0,0,0,0,0,26,26,0.0,M2020-01-05D,Race(1),,
13,0,0,0,0,0,0,0,0,0,0,1,1,0,0,1,1,34,34,3.0,M2020-01-05D,Race(1),,
11,0,0,0,0,0,0,0,0,0,0,0,0,0,0,0,0,21,21,0.0,M2020-01-05D,Race(1),,
12,0,5,5,10,1,2,4,7,1,2,6,9,2,9,15,26,14,14,1.0,M2020-01-05D,Race(1),,
1,0,2,3,5,0,0,0,0,1,0,2,3,1,2,5,8,26,26,0.0,M2020-01-05D,Race(1),,
3,0,0,0,0,0,0,0,0,1,0,0,1,1,0,0,1,61,61,0.0,M2020-01-05D,Race(1),,
5,3,5,5,13,14,4,4,22,6,4,3,13,23,13,12,48,4,4,0.0,M2020-01-05D,Race(1),,
6,4,0,0,4,2,3,3,8,2,3,2,7,8,6,5,19,20,20,2.0,M2020-01-05D,Race(1),,
2,0,5,0,5,0,0,0,0,0,0,0,0,0,5,0,5,31,31,0.0,M2020-01-05D,Race(1),,
8,10,8,12,30,6,16,4,26,10,7,5,22,26,31,21,78,2.6,2.6,0.0,M2020-01-05D,Race(1),,
9,8,2,0,10,6,2,13,21,4,1,3,8,18,5,16,39,8,8,0.0,M2020-01-05D,Race(1),,
10,0,0,0,0,0,0,0,0,0,1,0,1,0,1,0,1,31,31,0.0,M2020-01-05D,Race(1),,
7,0,0,0,0,0,0,0,0,0,0,0,0,0,0,0,0,101,101,0.0,M2020-01-05D,Race(1),,
3,2,3,5,10,0,3,15,18,0,3,5,8,2,9,25,36,7,7,1.0,M2020-01-05D,Race(10),,
1,10,8,7,25,20,5,4,29,15,5,3,23,45,18,14,77,3.6,3.6,3.0,M2020-01-05D,Race(10),,
2,0,2,0,2,0,2,0,2,0,0,0,0,0,4,0,4,14,14,0.0,M2020-01-05D,Race(10),,
5,5,0,0,5,0,0,0,0,1,2,0,3,6,2,0,8,13,13,0.0,M2020-01-05D,Race(10),,
4,0,0,0,0,0,0,0,0,0,0,0,0,0,0,0,0,51,51,0.0,M2020-01-05D,Race(10),,
6,3,3,2,8,2,3,3,8,4,4,4,12,9,10,9,28,8,8,0.0,M2020-01-05D,Race(10),,
14,0,0,6,6,1,4,3,8,1,6,5,12,2,10,14,26,12,12,0.0,M2020-01-05D,Race(10),,
13,0,0,0,0,0,0,0,0,0,0,1,1,0,0,1,1,81,81,0.0,M2020-01-05D,Race(10),,
12,3,2,0,5,0,1,0,1,0,0,0,0,3,3,0,6,21,21,0.0,M2020-01-05D,Race(10),,
11,0,2,0,2,0,0,0,0,0,0,0,0,0,2,0,2,10,10,0.0,M2020-01-05D,Race(10),,
10,7,7,7,21,7,12,3,22,5,6,4,15,19,25,14,58,4.4,4.4,2.0,M2020-01-05D,Race(10),,
7,0,0,0,0,0,0,0,0,0,0,0,0,0,0,0,0,71,71,0.0,M2020-01-05D,Race(10),,
8,0,0,0,0,0,0,0,0,0,0,0,0,0,0,0,0,51,51,0.0,M2020-01-05D,Race(10),,
9,0,3,3,6,0,0,2,2,0,0,4,4,0,3,9,12,16,16,0.0,M2020-01-05D,Race(10),,
6,0,2,2,4,0,0,0,0,0,0,1,1,0,2,3,5,15,15,0.0,M2020-01-05D,Race(2),,
2,7,12,4,23,2,3,3,8,4,5,6,15,13,20,13,46,4.4,4.4,0.0,M2020-01-05D,Race(2),,
3,5,2,0,7,2,2,1,5,2,2,1,5,9,6,2,17,12,12,0.0,M2020-01-05D,Race(2),,
5,0,0,3,3,0,1,1,2,0,2,0,2,0,3,4,7,12,12,0.0,M2020-01-05D,Race(2),,
4,8,5,4,17,15,7,7,29,4,10,8,22,27,22,19,68,4.4,4.4,1.0,M2020-01-05D,Race(2),,
12,0,3,3,6,0,0,0,0,0,0,0,0,0,3,3,6,21,21,0.0,M2020-01-05D,Race(2),,
11,0,0,0,0,0,0,0,0,0,0,0,0,0,0,0,0,71,67,0.0,M2020-01-05D,Race(2),,
10,0,0,0,0,0,0,0,0,0,0,0,0,0,0,0,0,34,34,0.0,M2020-01-05D,Race(2),,
9,6,2,8,16,4,15,5,24,7,6,4,17,17,23,17,57,7,7,0.0,M2020-01-05D,Race(2),,
8,0,0,0,0,1,0,0,1,1,0,1,2,2,0,1,3,16,16,3.0,M2020-01-05D,Race(2),,
7,0,0,0,0,0,0,0,0,2,1,1,4,2,1,1,4,8.5,9,0.0,M2020-01-05D,Race(2),,
1,4,4,6,14,6,2,13,21,6,0,4,10,16,6,23,45,5.5,5.5,2.0,M2020-01-05D,Race(2),,
13,0,2,0,2,0,1,0,1,0,0,0,0,0,3,0,3,14,14,2.0,M2020-01-05D,Race(3),,
12,0,0,0,0,0,0,0,0,0,0,0,0,0,0,0,0,11,11,0.0,M2020-01-05D,Race(3),,
14,0,2,0,2,0,0,0,0,0,0,0,0,0,2,0,2,41,41,0.0,M2020-01-05D,Race(3),,
10,5,8,7,20,5,13,3,21,4,3,2,9,14,24,12,50,4.8,4.8,0.0,M2020-01-05D,Race(3),,
9,0,0,0,0,0,0,0,0,0,0,0,0,0,0,0,0,126,126,0.0,M2020-01-05D,Race(3),,
8,15,3,3,21,15,4,4,23,9,3,2,14,39,10,9,58,5.5,5.5,0.0,M2020-01-05D,Race(3),,
6,2,0,0,2,1,0,1,2,2,1,2,5,5,1,3,9,19,19,0.0,M2020-01-05D,Race(3),,
5,0,0,0,0,0,0,1,1,0,0,1,1,0,0,2,2,31,31,0.0,M2020-01-05D,Race(3),,
7,0,0,2,2,0,0,4,4,0,2,6,8,0,2,12,14,11,11,0.0,M2020-01-05D,Race(3),,
3,6,5,4,15,3,4,11,18,4,5,3,12,13,14,18,45,8,8,3.0,M2020-01-05D,Race(3),,
2,0,0,0,0,0,0,0,0,0,0,0,0,0,0,0,0,41,41,0.0,M2020-01-05D,Race(3),,
1,2,3,3,8,3,3,2,8,2,4,2,8,7,10,7,24,9,9,0.0,M2020-01-05D,Race(3),,
4,0,5,9,14,0,1,3,4,1,1,6,8,1,7,18,26,5,5,1.0,M2020-01-05D,Race(3),,
11,0,2,2,4,0,1,0,1,0,1,0,1,0,4,2,6,17,17,0.0,M2020-01-05D,Race(3),,
9,3,0,0,3,0,0,3,3,1,1,5,7,4,1,8,13,9.5,9.5,0.0,M2020-01-05D,Race(4),,
10,3,8,3,14,2,4,2,8,1,5,2,8,6,17,7,30,9,9,2.0,M2020-01-05D,Race(4),,
1,3,2,5,10,1,2,12,15,2,4,4,10,6,8,21,35,15,15,0.0,M2020-01-05D,Race(4),,
8,0,2,0,2,0,0,0,0,0,0,0,0,0,2,0,2,61,61,0.0,M2020-01-05D,Race(4),,
7,0,0,9,9,0,2,1,3,0,2,1,3,0,4,11,15,9,9,1.0,M2020-01-05D,Race(4),,
6,0,0,0,0,0,0,0,0,0,0,0,0,0,0,0,0,101,101,0.0,M2020-01-05D,Race(4),,
4,3,0,0,3,0,0,0,0,0,1,0,1,3,1,0,4,21,21,0.0,M2020-01-05D,Race(4),,
3,6,5,6,17,10,13,4,27,10,5,6,21,26,23,16,65,4.2,4.5,3.0,M2020-01-05D,Race(4),,
2,7,7,5,19,17,6,5,28,11,6,4,21,35,19,14,68,3.2,3.2,0.0,M2020-01-05D,Race(4),,
5,5,6,2,13,0,2,3,5,1,0,1,2,6,8,6,20,8,8,0.0,M2020-01-05D,Race(4),,
14,0,0,0,0,0,0,0,0,0,0,0,0,0,0,0,0,101,101,0.0,M2020-01-05D,Race(4),,
12,0,0,0,0,0,1,0,1,0,2,1,3,0,3,1,4,14,14,0.0,M2020-01-05D,Race(4),,
11,0,0,0,0,0,0,0,0,0,0,2,2,0,0,2,2,18,18,0.0,M2020-01-05D,Race(4),,
13,0,0,0,0,0,0,0,0,0,0,0,0,0,0,0,0,61,61,0.0,M2020-01-05D,Race(4),,
11,0,0,0,0,0,0,1,1,0,0,2,2,0,0,3,3,51,41,0.0,M2020-01-05D,Race(5),,
9,3,5,4,12,0,2,1,3,1,4,1,6,4,11,6,21,13,12,0.0,M2020-01-05D,Race(5),,
7,0,0,0,0,0,0,0,0,0,0,1,1,0,0,1,1,101,101,0.0,M2020-01-05D,Race(5),,
12,0,0,0,0,0,0,0,0,0,0,0,0,0,0,0,0,71,67,0.0,M2020-01-05D,Race(5),,
6,0,0,6,6,2,0,3,5,1,0,2,3,3,0,11,14,15,14,0.0,M2020-01-05D,Race(5),,
3,6,2,8,16,3,4,13,20,3,4,8,15,12,10,29,51,5.5,5,3.0,M2020-01-05D,Race(5),,
4,0,0,0,0,0,0,0,0,0,1,0,1,0,1,0,1,21,19,0.0,M2020-01-05D,Race(5),,
1,15,10,0,25,22,6,2,30,18,6,1,25,55,22,3,80,1.75,1.85,1.0,M2020-01-05D,Race(5),,
2,2,8,10,20,1,16,7,24,3,7,8,18,6,31,25,62,14,13,2.0,M2020-01-05D,Race(5),,
10,0,0,0,0,0,0,1,1,0,1,0,1,0,1,1,2,20,19,0.0,M2020-01-05D,Race(5),,
5,2,5,2,9,2,2,2,6,0,3,3,6,4,10,7,21,12,11,0.0,M2020-01-05D,Race(5),,
8,2,0,0,2,0,0,0,0,0,0,0,0,2,0,0,2,14,16,0.0,M2020-01-05D,Race(5),,
4,0,2,0,2,1,1,0,2,2,0,0,2,3,3,0,6,14,14,0.0,M2020-01-05D,Race(6),,
14,0,0,0,0,0,0,0,0,0,0,0,0,0,0,0,0,61,61,0.0,M2020-01-05D,Race(6),,
13,0,0,0,0,0,0,0,0,0,0,0,0,0,0,0,0,81,81,0.0,M2020-01-05D,Race(6),,
12,3,5,4,12,1,4,4,9,3,3,3,9,7,12,11,30,4,4,1.0,M2020-01-05D,Race(6),,
5,5,0,13,18,0,2,12,14,0,3,8,11,5,5,33,43,7,7,3.0,M2020-01-05D,Race(6),,
11,0,0,0,0,0,0,0,0,0,0,0,0,0,0,0,0,101,101,0.0,M2020-01-05D,Race(6),,
10,0,3,0,3,0,1,0,1,0,1,0,1,0,5,0,5,21,21,0.0,M2020-01-05D,Race(6),,
6,0,0,0,0,0,0,0,0,0,2,1,3,0,2,1,3,41,41,0.0,M2020-01-05D,Race(6),,
9,0,0,0,0,0,0,0,0,0,0,1,1,0,0,1,1,51,51,0.0,M2020-01-05D,Race(6),,
8,3,3,5,11,1,1,2,4,0,1,3,4,4,5,10,19,11,11,0.0,M2020-01-05D,Race(6),,
3,7,7,3,17,4,13,7,24,8,6,4,18,19,26,14,59,4.6,4.6,0.0,M2020-01-05D,Race(6),,
2,12,8,5,25,21,6,2,29,12,7,3,22,45,21,10,76,4,4,2.0,M2020-01-05D,Race(6),,
1,0,2,0,2,0,2,3,5,0,3,3,6,0,7,6,13,16,16,0.0,M2020-01-05D,Race(6),,
7,0,0,0,0,2,0,0,2,1,0,0,1,3,0,0,3,16,16,0.0,M2020-01-05D,Race(6),,
7,0,0,0,0,0,0,0,0,0,0,2,2,0,0,2,2,17,17,0.0,M2020-01-05D,Race(7),,
6,3,4,0,7,0,4,2,6,0,4,0,4,3,12,2,17,17,17,0.0,M2020-01-05D,Race(7),,
4,15,2,10,27,26,3,1,30,17,5,3,25,58,10,14,82,2.2,2.2,0.0,M2020-01-05D,Race(7),,
8,0,0,0,0,0,0,0,0,0,0,0,0,0,0,0,0,71,67,0.0,M2020-01-05D,Race(7),,
9,0,8,6,14,0,13,8,21,3,7,11,21,3,28,25,56,7,7,0.0,M2020-01-05D,Race(7),,
10,0,3,0,3,1,2,2,5,0,5,2,7,1,10,4,15,11,11,2.0,M2020-01-05D,Race(7),,
5,0,0,0,0,0,1,0,1,0,0,0,0,0,1,0,1,51,51,0.0,M2020-01-05D,Race(7),,
12,2,0,0,2,0,0,0,0,0,0,0,0,2,0,0,2,81,81,0.0,M2020-01-05D,Race(7),,
11,0,0,0,0,0,0,0,0,0,0,0,0,0,0,0,0,34,34,0.0,M2020-01-05D,Race(7),,
1,7,8,7,22,2,5,11,18,4,2,4,10,13,15,22,50,5.5,5.5,0.0,M2020-01-05D,Race(7),,
2,0,0,5,5,1,0,1,2,2,0,2,4,3,0,8,11,17,17,1.0,M2020-01-05D,Race(7),,
3,3,5,2,10,0,2,5,7,0,3,2,5,3,10,9,22,6.5,6.5,3.0,M2020-01-05D,Race(7),,
6,4,0,11,15,1,5,17,23,1,6,12,19,6,11,40,57,3.6,3.6,2.0,M2020-01-05D,Race(8),,
7,0,2,0,2,0,0,1,1,0,0,1,1,0,2,2,4,26,26,0.0,M2020-01-05D,Race(8),,
8,0,0,0,0,0,0,1,1,1,0,1,2,1,0,2,3,17,17,3.0,M2020-01-05D,Race(8),,
13,0,0,0,0,0,0,0,0,0,0,0,0,0,0,0,0,61,61,0.0,M2020-01-05D,Race(8),,
12,0,0,0,0,0,0,0,0,0,0,0,0,0,0,0,0,81,81,0.0,M2020-01-05D,Race(8),,
4,0,2,5,7,2,0,0,2,2,1,2,5,4,3,7,14,16,16,0.0,M2020-01-05D,Race(8),,
10,2,2,3,7,0,1,0,1,0,0,1,1,2,3,4,9,13,13,0.0,M2020-01-05D,Race(8),,
1,15,4,9,28,5,18,6,29,8,9,5,22,28,31,20,79,3,3,0.0,M2020-01-05D,Race(8),,
2,5,3,0,8,3,1,2,6,2,3,1,6,10,7,3,20,15,15,1.0,M2020-01-05D,Race(8),,
3,4,17,2,23,18,5,3,26,11,7,3,21,33,29,8,70,4,4,0.0,M2020-01-05D,Race(8),,
5,0,0,0,0,0,0,0,0,0,0,0,0,0,0,0,0,41,41,0.0,M2020-01-05D,Race(8),,
9,0,0,0,0,0,0,0,0,0,0,0,0,0,0,0,0,81,81,0.0,M2020-01-05D,Race(8),,
11,0,0,0,0,1,0,0,1,1,0,0,1,2,0,0,2,21,21,0.0,M2020-01-05D,Race(8),,
7,0,0,0,0,0,0,0,0,0,0,1,1,0,0,1,1,51,51,0.0,M2020-01-05D,Race(9),,
3,17,2,4,23,21,1,7,29,13,2,7,22,51,5,18,74,2.5,2.6,1.0,M2020-01-05D,Race(9),,
14,2,2,5,9,3,4,12,19,6,3,4,13,11,9,21,41,6,6,2.0,M2020-01-05D,Race(9),,
13,0,0,0,0,0,0,0,0,0,0,0,0,0,0,0,0,81,81,0.0,M2020-01-05D,Race(9),,
12,0,2,0,2,0,1,2,3,0,2,2,4,0,5,4,9,14,15,0.0,M2020-01-05D,Race(9),,
10,0,0,0,0,1,0,1,2,1,0,2,3,2,0,3,5,19,19,0.0,M2020-01-05D,Race(9),,
9,4,0,0,4,1,0,1,2,2,1,3,6,7,1,4,12,16,16,0.0,M2020-01-05D,Race(9),,
2,0,5,2,7,0,0,0,0,0,1,0,1,0,6,2,8,31,31,0.0,M2020-01-05D,Race(9),,
8,3,0,0,3,0,1,0,1,0,1,0,1,3,2,0,5,34,34,3.0,M2020-01-05D,Race(9),,
6,0,8,2,10,0,2,1,3,0,2,1,3,0,12,4,16,10,10,0.0,M2020-01-05D,Race(9),,
4,2,9,9,20,0,18,3,21,2,10,1,13,4,37,13,54,5,5,0.0,M2020-01-05D,Race(9),,
1,0,0,0,0,0,0,0,0,0,0,1,1,0,0,1,1,26,26,0.0,M2020-01-05D,Race(9),,
11,0,0,5,5,2,2,0,4,2,2,1,5,4,4,6,14,21,21,0.0,M2020-01-05D,Race(9),,
5,2,2,3,7,2,1,3,6,0,2,3,5,4,5,9,18,15,15,0.0,M2020-01-05D,Race(9),,
2,4,0,0,4,0,1,1,2,0,1,2,3,4,2,3,9,26,26,0.0,M2020-01-08D,Race(1),,
12,0,0,0,0,0,0,0,0,0,0,0,0,0,0,0,0,41,41,0.0,M2020-01-08D,Race(1),,
11,6,15,5,26,15,19,1,35,7,7,3,17,28,41,9,78,3.4,3.4,2.0,M2020-01-08D,Race(1),,
10,0,0,0,0,0,0,1,1,0,1,0,1,0,1,1,2,16,16,0.0,M2020-01-08D,Race(1),,
9,0,0,0,0,0,0,0,0,0,0,2,2,0,0,2,2,15,15,3.0,M2020-01-08D,Race(1),,
8,0,0,0,0,0,0,0,0,0,0,0,0,0,0,0,0,126,126,0.0,M2020-01-08D,Race(1),,
7,0,7,9,16,0,1,6,7,2,3,4,9,2,11,19,32,8,8,1.0,M2020-01-08D,Race(1),,
6,18,6,4,28,13,7,2,22,13,8,3,24,44,21,9,74,3,3,0.0,M2020-01-08D,Race(1),,
5,0,0,0,0,0,0,0,0,0,0,0,0,0,0,0,0,34,34,0.0,M2020-01-08D,Race(1),,
3,0,2,0,2,1,2,8,11,3,4,1,8,4,8,9,21,26,26,0.0,M2020-01-08D,Race(1),,
1,2,0,12,14,1,1,11,13,1,2,11,14,4,3,34,41,5.5,5.5,0.0,M2020-01-08D,Race(1),,
4,0,0,0,0,0,0,0,0,0,0,0,0,0,0,0,0,13,13,0.0,M2020-01-08D,Race(1),,
11,0,0,5,5,0,1,4,5,0,1,3,4,0,2,12,14,12,12,3.0,M2020-01-08D,Race(2),,
5,0,0,0,0,0,0,0,0,2,0,0,2,2,0,0,2,41,41,0.0,M2020-01-08D,Race(2),,
4,4,5,5,14,0,10,1,11,0,2,1,3,4,17,7,28,8.5,8.5,0.0,M2020-01-08D,Race(2),,
3,3,0,0,3,0,0,0,0,0,0,0,0,3,0,0,3,15,15,0.0,M2020-01-08D,Race(2),,
2,7,6,7,20,13,11,3,27,8,8,5,21,28,25,15,68,3.5,3.5,0.0,M2020-01-08D,Race(2),,
1,14,11,3,28,16,2,4,22,12,5,5,22,42,18,12,72,3.6,3.6,0.0,M2020-01-08D,Race(2),,
8,0,0,0,0,0,0,0,0,0,0,0,0,0,0,0,0,101,101,0.0,M2020-01-08D,Race(2),,
10,0,0,0,0,0,1,1,2,0,2,1,3,0,3,2,5,21,21,2.0,M2020-01-08D,Race(2),,
6,0,0,3,3,0,2,1,3,1,4,3,8,1,6,7,14,8,8,1.0,M2020-01-08D,Race(2),,
12,0,2,2,4,0,0,1,1,0,0,2,2,0,2,5,7,26,26,0.0,M2020-01-08D,Race(2),,
9,2,6,5,13,1,3,15,19,3,4,5,12,6,13,25,44,6.5,6.5,0.0,M2020-01-08D,Race(2),,
7,0,0,0,0,0,0,0,0,0,0,1,1,0,0,1,1,21,21,0.0,M2020-01-08D,Race(2),,
9,3,0,4,7,0,0,1,1,0,1,1,2,3,1,6,10,10,10,0.0,M2020-01-08D,Race(3),,
1,10,10,5,25,7,9,10,26,9,8,2,19,26,27,17,70,4.4,4.5,0.0,M2020-01-08D,Race(3),,
2,11,10,2,23,20,6,2,28,9,6,6,21,40,22,10,72,3.8,3.8,2.0,M2020-01-08D,Race(3),,
8,0,2,0,2,0,2,6,8,0,2,7,9,0,6,13,19,9,9,0.0,M2020-01-08D,Race(3),,
7,0,0,0,0,0,0,0,0,0,0,0,0,0,0,0,0,31,31,0.0,M2020-01-08D,Race(3),,
3,0,2,13,15,0,10,5,15,1,3,3,7,1,15,21,37,11,11,3.0,M2020-01-08D,Race(3),,
12,0,0,0,0,0,0,0,0,0,2,1,3,0,2,1,3,31,31,0.0,M2020-01-08D,Race(3),,
11,6,0,6,12,1,2,2,5,4,1,1,6,11,3,9,23,6,6,1.0,M2020-01-08D,Race(3),,
4,0,3,0,3,0,0,1,1,0,0,1,1,0,3,2,5,7,7,0.0,M2020-01-08D,Race(3),,
5,0,0,0,0,0,0,0,0,0,0,0,0,0,0,0,0,101,101,0.0,M2020-01-08D,Race(3),,
6,0,0,0,0,0,0,0,0,0,2,0,2,0,2,0,2,61,61,0.0,M2020-01-08D,Race(3),,
10,0,3,0,3,2,1,3,6,3,1,4,8,5,5,7,17,11,11,0.0,M2020-01-08D,Race(3),,
6,0,0,3,3,0,0,0,0,0,0,0,0,0,0,3,3,71,67,0.0,M2020-01-08D,Race(4),,
5,17,11,2,30,13,5,3,21,12,11,2,25,42,27,7,76,2.9,3.5,1.0,M2020-01-08D,Race(4),,
4,0,3,0,3,2,1,1,4,4,0,2,6,6,4,3,13,16,16,3.0,M2020-01-08D,Race(4),,
7,11,10,2,23,14,9,4,27,7,6,10,23,32,25,16,73,2.65,2.6,0.0,M2020-01-08D,Race(4),,
3,0,0,13,13,0,1,0,1,1,0,3,4,1,1,16,18,7.5,7,0.0,M2020-01-08D,Race(4),,
1,0,2,3,5,0,11,5,16,1,5,2,8,1,18,10,29,11,10,2.0,M2020-01-08D,Race(4),,
12,0,2,3,5,0,0,1,1,0,0,0,0,0,2,4,6,8.5,8.5,0.0,M2020-01-08D,Race(4),,
2,2,2,2,6,1,2,4,7,1,2,3,6,4,6,9,19,11,11,0.0,M2020-01-08D,Race(4),,
10,0,0,2,2,0,0,1,1,0,0,0,0,0,0,3,3,71,67,0.0,M2020-01-08D,Race(4),,
11,0,0,0,0,0,1,11,12,0,0,2,2,0,1,13,14,23,21,0.0,M2020-01-08D,Race(4),,
8,0,0,0,0,0,0,0,0,0,0,0,0,0,0,0,0,101,101,0.0,M2020-01-08D,Race(4),,
9,0,0,0,0,0,0,0,0,0,2,2,4,0,2,2,4,126,101,0.0,M2020-01-08D,Race(4),,
12,0,0,3,3,0,2,1,3,0,4,2,6,0,6,6,12,15,15,2.0,M2020-01-08D,Race(5),,
6,0,0,0,0,0,0,1,1,1,0,0,1,1,0,1,2,26,26,0.0,M2020-01-08D,Race(5),,
4,0,0,0,0,0,0,0,0,0,0,0,0,0,0,0,0,41,41,0.0,M2020-01-08D,Race(5),,
3,11,11,2,24,17,11,1,29,12,9,1,22,40,31,4,75,3,3,1.0,M2020-01-08D,Race(5),,
11,0,0,0,0,0,0,0,0,0,0,0,0,0,0,0,0,81,81,0.0,M2020-01-08D,Race(5),,
5,3,6,7,16,0,3,6,9,0,6,4,10,3,15,17,35,7,7,3.0,M2020-01-08D,Race(5),,
9,0,0,0,0,0,0,0,0,0,0,1,1,0,0,1,1,26,26,0.0,M2020-01-08D,Race(5),,
8,9,0,10,19,2,4,12,18,6,5,7,18,17,9,29,55,3.1,3.1,0.0,M2020-01-08D,Race(5),,
7,0,0,0,0,1,0,0,1,0,0,0,0,1,0,0,1,21,21,0.0,M2020-01-08D,Race(5),,
1,5,2,2,9,0,3,5,8,0,1,4,5,5,6,11,22,14,14,0.0,M2020-01-08D,Race(5),,
2,2,11,6,19,10,6,4,20,7,1,7,15,19,18,17,54,7,7,0.0,M2020-01-08D,Race(5),,
10,0,0,0,0,0,1,0,1,0,0,0,0,0,1,0,1,26,26,0.0,M2020-01-08D,Race(5),,
10,0,0,0,0,0,0,0,0,0,0,0,0,0,0,0,0,0,0,0.0,M2020-01-08D,Race(6),,
7,0,0,0,0,0,0,0,0,0,1,0,1,0,1,0,1,34,34,0.0,M2020-01-08D,Race(6),,
6,2,3,6,11,1,10,6,17,2,3,7,12,5,16,19,40,5.5,5.5,2.0,M2020-01-08D,Race(6),,
5,7,10,2,19,3,6,4,13,2,8,5,15,12,24,11,47,3.8,3.8,3.0,M2020-01-08D,Race(6),,
3,0,0,0,0,1,0,2,3,4,0,2,6,5,0,4,9,12,12,0.0,M2020-01-08D,Race(6),,
2,0,6,2,8,10,7,3,20,6,4,0,10,16,17,5,38,4.6,4.6,0.0,M2020-01-08D,Race(6),,
1,9,5,10,24,9,6,3,18,7,7,3,17,25,18,16,59,4.6,4.6,0.0,M2020-01-08D,Race(6),,
9,0,6,0,6,0,1,0,1,0,0,0,0,0,7,0,7,26,26,0.0,M2020-01-08D,Race(6),,
11,0,0,0,0,0,0,0,0,0,0,0,0,0,0,0,0,0,0,0.0,M2020-01-08D,Race(6),,
4,9,0,8,17,4,0,10,14,3,3,3,9,16,3,21,40,9.5,9.5,0.0,M2020-01-08D,Race(6),,
12,0,0,0,0,0,0,0,0,0,0,0,0,0,0,0,0,0,0,0.0,M2020-01-08D,Race(6),,
8,3,0,2,5,2,0,2,4,2,0,6,8,7,0,10,17,7,7,1.0,M2020-01-08D,Race(6),,
2,10,0,0,10,4,4,9,17,1,6,8,15,15,10,17,42,5,5,0.0,M2020-01-08D,Race(7),,
8,0,0,3,3,0,2,0,2,0,0,2,2,0,2,5,7,21,21,0.0,M2020-01-08D,Race(7),,
1,0,13,3,16,5,9,5,19,7,3,4,14,12,25,12,49,7,7,0.0,M2020-01-08D,Race(7),,
10,0,0,0,0,0,0,0,0,0,0,0,0,0,0,0,0,41,41,0.0,M2020-01-08D,Race(7),,
11,0,0,2,2,1,1,2,4,2,1,2,5,3,2,6,11,12,12,0.0,M2020-01-08D,Race(7),,
12,0,0,0,0,0,0,0,0,0,0,0,0,0,0,0,0,17,17,0.0,M2020-01-08D,Race(7),,
7,0,0,15,15,3,0,0,3,2,1,2,5,5,1,17,23,5.5,5.5,0.0,M2020-01-08D,Race(7),,
9,0,2,0,2,0,1,0,1,0,0,0,0,0,3,0,3,21,21,0.0,M2020-01-08D,Race(7),,
6,2,12,5,19,3,6,7,16,3,9,5,17,8,27,17,52,6,6,3.0,M2020-01-08D,Race(7),,
5,2,3,0,5,0,1,2,3,0,1,3,4,2,5,5,12,13,13,2.0,M2020-01-08D,Race(7),,
4,16,0,2,18,14,6,5,25,9,5,0,14,39,11,7,57,4.4,4.4,1.0,M2020-01-08D,Race(7),,
3,0,0,0,0,0,0,0,0,2,0,0,2,2,0,0,2,51,51,0.0,M2020-01-08D,Race(7),,
6,2,8,2,12,12,3,10,25,13,4,1,18,27,15,13,55,5.5,5.5,0.0,M2020-01-08D,Race(8),,
10,0,5,0,5,0,0,1,1,0,0,0,0,0,5,1,6,14,14,0.0,M2020-01-08D,Race(8),,
4,14,0,7,21,2,12,5,19,3,5,8,16,19,17,20,56,6.5,6.5,3.0,M2020-01-08D,Race(8),,
11,3,0,2,5,1,1,1,3,3,1,1,5,7,2,4,13,13,13,0.0,M2020-01-08D,Race(8),,
8,0,0,0,0,0,0,0,0,0,0,0,0,0,0,0,0,61,61,0.0,M2020-01-08D,Race(8),,
9,2,0,3,5,0,1,2,3,1,0,3,4,3,1,8,12,6,6,0.0,M2020-01-08D,Race(8),,
7,0,0,0,0,0,0,0,0,0,1,0,1,0,1,0,1,34,34,0.0,M2020-01-08D,Race(8),,
1,2,12,3,17,10,5,4,19,1,9,6,16,13,26,13,52,4,4,1.0,M2020-01-08D,Race(8),,
2,7,5,13,25,5,6,7,18,5,5,7,17,17,16,27,60,4.4,4.4,2.0,M2020-01-08D,Race(8),,
3,0,0,0,0,0,1,0,1,0,0,0,0,0,1,0,1,21,21,0.0,M2020-01-08D,Race(8),,
12,0,0,0,0,0,0,0,0,0,0,0,0,0,0,0,0,51,51,0.0,M2020-01-08D,Race(8),,
5,0,0,0,0,0,1,0,1,0,1,0,1,0,2,0,2,26,26,0.0,M2020-01-08D,Race(8),,
1,2,5,3,10,0,10,2,12,0,0,2,2,2,15,7,24,10,10,0.0,M2020-01-08D,Race(9),,
2,26,4,0,30,17,4,9,30,18,6,1,25,61,14,10,85,2,2,0.0,M2020-01-08D,Race(9),,
3,0,2,0,2,0,0,1,1,0,0,0,0,0,2,1,3,15,15,0.0,M2020-01-08D,Race(9),,
4,2,5,0,7,9,4,6,19,2,5,7,14,13,14,13,40,8,8,3.0,M2020-01-08D,Race(9),,
5,0,0,8,8,1,5,2,8,2,8,4,14,3,13,14,30,12,12,1.0,M2020-01-08D,Race(9),,
7,0,0,2,2,0,0,1,1,0,1,2,3,0,1,5,6,21,21,0.0,M2020-01-08D,Race(9),,
9,0,0,0,0,1,0,0,1,0,0,0,0,1,0,0,1,51,51,0.0,M2020-01-08D,Race(9),,
10,0,11,12,23,2,6,8,16,3,5,8,16,5,22,28,55,5.5,5.5,2.0,M2020-01-08D,Race(9),,
11,0,0,5,5,0,1,0,1,1,1,2,4,1,2,7,10,13,13,0.0,M2020-01-08D,Race(9),,
12,0,0,0,0,0,0,0,0,0,0,0,0,0,0,0,0,81,81,0.0,M2020-01-08D,Race(9),,
8,0,0,0,0,0,0,0,0,0,0,0,0,0,0,0,0,31,31,0.0,M2020-01-08D,Race(9),,
6,0,3,0,3,0,0,1,1,0,0,0,0,0,3,1,4,31,31,0.0,M2020-01-08D,Race(9),,
8,13,5,7,25,9,6,4,19,11,5,5,21,33,16,16,65,3.8,3.8,1.0,M2020-01-15D,Race(1),,
7,5,11,7,23,10,9,6,25,2,9,6,17,17,29,19,65,6,6,0.0,M2020-01-15D,Race(1),,
6,0,0,0,0,0,1,1,2,1,0,1,2,1,1,2,4,17,17,2.0,M2020-01-15D,Race(1),,
5,0,5,3,8,1,1,1,3,1,1,1,3,2,7,5,14,13,13,0.0,M2020-01-15D,Race(1),,
4,3,0,0,3,5,0,9,14,4,0,2,6,12,0,11,23,9.5,9.5,0.0,M2020-01-15D,Race(1),,
3,7,7,3,17,2,2,2,6,1,4,4,9,10,13,9,32,5,5,0.0,M2020-01-15D,Race(1),,
2,0,0,0,0,0,1,0,1,0,0,1,1,0,1,1,2,41,41,0.0,M2020-01-15D,Race(1),,
1,0,0,0,0,0,0,0,0,0,0,0,0,0,0,0,0,51,51,0.0,M2020-01-15D,Race(1),,
11,0,0,3,3,2,9,5,16,3,2,3,8,5,11,11,27,9.5,9.5,0.0,M2020-01-15D,Race(1),,
12,0,0,0,0,0,1,0,1,0,2,0,2,0,3,0,3,26,26,0.0,M2020-01-15D,Race(1),,
10,2,0,0,2,0,0,0,0,0,0,0,0,2,0,0,2,26,26,0.0,M2020-01-15D,Race(1),,
9,0,2,7,9,1,0,2,3,3,3,3,9,4,5,12,21,5.5,5.5,3.0,M2020-01-15D,Race(1),,
10,0,0,0,0,0,0,0,0,0,0,0,0,0,0,0,0,26,26,0.0,M2020-01-15D,Race(2),,
8,5,5,5,15,1,14,10,25,2,8,3,13,8,27,18,53,5,5,0.0,M2020-01-15D,Race(2),,
11,4,5,2,11,9,0,7,16,3,1,9,13,16,6,18,40,6.5,6.5,2.0,M2020-01-15D,Race(2),,
3,3,3,5,11,0,1,4,5,0,2,5,7,3,6,14,23,8.5,8.5,0.0,M2020-01-15D,Race(2),,
4,2,0,0,2,0,0,0,0,0,0,0,0,2,0,0,2,41,41,0.0,M2020-01-15D,Race(2),,
2,3,5,2,10,0,2,3,5,5,4,0,9,8,11,5,24,8.5,8.5,0.0,M2020-01-15D,Race(2),,
5,0,0,0,0,0,0,0,0,0,0,0,0,0,0,0,0,51,51,0.0,M2020-01-15D,Race(2),,
6,0,5,5,10,0,0,1,1,0,0,0,0,0,5,6,11,13,13,3.0,M2020-01-15D,Race(2),,
7,0,0,0,0,2,2,3,7,5,3,4,12,7,5,7,19,9,10,0.0,M2020-01-15D,Race(2),,
9,13,7,2,22,15,10,1,26,11,6,2,19,39,23,5,67,4.8,4.8,0.0,M2020-01-15D,Race(2),,
12,0,0,9,9,1,1,1,3,0,2,3,5,1,3,13,17,4.6,5,1.0,M2020-01-15D,Race(2),,
1,0,0,0,0,0,0,0,0,0,0,0,0,0,0,0,0,51,51,0.0,M2020-01-15D,Race(2),,
8,0,0,3,3,0,0,0,0,0,0,0,0,0,0,3,3,21,21,0.0,M2020-01-15D,Race(3),,
12,3,9,0,12,6,12,6,24,8,7,5,20,17,28,11,56,4.8,4.8,1.0,M2020-01-15D,Race(3),,
11,3,2,0,5,0,0,1,1,3,1,1,5,6,3,2,11,10,10,3.0,M2020-01-15D,Race(3),,
10,4,4,2,10,0,1,1,2,0,0,0,0,4,5,3,12,7.5,7.5,0.0,M2020-01-15D,Race(3),,
7,0,0,0,0,0,1,1,2,0,2,0,2,0,3,1,4,10,10,0.0,M2020-01-15D,Race(3),,
5,14,3,2,19,12,6,6,24,7,6,4,17,33,15,12,60,2.9,2.9,0.0,M2020-01-15D,Race(3),,
1,0,2,0,2,0,1,0,1,0,0,1,1,0,3,1,4,71,67,0.0,M2020-01-15D,Race(3),,
3,0,5,14,19,0,0,1,1,1,2,2,5,1,7,17,25,16,16,0.0,M2020-01-15D,Race(3),,
2,0,0,4,4,2,0,1,3,0,0,2,2,2,0,7,9,13,13,0.0,M2020-01-15D,Race(3),,
9,6,3,2,11,8,8,4,20,3,8,8,19,17,19,14,50,11,11,2.0,M2020-01-15D,Race(3),,
6,0,0,0,0,0,0,0,0,0,0,0,0,0,0,0,0,101,101,0.0,M2020-01-15D,Race(3),,
4,0,2,3,5,2,1,9,12,4,0,3,7,6,3,15,24,11,11,0.0,M2020-01-15D,Race(3),,
1,0,0,0,0,0,0,2,2,0,0,1,1,0,0,3,3,21,21,0.0,M2020-01-15D,Race(4),,
4,3,12,13,28,4,8,6,18,7,6,7,20,14,26,26,66,4.4,4.2,0.0,M2020-01-15D,Race(4),,
12,0,0,0,0,0,0,0,0,0,0,0,0,0,0,0,0,151,151,0.0,M2020-01-15D,Race(4),,
11,6,0,5,11,3,5,10,18,4,6,3,13,13,11,18,42,6.5,7,3.0,M2020-01-15D,Race(4),,
10,0,0,0,0,0,0,1,1,0,0,2,2,0,0,3,3,21,23,0.0,M2020-01-15D,Race(4),,
9,5,8,5,18,8,11,3,22,5,8,3,16,18,27,11,56,7,7,0.0,M2020-01-15D,Race(4),,
8,0,2,2,4,0,0,0,0,0,0,0,0,0,2,2,4,14,14,0.0,M2020-01-15D,Race(4),,
6,0,0,0,0,0,0,0,0,0,0,0,0,0,0,0,0,81,81,0.0,M2020-01-15D,Race(4),,
5,3,3,0,6,0,0,0,0,1,0,1,2,4,3,1,8,6,6,1.0,M2020-01-15D,Race(4),,
7,0,0,0,0,0,0,1,1,1,1,2,4,1,1,3,5,15,16,0.0,M2020-01-15D,Race(4),,
3,0,2,0,2,10,0,3,13,2,0,4,6,12,2,7,21,9,9.5,0.0,M2020-01-15D,Race(4),,
2,13,3,5,21,5,6,4,15,6,5,3,14,24,14,12,50,4,4.2,2.0,M2020-01-15D,Race(4),,
10,2,3,0,5,0,0,1,1,0,0,2,2,2,3,3,8,12,10,2.0,M2020-01-15D,Race(5),,
11,0,0,0,0,0,0,0,0,0,0,0,0,0,0,0,0,61,61,0.0,M2020-01-15D,Race(5),,
12,0,0,0,0,0,0,0,0,0,0,0,0,0,0,0,0,0,0,0.0,M2020-01-15D,Race(5),,
6,3,3,4,10,9,5,9,23,3,5,4,12,15,13,17,45,7,6.5,0.0,M2020-01-15D,Race(5),,
7,18,5,5,28,17,10,2,29,18,5,1,24,53,20,8,81,2.15,2.25,3.0,M2020-01-15D,Race(5),,
8,0,0,0,0,0,0,0,0,0,0,0,0,0,0,0,0,61,67,0.0,M2020-01-15D,Race(5),,
5,5,6,5,16,0,3,4,7,2,3,7,12,7,12,16,35,7.5,6.5,1.0,M2020-01-15D,Race(5),,
4,0,0,0,0,0,0,0,0,0,1,0,1,0,1,0,1,23,26,0.0,M2020-01-15D,Race(5),,
1,0,0,2,2,1,2,0,3,0,3,0,3,1,5,2,8,23,21,0.0,M2020-01-15D,Race(5),,
2,0,8,3,11,2,4,10,16,1,4,6,11,3,16,19,38,9,8.5,0.0,M2020-01-15D,Race(5),,
3,0,5,5,10,1,4,3,8,2,2,6,10,3,11,14,28,8.5,10,0.0,M2020-01-15D,Race(5),,
9,2,0,6,8,0,3,0,3,0,3,0,3,2,6,6,14,13,11,0.0,M2020-01-15D,Race(5),,
11,0,0,0,0,0,1,1,2,0,1,3,4,0,2,4,6,41,41,0.0,M2020-01-15D,Race(6),,
10,0,0,2,2,0,0,3,3,1,2,4,7,1,2,9,12,11,11,0.0,M2020-01-15D,Race(6),,
8,0,0,5,5,0,0,1,1,0,0,0,0,0,0,6,6,12,12,0.0,M2020-01-15D,Race(6),,
7,3,3,3,9,0,0,2,2,0,0,1,1,3,3,6,12,12,12,0.0,M2020-01-15D,Race(6),,
6,2,2,6,10,0,0,2,2,0,1,2,3,2,3,10,15,9,9,0.0,M2020-01-15D,Race(6),,
5,16,9,2,27,10,15,3,28,6,14,2,22,32,38,7,77,3.8,3.8,2.0,M2020-01-15D,Race(6),,
4,9,14,3,26,19,10,0,29,18,4,1,23,46,28,4,78,3.5,3.5,1.0,M2020-01-15D,Race(6),,
3,0,0,0,0,1,0,0,1,1,1,0,2,2,1,0,3,13,13,0.0,M2020-01-15D,Race(6),,
2,0,2,9,11,0,2,8,10,0,2,8,10,0,6,25,31,7.5,7.5,0.0,M2020-01-15D,Race(6),,
12,0,0,0,0,0,0,0,0,0,0,0,0,0,0,0,0,81,81,0.0,M2020-01-15D,Race(6),,
1,0,0,0,0,0,2,10,12,0,1,5,6,0,3,15,18,11,11,3.0,M2020-01-15D,Race(6),,
9,0,0,0,0,0,0,0,0,0,0,0,0,0,0,0,0,41,41,0.0,M2020-01-15D,Race(6),,
4,0,0,0,0,0,0,0,0,0,0,0,0,0,0,0,0,71,101,0.0,M2020-01-15D,Race(7),,
1,2,0,0,2,0,0,1,1,0,1,1,2,2,1,2,5,34,34,2.0,M2020-01-15D,Race(7),,
10,0,5,13,18,9,0,4,13,1,0,6,7,10,5,23,38,12,11,0.0,M2020-01-15D,Race(7),,
12,0,0,0,0,0,0,0,0,0,0,1,1,0,0,1,1,31,31,0.0,M2020-01-15D,Race(7),,
2,5,15,6,26,0,15,14,29,2,14,6,22,7,44,26,77,3.9,4,0.0,M2020-01-15D,Race(7),,
11,3,0,2,5,0,1,1,2,0,0,0,0,3,1,3,7,26,26,0.0,M2020-01-15D,Race(7),,
5,20,6,4,30,21,9,0,30,21,3,1,25,62,18,5,85,1.75,1.75,3.0,M2020-01-15D,Race(7),,
6,0,0,0,0,0,0,0,0,0,0,0,0,0,0,0,0,41,41,0.0,M2020-01-15D,Race(7),,
7,0,4,5,9,0,2,1,3,1,6,2,9,1,12,8,21,8.5,8,1.0,M2020-01-15D,Race(7),,
8,0,0,0,0,0,0,0,0,0,0,0,0,0,0,0,0,26,26,0.0,M2020-01-15D,Race(7),,
9,0,0,0,0,0,0,1,1,0,0,0,0,0,0,1,1,15,15,0.0,M2020-01-15D,Race(7),,
3,0,0,0,0,0,3,9,12,0,0,0,0,0,3,9,12,0,0,0.0,M2020-01-15D,Race(7),,
6,16,6,8,30,15,10,3,28,15,3,3,21,46,19,14,79,3,3,0.0,M2020-01-15D,Race(8),,
2,0,0,0,0,0,1,0,1,0,0,0,0,0,1,0,1,26,26,0.0,M2020-01-15D,Race(8),,
3,7,8,8,23,10,8,5,23,4,8,3,15,21,24,16,61,6,6,3.0,M2020-01-15D,Race(8),,
4,0,0,0,0,0,0,0,0,0,0,0,0,0,0,0,0,71,67,0.0,M2020-01-15D,Race(8),,
5,2,0,0,2,0,2,0,2,1,5,2,8,3,7,2,12,16,16,0.0,M2020-01-15D,Race(8),,
7,0,0,3,3,0,4,1,5,1,5,2,8,1,9,6,16,26,26,0.0,M2020-01-15D,Race(8),,
9,0,0,0,0,0,0,0,0,0,0,0,0,0,0,0,0,51,51,0.0,M2020-01-15D,Race(8),,
1,0,3,3,6,2,0,10,12,2,1,3,6,4,4,16,24,8,8,0.0,M2020-01-15D,Race(8),,
10,0,0,0,0,0,0,0,0,0,0,0,0,0,0,0,0,41,41,0.0,M2020-01-15D,Race(8),,
11,0,4,5,9,0,3,3,6,3,3,5,11,3,10,13,26,5.5,5.5,2.0,M2020-01-15D,Race(8),,
12,0,0,0,0,0,0,0,0,0,0,0,0,0,0,0,0,41,41,0.0,M2020-01-15D,Race(8),,
8,5,9,3,17,3,2,8,13,0,1,8,9,8,12,19,39,4,4,1.0,M2020-01-15D,Race(8),,
7,0,0,0,0,0,0,0,0,0,0,0,0,0,0,0,0,81,81,0.0,M2020-01-15D,Race(9),,
8,0,0,0,0,0,0,0,0,0,0,0,0,0,0,0,0,81,81,0.0,M2020-01-15D,Race(9),,
9,2,0,0,2,1,0,0,1,1,0,0,1,4,0,0,4,8.5,11,0.0,M2020-01-15D,Race(9),,
10,0,0,3,3,0,0,1,1,1,1,3,5,1,1,7,9,12,14,0.0,M2020-01-15D,Race(9),,
11,0,0,0,0,0,0,0,0,0,0,0,0,0,0,0,0,81,81,0.0,M2020-01-15D,Race(9),,
5,0,0,0,0,0,0,0,0,0,0,0,0,0,0,0,0,126,126,0.0,M2020-01-15D,Race(9),,
4,0,5,0,5,0,0,1,1,0,1,3,4,0,6,4,10,18,17,0.0,M2020-01-15D,Race(9),,
3,3,8,16,27,10,6,13,29,4,8,10,22,17,22,39,78,3.2,3.2,3.0,M2020-01-15D,Race(9),,
2,22,5,0,27,17,12,1,30,18,6,2,26,57,23,3,83,2.05,2,1.0,M2020-01-15D,Race(9),,
1,3,12,11,26,2,12,14,28,2,9,8,19,7,33,33,73,6,6,2.0,M2020-01-15D,Race(9),,
12,0,0,0,0,0,0,0,0,0,0,0,0,0,0,0,0,101,101,0.0,M2020-01-15D,Race(9),,
6,0,0,0,0,0,0,0,0,0,1,0,1,0,1,0,1,41,41,0.0,M2020-01-15D,Race(9),,
6,5,15,2,22,22,4,0,26,13,6,1,20,40,25,3,68,3.5,3.5,0.0,M2020-01-19D,Race(1),,
10,0,2,2,4,0,1,1,2,0,0,2,2,0,3,5,8,34,34,0.0,M2020-01-19D,Race(1),,
9,0,2,0,2,0,0,1,1,0,1,0,1,0,3,1,4,21,21,2.0,M2020-01-19D,Race(1),,
8,0,0,0,0,1,1,2,4,2,1,5,8,3,2,7,12,15,15,0.0,M2020-01-19D,Race(1),,
7,2,5,0,7,0,1,1,2,0,0,2,2,2,6,3,11,17,17,0.0,M2020-01-19D,Race(1),,
1,3,3,5,11,5,13,1,19,2,5,2,9,10,21,8,39,8.5,9,1.0,M2020-01-19D,Race(1),,
2,0,0,2,2,0,1,1,2,0,2,1,3,0,3,4,7,13,13,0.0,M2020-01-19D,Race(1),,
3,0,0,3,3,0,0,1,1,1,0,0,1,1,0,4,5,41,41,0.0,M2020-01-19D,Race(1),,
4,11,3,10,24,2,5,16,23,6,5,5,16,19,13,31,63,2.35,2.35,3.0,M2020-01-19D,Race(1),,
5,9,0,6,15,0,4,6,10,2,6,8,16,11,10,20,41,6.5,6.5,0.0,M2020-01-19D,Race(1),,
9,0,0,0,0,0,0,0,0,0,0,1,1,0,0,1,1,51,46,0.0,M2020-01-19D,Race(10),,
10,0,0,0,0,0,0,0,0,0,0,0,0,0,0,0,0,41,41,0.0,M2020-01-19D,Race(10),,
11,2,2,2,6,0,2,2,4,0,1,5,6,2,5,9,16,12,16,2.0,M2020-01-19D,Race(10),,
12,0,0,0,0,1,0,0,1,1,0,0,1,2,0,0,2,61,41,0.0,M2020-01-19D,Race(10),,
13,0,0,2,2,1,2,1,4,0,0,2,2,1,2,5,8,15,15,0.0,M2020-01-19D,Race(10),,
14,2,5,5,12,1,0,1,2,1,0,1,2,4,5,7,16,7,8.5,0.0,M2020-01-19D,Race(10),,
8,0,4,3,7,0,0,3,3,0,0,3,3,0,4,9,13,9,7.5,0.0,M2020-01-19D,Race(10),,
1,3,8,2,13,2,15,4,21,0,8,3,11,5,31,9,45,9,9.5,0.0,M2020-01-19D,Race(10),,
2,17,6,0,23,21,3,5,29,13,5,5,23,51,14,10,75,2.9,3,3.0,M2020-01-19D,Race(10),,
3,0,0,0,0,0,0,0,0,0,0,0,0,0,0,0,0,91,91,0.0,M2020-01-19D,Race(10),,
4,0,0,6,6,2,3,2,7,5,4,0,9,7,7,8,22,7.5,8.5,1.0,M2020-01-19D,Race(10),,
5,0,0,0,0,0,0,0,0,0,0,0,0,0,0,0,0,91,91,0.0,M2020-01-19D,Race(10),,
6,6,0,3,9,1,1,0,2,3,2,1,6,10,3,4,17,12,16,0.0,M2020-01-19D,Race(10),,
7,0,5,7,12,1,4,12,17,3,6,5,14,4,15,24,43,6.5,5,0.0,M2020-01-19D,Race(10),,
13,0,3,0,3,1,0,0,1,2,0,1,3,3,3,1,7,19,19,0.0,M2020-01-19D,Race(2),,
5,6,0,3,9,2,0,7,9,5,2,5,12,13,2,15,30,9,9,0.0,M2020-01-19D,Race(2),,
4,0,2,13,15,0,8,13,21,2,7,2,11,2,17,28,47,4.4,4.4,3.0,M2020-01-19D,Race(2),,
3,13,13,2,28,18,6,4,28,8,7,5,20,39,26,11,76,3.8,3.8,2.0,M2020-01-19D,Race(2),,
12,3,0,0,3,0,0,0,0,0,0,1,1,3,0,1,4,13,13,0.0,M2020-01-19D,Race(2),,
1,0,0,0,0,1,0,0,1,0,0,0,0,1,0,0,1,19,19,0.0,M2020-01-19D,Race(2),,
6,0,2,3,5,0,1,3,4,0,2,7,9,0,5,13,18,15,15,1.0,M2020-01-19D,Race(2),,
14,0,0,0,0,0,0,0,0,0,0,0,0,0,0,0,0,151,201,0.0,M2020-01-19D,Race(2),,
2,0,0,0,0,0,0,0,0,0,0,0,0,0,0,0,0,126,126,0.0,M2020-01-19D,Race(2),,
7,0,0,0,0,0,0,0,0,0,0,0,0,0,0,0,0,71,67,0.0,M2020-01-19D,Race(2),,
11,2,0,7,9,0,0,1,1,0,0,1,1,2,0,9,11,9.5,9.5,0.0,M2020-01-19D,Race(2),,
9,0,0,0,0,0,0,0,0,0,0,0,0,0,0,0,0,71,71,0.0,M2020-01-19D,Race(2),,
10,0,0,0,0,0,0,0,0,0,0,0,0,0,0,0,0,31,31,0.0,M2020-01-19D,Race(2),,
8,6,10,2,18,8,15,2,25,9,8,4,21,23,33,8,64,4,4,0.0,M2020-01-19D,Race(2),,
14,0,0,0,0,0,0,0,0,0,0,0,0,0,0,0,0,151,151,0.0,M2020-01-19D,Race(3),,
13,0,0,0,0,0,0,0,0,0,0,0,0,0,0,0,0,101,101,0.0,M2020-01-19D,Race(3),,
12,0,0,0,0,0,0,0,0,0,0,0,0,0,0,0,0,126,126,0.0,M2020-01-19D,Race(3),,
5,0,0,3,3,0,0,2,2,0,1,2,3,0,1,7,8,21,21,0.0,M2020-01-19D,Race(3),,
4,0,0,0,0,0,0,0,0,1,0,0,1,1,0,0,1,151,201,0.0,M2020-01-19D,Race(3),,
3,20,10,0,30,4,19,5,28,6,12,6,24,30,41,11,82,2.25,2.25,3.0,M2020-01-19D,Race(3),,
2,0,0,0,0,2,1,0,3,0,1,0,1,2,2,0,4,21,21,1.0,M2020-01-19D,Race(3),,
1,10,16,2,28,21,7,2,30,13,9,3,25,44,32,7,83,3.7,3.7,0.0,M2020-01-19D,Race(3),,
9,0,0,3,3,0,0,0,0,0,0,1,1,0,0,4,4,23,23,0.0,M2020-01-19D,Race(3),,
10,0,0,0,0,0,0,0,0,0,0,0,0,0,0,0,0,31,31,0.0,M2020-01-19D,Race(3),,
6,0,0,12,12,2,2,17,21,3,1,7,11,5,3,36,44,9,9,2.0,M2020-01-19D,Race(3),,
7,0,2,0,2,0,0,0,0,0,0,0,0,0,2,0,2,21,21,0.0,M2020-01-19D,Race(3),,
8,0,2,10,12,1,1,4,6,3,2,7,12,4,5,21,30,5.5,5.5,0.0,M2020-01-19D,Race(3),,
11,0,0,0,0,0,0,0,0,0,0,0,0,0,0,0,0,41,41,0.0,M2020-01-19D,Race(3),,
10,0,0,3,3,0,0,0,0,0,1,0,1,0,1,3,4,26,26,0.0,M2020-01-19D,Race(4),,
2,6,5,9,20,6,6,13,25,11,6,4,21,23,17,26,66,5.5,5.5,2.0,M2020-01-19D,Race(4),,
1,6,15,0,21,13,8,5,26,8,7,7,22,27,30,12,69,4.2,4,1.0,M2020-01-19D,Race(4),,
9,0,2,0,2,0,0,1,1,0,0,2,2,0,2,3,5,26,26,0.0,M2020-01-19D,Race(4),,
14,0,0,0,0,0,0,0,0,0,0,0,0,0,0,0,0,61,61,0.0,M2020-01-19D,Race(4),,
13,0,0,0,0,0,0,0,0,0,0,0,0,0,0,0,0,61,61,0.0,M2020-01-19D,Race(4),,
12,6,3,10,19,6,14,5,25,4,10,6,20,16,27,21,64,3.6,3.4,3.0,M2020-01-19D,Race(4),,
3,0,0,0,0,0,0,0,0,1,1,0,2,1,1,0,2,19,19,0.0,M2020-01-19D,Race(4),,
4,7,0,5,12,2,2,4,8,1,1,6,8,10,3,15,28,4.4,5,0.0,M2020-01-19D,Race(4),,
5,0,0,0,0,0,0,0,0,0,0,0,0,0,0,0,0,101,126,0.0,M2020-01-19D,Race(4),,
11,0,3,0,3,0,0,2,2,0,0,0,0,0,3,2,5,20,19,0.0,M2020-01-19D,Race(4),,
7,2,0,3,5,0,0,0,0,0,0,1,1,2,0,4,6,21,21,0.0,M2020-01-19D,Race(4),,
8,3,2,0,5,3,0,0,3,1,0,0,1,7,2,0,9,16,16,0.0,M2020-01-19D,Race(4),,
6,0,0,0,0,0,0,0,0,0,0,0,0,0,0,0,0,51,51,0.0,M2020-01-19D,Race(4),,
1,5,18,3,26,0,27,3,30,2,16,6,24,7,61,12,80,3.6,3.5,2.0,M2020-01-19D,Race(5),,
2,0,2,13,15,0,0,18,18,2,0,6,8,2,2,37,41,31,34,0.0,M2020-01-19D,Race(5),,
3,23,5,2,30,29,1,0,30,20,4,1,25,72,10,3,85,1.95,2,1.0,M2020-01-19D,Race(5),,
4,0,0,3,3,0,0,0,0,0,0,0,0,0,0,3,3,15,17,0.0,M2020-01-19D,Race(5),,
5,2,5,7,14,0,1,1,2,0,5,3,8,2,11,11,24,4.4,4,0.0,M2020-01-19D,Race(5),,
6,0,0,2,2,0,0,0,0,0,0,0,0,0,0,2,2,26,34,0.0,M2020-01-19D,Race(5),,
7,0,0,0,0,1,1,8,10,2,1,10,13,3,2,18,23,9,9,3.0,M2020-01-19D,Race(5),,
3,0,2,3,5,2,0,0,2,2,0,0,2,4,2,3,9,8.5,8.5,0.0,M2020-01-19D,Race(6),,
4,6,6,6,18,5,12,6,23,0,6,4,10,11,24,16,51,4.4,4.4,2.0,M2020-01-19D,Race(6),,
5,0,0,6,6,0,2,2,4,0,1,2,3,0,3,10,13,13,13,0.0,M2020-01-19D,Race(6),,
7,2,0,0,2,0,0,0,0,0,0,2,2,2,0,2,4,17,17,0.0,M2020-01-19D,Race(6),,
6,2,9,0,11,1,2,13,16,2,7,9,18,5,18,22,45,10,10,0.0,M2020-01-19D,Race(6),,
10,0,0,0,0,0,0,1,1,0,0,1,1,0,0,2,2,51,51,0.0,M2020-01-19D,Race(6),,
11,0,0,0,0,0,0,0,0,1,0,1,2,1,0,1,2,51,51,0.0,M2020-01-19D,Race(6),,
12,0,0,0,0,0,0,0,0,0,0,0,0,0,0,0,0,41,41,1.0,M2020-01-19D,Race(6),,
13,2,4,6,12,1,2,3,6,2,2,3,7,5,8,12,25,13,13,0.0,M2020-01-19D,Race(6),,
14,0,0,0,0,0,0,0,0,0,0,0,0,0,0,0,0,41,41,3.0,M2020-01-19D,Race(6),,
2,14,5,4,23,21,6,2,29,19,3,1,23,54,14,7,75,3.1,3.1,0.0,M2020-01-19D,Race(6),,
1,0,0,0,0,0,0,0,0,0,0,0,0,0,0,0,0,101,101,0.0,M2020-01-19D,Race(6),,
9,0,4,3,7,0,2,0,2,0,3,1,4,0,9,4,13,8,8,0.0,M2020-01-19D,Race(6),,
8,4,0,2,6,0,4,3,7,0,4,2,6,4,8,7,19,13,13,0.0,M2020-01-19D,Race(6),,
1,13,15,2,30,25,5,0,30,22,4,0,26,60,24,2,86,2.35,2.2,1.0,M2020-01-19D,Race(7),,
2,14,13,3,30,4,25,1,30,3,22,1,26,21,60,5,86,3,3.1,3.0,M2020-01-19D,Race(7),,
3,3,0,15,18,0,0,19,19,0,0,14,14,3,0,48,51,7,7,0.0,M2020-01-19D,Race(7),,
4,0,2,8,10,0,0,6,6,0,0,8,8,0,2,22,24,7.5,7.5,0.0,M2020-01-19D,Race(7),,
5,0,0,0,0,1,0,3,4,1,0,1,2,2,0,4,6,11,10,0.0,M2020-01-19D,Race(7),,
6,0,0,2,2,0,0,1,1,0,0,1,1,0,0,4,4,13,15,0.0,M2020-01-19D,Race(7),,
7,0,0,0,0,0,0,0,0,0,0,1,1,0,0,1,1,18,17,2.0,M2020-01-19D,Race(7),,
6,7,5,2,14,2,3,14,19,6,2,5,13,15,10,21,46,5.5,5.5,0.0,M2020-01-19D,Race(8),,
7,0,5,2,7,1,3,1,5,0,5,4,9,1,13,7,21,13,13,3.0,M2020-01-19D,Race(8),,
4,0,0,3,3,0,0,0,0,1,0,0,1,1,0,3,4,41,41,0.0,M2020-01-19D,Race(8),,
3,2,2,3,7,0,1,0,1,1,0,0,1,3,3,3,9,9,9,1.0,M2020-01-19D,Race(8),,
2,5,8,0,13,9,0,3,12,5,1,2,8,19,9,5,33,4.4,4.4,2.0,M2020-01-19D,Race(8),,
1,0,0,5,5,3,14,3,20,3,5,2,10,6,19,10,35,11,11,0.0,M2020-01-19D,Race(8),,
9,2,0,0,2,1,0,1,2,0,0,2,2,3,0,3,6,9.5,10,0.0,M2020-01-19D,Race(8),,
10,0,0,0,0,0,0,0,0,0,0,0,0,0,0,0,0,126,126,0.0,M2020-01-19D,Race(8),,
11,6,5,2,13,3,6,5,14,2,9,4,15,11,20,11,42,5.5,5.5,0.0,M2020-01-19D,Race(8),,
8,2,3,0,5,0,0,1,1,1,0,2,3,3,3,3,9,15,15,0.0,M2020-01-19D,Race(8),,
12,0,0,0,0,0,0,0,0,0,0,0,0,0,0,0,0,126,126,0.0,M2020-01-19D,Race(8),,
13,6,0,11,17,8,3,2,13,4,4,4,12,18,7,17,42,7.5,8,0.0,M2020-01-19D,Race(8),,
14,0,0,0,0,0,0,0,0,0,0,1,1,0,0,1,1,34,34,0.0,M2020-01-19D,Race(8),,
5,0,2,2,4,3,0,0,3,3,0,0,3,6,2,2,10,21,21,0.0,M2020-01-19D,Race(8),,
1,0,0,0,0,0,1,2,3,1,0,2,3,1,1,4,6,18,19,0.0,M2020-01-19D,Race(9),,
3,0,0,0,0,0,0,0,0,0,0,0,0,0,0,0,0,101,101,0.0,M2020-01-19D,Race(9),,
4,3,0,5,8,1,1,0,2,2,3,1,6,6,4,6,16,10,11,0.0,M2020-01-19D,Race(9),,
5,2,0,2,4,1,1,1,3,2,1,1,4,5,2,4,11,10,15,0.0,M2020-01-19D,Race(9),,
6,0,0,0,0,0,0,2,2,0,1,0,1,0,1,2,3,10,9.5,0.0,M2020-01-19D,Race(9),,
7,0,0,0,0,0,0,0,0,0,0,0,0,0,0,0,0,41,35,0.0,M2020-01-19D,Race(9),,
9,0,0,0,0,0,0,0,0,0,0,0,0,0,0,0,0,71,91,0.0,M2020-01-19D,Race(9),,
11,2,4,11,17,2,4,14,20,1,5,8,14,5,13,33,51,5.5,5,1.0,M2020-01-19D,Race(9),,
12,0,0,0,0,0,0,0,0,0,0,0,0,0,0,0,0,51,41,0.0,M2020-01-19D,Race(9),,
13,0,2,5,7,1,0,3,4,0,0,3,3,1,2,11,14,9.5,13,0.0,M2020-01-19D,Race(9),,
14,0,0,0,0,0,0,0,0,0,0,0,0,0,0,0,0,91,81,0.0,M2020-01-19D,Race(9),,
8,10,14,0,24,7,19,3,29,8,11,4,23,25,44,7,76,3.3,3.6,2.0,M2020-01-19D,Race(9),,
2,0,0,0,0,0,0,0,0,0,0,0,0,0,0,0,0,71,51,0.0,M2020-01-19D,Race(9),,
10,13,10,7,30,18,4,5,27,12,5,7,24,43,19,19,81,3.5,3.1,3.0,M2020-01-19D,Race(9),,
3,0,0,0,0,0,0,0,0,0,0,0,0,0,0,0,0,91,91,0.0,M2020-01-22D,Race(1),,
9,6,5,8,19,9,1,5,15,2,3,7,12,17,9,20,46,5.5,5.5,0.0,M2020-01-22D,Race(1),,
12,7,5,6,18,5,5,10,20,5,5,4,14,17,15,20,52,3.8,3.8,0.0,M2020-01-22D,Race(1),,
11,0,2,0,2,0,3,2,5,3,6,1,10,3,11,3,17,19,19,0.0,M2020-01-22D,Race(1),,
10,2,2,5,9,0,0,0,0,0,0,0,0,2,2,5,9,15,15,1.0,M2020-01-22D,Race(1),,
8,0,0,2,2,1,0,1,2,2,1,1,4,3,1,4,8,10,10,2.0,M2020-01-22D,Race(1),,
7,0,0,0,0,0,1,1,2,0,0,0,0,0,1,1,2,26,26,0.0,M2020-01-22D,Race(1),,
6,0,3,6,9,0,10,0,10,2,1,1,4,2,14,7,23,14,14,0.0,M2020-01-22D,Race(1),,
1,0,3,0,3,1,1,0,2,0,2,0,2,1,6,0,7,31,31,0.0,M2020-01-22D,Race(1),,
2,15,5,0,20,13,6,3,22,11,5,7,23,39,16,10,65,2.8,2.8,0.0,M2020-01-22D,Race(1),,
5,0,5,3,8,1,4,8,13,1,3,5,9,2,12,16,30,11,11,3.0,M2020-01-22D,Race(1),,
4,0,0,0,0,0,0,0,0,0,0,0,0,0,0,0,0,71,71,0.0,M2020-01-22D,Race(1),,
9,0,0,7,7,4,2,13,19,5,2,3,10,9,4,23,36,7,7,0.0,M2020-01-22D,Race(2),,
4,0,0,0,0,0,0,0,0,0,1,1,2,0,1,1,2,31,31,0.0,M2020-01-22D,Race(2),,
7,0,0,0,0,0,0,0,0,0,0,1,1,0,0,1,1,151,151,0.0,M2020-01-22D,Race(2),,
8,0,0,0,0,0,0,0,0,0,0,0,0,0,0,0,0,71,71,0.0,M2020-01-22D,Race(2),,
12,9,7,2,18,7,7,4,18,5,7,7,19,21,21,13,55,3.2,3.2,1.0,M2020-01-22D,Race(2),,
10,9,5,5,19,7,8,6,21,6,9,5,20,22,22,16,60,4.2,4.2,0.0,M2020-01-22D,Race(2),,
11,0,0,0,0,1,0,0,1,0,0,0,0,1,0,0,1,31,31,2.0,M2020-01-22D,Race(2),,
5,0,3,0,3,0,0,0,0,0,0,1,1,0,3,1,4,15,15,0.0,M2020-01-22D,Race(2),,
3,0,7,8,15,0,2,1,3,1,1,1,3,1,10,10,21,16,16,0.0,M2020-01-22D,Race(2),,
6,2,0,0,2,0,0,1,1,2,0,2,4,4,0,3,7,34,34,0.0,M2020-01-22D,Race(2),,
1,5,5,0,10,1,10,4,15,3,5,4,12,9,20,8,37,7,7,0.0,M2020-01-22D,Race(2),,
2,5,3,8,16,10,1,1,12,4,1,1,6,19,5,10,34,5,5,3.0,M2020-01-22D,Race(2),,
1,0,0,3,3,1,1,1,3,2,0,2,4,3,1,6,10,12,12,0.0,M2020-01-22D,Race(3),,
2,8,16,4,28,8,13,7,28,4,7,9,20,20,36,20,76,4.4,4.4,2.0,M2020-01-22D,Race(3),,
3,0,0,3,3,0,0,0,0,2,0,0,2,2,0,3,5,26,26,0.0,M2020-01-22D,Race(3),,
4,9,5,3,17,3,3,10,16,4,3,1,8,16,11,14,41,5.5,5.5,1.0,M2020-01-22D,Race(3),,
7,0,0,0,0,0,0,0,0,1,0,0,1,1,0,0,1,101,101,0.0,M2020-01-22D,Race(3),,
8,2,0,7,9,0,5,4,9,0,8,4,12,2,13,15,30,8.5,8.5,0.0,M2020-01-22D,Race(3),,
9,9,9,2,20,17,7,4,28,11,7,4,22,37,23,10,70,3.1,3.1,3.0,M2020-01-22D,Race(3),,
6,0,0,0,0,0,0,0,0,0,0,0,0,0,0,0,0,126,126,0.0,M2020-01-22D,Race(3),,
11,2,0,3,5,0,0,3,3,1,0,4,5,3,0,10,13,12,12,0.0,M2020-01-22D,Race(3),,
10,0,0,0,0,1,0,0,1,0,0,0,0,1,0,0,1,11,11,0.0,M2020-01-22D,Race(3),,
5,0,0,3,3,0,1,1,2,1,1,2,4,1,2,6,9,11,11,0.0,M2020-01-22D,Race(3),,
12,0,0,2,2,0,0,0,0,0,0,0,0,0,0,2,2,41,41,0.0,M2020-01-22D,Race(3),,
9,2,3,3,8,2,2,1,5,4,2,2,8,8,7,6,21,7.5,7.5,0.0,M2020-01-22D,Race(4),,
11,0,2,0,2,1,1,2,4,0,0,5,5,1,3,7,11,12,12,0.0,M2020-01-22D,Race(4),,
8,3,3,11,17,2,12,6,20,3,5,4,12,8,20,21,49,5,5,2.0,M2020-01-22D,Race(4),,
7,0,0,0,0,0,1,0,1,0,1,1,2,0,2,1,3,21,21,0.0,M2020-01-22D,Race(4),,
5,3,12,6,21,6,4,2,12,6,4,3,13,15,20,11,46,6,6,0.0,M2020-01-22D,Race(4),,
6,0,0,0,0,0,0,0,0,0,0,0,0,0,0,0,0,71,67,0.0,M2020-01-22D,Race(4),,
3,3,2,0,5,3,0,10,13,5,2,4,11,11,4,14,29,8,8,0.0,M2020-01-22D,Race(4),,
10,0,0,3,3,0,0,1,1,0,2,1,3,0,2,5,7,21,21,3.0,M2020-01-22D,Race(4),,
12,0,0,0,0,0,0,0,0,0,0,0,0,0,0,0,0,81,81,0.0,M2020-01-22D,Race(4),,
2,15,8,7,30,7,5,7,19,6,3,5,14,28,16,19,63,4,4,1.0,M2020-01-22D,Race(4),,
1,4,0,0,4,9,4,1,14,2,7,1,10,15,11,2,28,6.5,6.5,0.0,M2020-01-22D,Race(4),,
4,0,0,0,0,0,1,0,1,0,0,0,0,0,1,0,1,23,23,0.0,M2020-01-22D,Race(4),,
10,3,6,5,14,0,8,6,14,3,8,3,14,6,22,14,42,7,7,0.0,M2020-01-22D,Race(5),,
12,0,0,0,0,0,0,0,0,0,0,0,0,0,0,0,0,81,81,0.0,M2020-01-22D,Race(5),,
11,0,0,3,3,0,1,3,4,0,3,3,6,0,4,9,13,7,7,0.0,M2020-01-22D,Race(5),,
4,0,0,6,6,0,0,1,1,0,2,2,4,0,2,9,11,19,19,0.0,M2020-01-22D,Race(5),,
9,16,12,2,30,15,9,4,28,10,4,8,22,41,25,14,80,2.6,2.6,0.0,M2020-01-22D,Race(5),,
8,0,4,4,8,9,10,1,20,3,4,2,9,12,18,7,37,8,8,0.0,M2020-01-22D,Race(5),,
7,3,2,2,7,1,0,1,2,2,2,1,5,6,4,4,14,9,9,2.0,M2020-01-22D,Race(5),,
6,0,0,0,0,0,0,0,0,0,0,1,1,0,0,1,1,81,81,0.0,M2020-01-22D,Race(5),,
2,6,3,6,15,5,2,14,21,8,3,6,17,19,8,26,53,4.8,4.8,1.0,M2020-01-22D,Race(5),,
3,2,3,2,7,0,0,0,0,0,0,0,0,2,3,2,7,17,17,3.0,M2020-01-22D,Race(5),,
1,0,0,0,0,0,0,0,0,0,0,0,0,0,0,0,0,101,101,0.0,M2020-01-22D,Race(5),,
5,0,0,0,0,0,0,0,0,0,0,0,0,0,0,0,0,51,51,0.0,M2020-01-22D,Race(5),,
4,18,5,7,30,11,8,9,28,9,12,2,23,38,25,18,81,2,2,1.0,M2020-01-22D,Race(6),,
6,0,0,3,3,0,0,0,0,0,0,0,0,0,0,3,3,34,34,3.0,M2020-01-22D,Race(6),,
7,8,2,3,13,6,13,6,25,10,6,3,19,24,21,12,57,7.5,7.5,0.0,M2020-01-22D,Race(6),,
8,0,0,0,0,0,0,0,0,0,0,0,0,0,0,0,0,18,18,0.0,M2020-01-22D,Race(6),,
9,0,0,5,5,0,0,2,2,0,0,5,5,0,0,12,12,15,15,0.0,M2020-01-22D,Race(6),,
10,0,3,0,3,1,1,1,3,1,0,3,4,2,4,4,10,10,10,0.0,M2020-01-22D,Race(6),,
12,0,2,0,2,0,0,0,0,0,0,0,0,0,2,0,2,34,34,0.0,M2020-01-22D,Race(6),,
5,0,0,6,6,0,0,1,1,0,0,1,1,0,0,8,8,16,16,0.0,M2020-01-22D,Race(6),,
3,2,9,0,11,2,2,5,9,2,2,5,9,6,13,10,29,10,10,2.0,M2020-01-22D,Race(6),,
11,0,6,0,6,0,0,1,1,1,2,2,5,1,8,3,12,11,11,0.0,M2020-01-22D,Race(6),,
1,2,3,6,11,9,5,5,19,2,3,5,10,13,11,16,40,10,10,0.0,M2020-01-22D,Race(6),,
2,0,0,0,0,0,0,0,0,1,0,0,1,1,0,0,1,91,91,0.0,M2020-01-22D,Race(6),,
11,2,0,0,2,0,1,0,1,0,0,0,0,2,1,0,3,34,34,0.0,M2020-01-22D,Race(7),,
10,0,0,0,0,0,0,0,0,0,1,0,1,0,1,0,1,26,26,1.0,M2020-01-22D,Race(7),,
4,0,0,0,0,0,0,0,0,0,0,0,0,0,0,0,0,34,34,0.0,M2020-01-22D,Race(7),,
5,0,0,0,0,0,0,0,0,0,0,0,0,0,0,0,0,91,91,0.0,M2020-01-22D,Race(7),,
6,2,0,0,2,1,0,1,2,0,2,0,2,3,2,1,6,12,12,0.0,M2020-01-22D,Race(7),,
7,0,8,0,8,0,1,0,1,0,0,1,1,0,9,1,10,12,12,0.0,M2020-01-22D,Race(7),,
8,23,0,4,27,13,12,1,26,14,8,3,25,50,20,8,78,3,3,0.0,M2020-01-22D,Race(7),,
3,0,0,0,0,0,1,3,4,0,2,3,5,0,3,6,9,17,17,0.0,M2020-01-22D,Race(7),,
9,0,0,6,6,0,0,0,0,0,0,0,0,0,0,6,6,13,13,3.0,M2020-01-22D,Race(7),,
2,0,11,3,14,15,12,9,36,9,11,4,24,24,34,16,74,4.4,4.4,0.0,M2020-01-22D,Race(7),,
1,3,0,12,15,0,3,10,13,1,1,9,11,4,4,31,39,10,10,0.0,M2020-01-22D,Race(7),,
12,0,11,5,16,1,0,3,4,2,1,6,9,3,12,14,29,4.8,4.8,2.0,M2020-01-22D,Race(7),,
4,0,0,2,2,2,2,2,6,2,3,2,7,4,5,6,15,9,9,0.0,M2020-01-22D,Race(8),,
3,7,2,5,14,2,6,10,18,3,3,2,8,12,11,17,40,6.5,6.5,0.0,M2020-01-22D,Race(8),,
2,4,8,0,12,3,0,4,7,4,1,5,10,11,9,9,29,9.5,9.5,1.0,M2020-01-22D,Race(8),,
7,10,5,0,15,9,11,4,24,6,6,5,17,25,22,9,56,7.5,7.5,3.0,M2020-01-22D,Race(8),,
8,0,0,2,2,0,0,0,0,0,0,0,0,0,0,2,2,26,26,0.0,M2020-01-22D,Race(8),,
9,3,10,8,21,9,3,6,18,4,6,3,13,16,19,17,52,6,6,0.0,M2020-01-22D,Race(8),,
10,0,2,2,4,0,1,0,1,1,1,1,3,1,4,3,8,9,9,0.0,M2020-01-22D,Race(8),,
1,0,0,0,0,0,2,0,2,1,3,1,5,1,5,1,7,21,21,0.0,M2020-01-22D,Race(8),,
11,0,0,0,0,2,2,0,4,2,2,1,5,4,4,1,9,7.5,7.5,2.0,M2020-01-22D,Race(8),,
5,0,0,0,0,0,0,0,0,0,0,0,0,0,0,0,0,31,31,0.0,M2020-01-22D,Race(8),,
6,3,0,0,3,0,0,2,2,1,0,4,5,4,0,6,10,26,26,0.0,M2020-01-22D,Race(8),,
12,3,3,11,17,3,3,2,8,2,1,2,5,8,7,15,30,4.8,4.8,0.0,M2020-01-22D,Race(8),,
8,0,5,0,5,2,0,1,3,1,0,4,5,3,5,5,13,7.5,7.5,1.0,M2020-01-22D,Race(9),,
11,3,0,3,6,0,2,1,3,0,3,0,3,3,5,4,12,12,12,0.0,M2020-01-22D,Race(9),,
12,2,3,3,8,0,0,0,0,1,1,0,2,3,4,3,10,12,12,0.0,M2020-01-22D,Race(9),,
7,2,5,9,16,9,10,4,23,3,7,8,18,14,22,21,57,8,8,0.0,M2020-01-22D,Race(9),,
6,0,0,0,0,0,0,0,0,0,0,0,0,0,0,0,0,101,101,0.0,M2020-01-22D,Race(9),,
5,0,0,0,0,0,0,0,0,0,0,0,0,0,0,0,0,81,81,0.0,M2020-01-22D,Race(9),,
4,14,13,3,30,15,10,3,28,19,3,2,24,48,26,8,82,2.7,2.7,0.0,M2020-01-22D,Race(9),,
3,9,4,5,18,1,6,9,16,1,7,8,16,11,17,22,50,4.2,4.2,3.0,M2020-01-22D,Race(9),,
2,0,0,0,0,0,0,1,1,0,1,1,2,0,1,2,3,41,41,0.0,M2020-01-22D,Race(9),,
1,0,0,4,4,3,2,10,15,1,4,2,7,4,6,16,26,19,19,0.0,M2020-01-22D,Race(9),,
9,0,0,3,3,0,0,1,1,0,0,0,0,0,0,4,4,10,10,2.0,M2020-01-22D,Race(9),,
10,0,0,0,0,0,0,0,0,0,0,1,1,0,0,1,1,21,21,0.0,M2020-01-22D,Race(9),,
3,9,3,8,20,4,1,1,6,5,0,0,5,18,4,9,31,4.6,4.6,2.0,M2020-01-27D,Race(1),,
6,0,0,0,0,0,0,0,0,0,1,0,1,0,1,0,1,101,101,0.0,M2020-01-27D,Race(1),,
7,0,0,2,2,1,1,0,2,0,0,0,0,1,1,2,4,21,21,0.0,M2020-01-27D,Race(1),,
8,2,6,5,13,2,5,11,18,4,5,1,10,8,16,17,41,7.5,7.5,0.0,M2020-01-27D,Race(1),,
9,5,0,0,5,0,0,0,0,0,0,2,2,5,0,2,7,17,17,0.0,M2020-01-27D,Race(1),,
10,3,0,7,10,0,0,2,2,0,1,2,3,3,1,11,15,5,5,1.0,M2020-01-27D,Race(1),,
11,0,0,0,0,3,1,0,4,0,2,0,2,3,3,0,6,34,34,0.0,M2020-01-27D,Race(1),,
13,0,2,0,2,2,0,1,3,1,1,2,4,3,3,3,9,41,41,3.0,M2020-01-27D,Race(1),,
5,0,0,0,0,0,0,0,0,0,0,0,0,0,0,0,0,61,61,0.0,M2020-01-27D,Race(1),,
2,4,3,2,9,0,12,9,21,2,3,9,14,6,18,20,44,7.5,7.5,0.0,M2020-01-27D,Race(1),,
1,2,2,3,7,1,1,1,3,3,3,1,7,6,6,5,17,11,11,0.0,M2020-01-27D,Race(1),,
12,5,10,3,18,17,8,2,27,11,8,3,22,33,26,8,67,3.7,3.7,0.0,M2020-01-27D,Race(1),,
14,0,2,0,2,0,1,3,4,0,2,6,8,0,5,9,14,34,34,0.0,M2020-01-27D,Race(1),,
4,0,2,0,2,0,0,0,0,0,0,0,0,0,2,0,2,61,61,0.0,M2020-01-27D,Race(1),,
6,0,0,0,0,0,0,0,0,0,0,1,1,0,0,1,1,41,41,0.0,M2020-01-27D,Race(10),,
11,0,0,0,0,0,1,0,1,0,0,0,0,0,1,0,1,34,34,0.0,M2020-01-27D,Race(10),,
7,0,5,8,13,2,6,11,19,3,5,5,13,5,16,24,45,6,6,2.0,M2020-01-27D,Race(10),,
8,0,0,0,0,1,0,0,1,0,0,1,1,1,0,1,2,31,31,0.0,M2020-01-27D,Race(10),,
14,0,0,0,0,0,0,0,0,0,1,0,1,0,1,0,1,26,26,0.0,M2020-01-27D,Race(10),,
13,10,17,0,27,6,11,8,25,7,7,5,19,23,35,13,71,4,4,1.0,M2020-01-27D,Race(10),,
12,0,0,0,0,0,0,0,0,0,0,0,0,0,0,0,0,81,81,3.0,M2020-01-27D,Race(10),,
10,0,0,0,0,0,0,0,0,0,0,0,0,0,0,0,0,81,81,0.0,M2020-01-27D,Race(10),,
5,3,0,2,5,0,1,0,1,0,0,0,0,3,1,2,6,21,21,0.0,M2020-01-27D,Race(10),,
4,2,0,8,10,1,1,2,4,0,0,1,1,3,1,11,15,11,11,0.0,M2020-01-27D,Race(10),,
3,15,2,8,25,15,10,2,27,12,9,2,23,42,21,12,75,2.8,2.8,0.0,M2020-01-27D,Race(10),,
9,0,6,2,8,2,0,4,6,0,0,5,5,2,6,11,19,7.5,7.5,0.0,M2020-01-27D,Race(10),,
1,0,0,2,2,0,0,0,0,0,0,0,0,0,0,2,2,17,17,0.0,M2020-01-27D,Race(10),,
2,0,0,0,0,0,0,2,2,0,4,0,4,0,4,2,6,41,41,0.0,M2020-01-27D,Race(10),,
14,0,0,0,0,0,0,0,0,0,0,0,0,0,0,0,0,71,67,3.0,M2020-01-27D,Race(11),,
1,14,7,5,26,17,10,2,29,11,8,4,23,42,25,11,78,3.6,3.6,0.0,M2020-01-27D,Race(11),,
2,14,11,5,30,10,17,1,28,8,13,3,24,32,41,9,82,2.5,2.5,1.0,M2020-01-27D,Race(11),,
3,0,2,5,7,0,1,2,3,0,0,2,2,0,3,9,12,13,13,2.0,M2020-01-27D,Race(11),,
4,0,7,11,18,1,0,16,17,2,3,3,8,3,10,30,43,4.2,5,0.0,M2020-01-27D,Race(11),,
5,0,3,0,3,1,0,1,2,0,0,2,2,1,3,3,7,51,51,0.0,M2020-01-27D,Race(11),,
13,0,0,0,0,0,0,0,0,0,0,0,0,0,0,0,0,61,61,0.0,M2020-01-27D,Race(11),,
8,0,0,0,0,0,0,0,0,0,0,0,0,0,0,0,0,41,41,0.0,M2020-01-27D,Race(11),,
9,0,0,0,0,0,0,0,0,0,0,0,0,0,0,0,0,151,151,0.0,M2020-01-27D,Race(11),,
10,0,0,0,0,0,0,0,0,0,0,0,0,0,0,0,0,101,101,0.0,M2020-01-27D,Race(11),,
11,0,0,0,0,0,0,0,0,0,0,0,0,0,0,0,0,41,41,0.0,M2020-01-27D,Race(11),,
12,0,0,0,0,0,0,0,0,0,0,0,0,0,0,0,0,81,81,0.0,M2020-01-27D,Race(11),,
6,2,0,4,6,1,2,8,11,5,2,12,19,8,4,24,36,6.5,6.5,0.0,M2020-01-27D,Race(11),,
7,0,0,0,0,0,0,0,0,0,0,0,0,0,0,0,0,26,26,0.0,M2020-01-27D,Race(11),,
13,0,0,2,2,0,0,0,0,0,1,1,2,0,1,3,4,17,17,0.0,M2020-01-27D,Race(2),,
14,0,0,0,0,0,0,0,0,0,0,1,1,0,0,1,1,51,51,0.0,M2020-01-27D,Race(2),,
1,8,5,3,16,6,13,3,22,4,3,5,12,18,21,11,50,7.5,7.5,2.0,M2020-01-27D,Race(2),,
4,3,6,8,17,2,6,17,25,1,7,8,16,6,19,33,58,10,10,0.0,M2020-01-27D,Race(2),,
12,0,0,0,0,0,0,0,0,0,0,0,0,0,0,0,0,126,126,0.0,M2020-01-27D,Race(2),,
11,0,3,0,3,0,0,0,0,0,0,0,0,0,3,0,3,41,41,0.0,M2020-01-27D,Race(2),,
6,0,0,0,0,0,0,0,0,0,0,0,0,0,0,0,0,126,126,0.0,M2020-01-27D,Race(2),,
2,2,0,6,8,0,2,3,5,0,2,1,3,2,4,10,16,9,9,3.0,M2020-01-27D,Race(2),,
3,12,11,5,28,18,5,5,28,15,4,4,23,45,20,14,79,2.1,2.1,1.0,M2020-01-27D,Race(2),,
5,0,0,0,0,2,2,1,5,4,3,2,9,6,5,3,14,11,11,0.0,M2020-01-27D,Race(2),,
7,5,3,6,14,2,2,1,5,2,5,1,8,9,10,8,27,4.6,4.6,0.0,M2020-01-27D,Race(2),,
8,0,0,0,0,0,0,0,0,0,0,0,0,0,0,0,0,151,151,0.0,M2020-01-27D,Race(2),,
9,0,2,0,2,0,0,0,0,0,1,1,2,0,3,1,4,71,67,0.0,M2020-01-27D,Race(2),,
10,0,0,0,0,0,0,0,0,0,0,0,0,0,0,0,0,101,101,0.0,M2020-01-27D,Race(2),,
7,11,2,5,18,1,2,15,18,5,3,5,13,17,7,25,49,4.8,4.8,3.0,M2020-01-27D,Race(3),,
14,0,0,0,0,0,0,0,0,0,0,3,3,0,0,3,3,34,34,0.0,M2020-01-27D,Race(3),,
4,0,0,0,0,0,0,1,1,0,0,0,0,0,0,1,1,51,51,0.0,M2020-01-27D,Race(3),,
13,0,0,0,0,0,0,0,0,0,0,0,0,0,0,0,0,201,201,0.0,M2020-01-27D,Race(3),,
12,0,0,0,0,0,0,0,0,0,0,0,0,0,0,0,0,101,101,0.0,M2020-01-27D,Race(3),,
9,2,0,3,5,1,2,6,9,3,6,4,13,6,8,13,27,10,10,0.0,M2020-01-27D,Race(3),,
10,0,0,0,0,0,0,0,0,0,0,0,0,0,0,0,0,81,81,0.0,M2020-01-27D,Race(3),,
6,2,0,5,7,0,0,0,0,0,0,2,2,2,0,7,9,12,12,0.0,M2020-01-27D,Race(3),,
8,0,0,0,0,0,2,0,2,0,2,1,3,0,4,1,5,61,61,0.0,M2020-01-27D,Race(3),,
1,9,10,5,24,5,16,6,27,5,6,6,17,19,32,17,68,3.3,3.3,1.0,M2020-01-27D,Race(3),,
2,6,10,12,28,23,6,0,29,12,6,3,21,41,22,15,78,2.35,2.6,2.0,M2020-01-27D,Race(3),,
3,0,0,0,0,0,0,0,0,0,1,0,1,0,1,0,1,61,61,0.0,M2020-01-27D,Race(3),,
5,0,3,0,3,0,2,2,4,1,2,1,4,1,7,3,11,26,26,0.0,M2020-01-27D,Race(3),,
11,0,5,0,5,0,0,0,0,0,0,1,1,0,5,1,6,19,19,0.0,M2020-01-27D,Race(3),,
1,15,5,4,24,25,3,2,30,18,1,2,21,58,9,8,75,2.1,2.1,1.0,M2020-01-27D,Race(4),,
10,0,0,3,3,1,2,1,4,0,1,2,3,1,3,6,10,13,13,0.0,M2020-01-27D,Race(4),,
9,5,0,5,10,0,3,4,7,1,5,2,8,6,8,11,25,6.5,6.5,0.0,M2020-01-27D,Race(4),,
2,0,4,2,6,0,0,1,1,1,1,0,2,1,5,3,9,23,23,0.0,M2020-01-27D,Race(4),,
8,8,10,3,21,2,13,5,20,1,5,9,15,11,28,17,56,6,6,0.0,M2020-01-27D,Race(4),,
3,0,0,0,0,0,2,2,4,0,0,0,0,0,2,2,4,0,0,0.0,M2020-01-27D,Race(4),,
11,0,8,7,15,2,3,1,6,1,4,2,7,3,15,10,28,7,7,2.0,M2020-01-27D,Race(4),,
4,0,0,0,0,0,0,0,0,0,1,1,2,0,1,1,2,51,51,0.0,M2020-01-27D,Race(4),,
5,0,0,0,0,0,2,1,3,2,5,0,7,2,7,1,10,21,21,3.0,M2020-01-27D,Race(4),,
7,0,3,6,9,0,2,13,15,1,0,6,7,1,5,25,31,8,8,0.0,M2020-01-27D,Race(4),,
6,2,0,0,2,0,0,0,0,0,0,0,0,2,0,0,2,34,34,0.0,M2020-01-27D,Race(4),,
3,3,2,11,16,2,15,3,20,1,6,4,11,6,23,18,47,7.5,7.5,0.0,M2020-01-27D,Race(5),,
2,0,0,0,0,0,0,0,0,0,1,0,1,0,1,0,1,41,41,0.0,M2020-01-27D,Race(5),,
1,0,0,0,0,0,0,0,0,0,0,0,0,0,0,0,0,126,126,0.0,M2020-01-27D,Race(5),,
4,0,2,0,2,0,1,0,1,0,0,0,0,0,3,0,3,71,67,0.0,M2020-01-27D,Race(5),,
8,7,19,4,30,20,2,4,26,13,1,4,18,40,22,12,74,1.9,1.9,2.0,M2020-01-27D,Race(5),,
14,0,0,0,0,0,0,0,0,0,0,0,0,0,0,0,0,81,81,0.0,M2020-01-27D,Race(5),,
12,3,2,0,5,0,0,0,0,0,1,2,3,3,3,2,8,26,26,0.0,M2020-01-27D,Race(5),,
11,0,0,6,6,0,1,0,1,0,0,0,0,0,1,6,7,13,13,1.0,M2020-01-27D,Race(5),,
7,2,0,0,2,5,3,5,13,7,3,4,14,14,6,9,29,9,9,0.0,M2020-01-27D,Race(5),,
5,13,3,4,20,2,7,12,21,5,8,7,20,20,18,23,61,6.5,6.5,0.0,M2020-01-27D,Race(5),,
6,2,2,5,9,1,1,5,7,0,5,5,10,3,8,15,26,6.5,6.5,3.0,M2020-01-27D,Race(5),,
10,0,0,0,0,0,0,1,1,0,1,0,1,0,1,1,2,81,81,0.0,M2020-01-27D,Race(5),,
9,0,0,0,0,0,0,0,0,0,0,0,0,0,0,0,0,151,151,0.0,M2020-01-27D,Race(5),,
13,0,0,0,0,0,0,0,0,0,0,0,0,0,0,0,0,126,126,0.0,M2020-01-27D,Race(5),,
1,2,9,3,14,5,3,5,13,6,1,6,13,13,13,14,40,6.5,6.5,1.0,M2020-01-27D,Race(6),,
2,5,11,7,23,14,6,4,24,8,5,3,16,27,22,14,63,6,6,0.0,M2020-01-27D,Race(6),,
12,0,0,0,0,0,0,0,0,0,0,0,0,0,0,0,0,101,101,0.0,M2020-01-27D,Race(6),,
3,0,0,0,0,1,0,0,1,0,0,0,0,1,0,0,1,41,41,0.0,M2020-01-27D,Race(6),,
14,0,0,0,0,0,0,0,0,0,0,0,0,0,0,0,0,12,12,0.0,M2020-01-27D,Race(6),,
4,0,0,6,6,0,1,1,2,1,0,1,2,1,1,8,10,14,14,2.0,M2020-01-27D,Race(6),,
5,15,3,4,22,6,16,3,25,2,8,3,13,23,27,10,60,4.6,4.6,0.0,M2020-01-27D,Race(6),,
9,0,0,0,0,0,0,0,0,0,0,0,0,0,0,0,0,71,71,0.0,M2020-01-27D,Race(6),,
7,0,0,0,0,0,0,1,1,0,0,1,1,0,0,2,2,81,81,0.0,M2020-01-27D,Race(6),,
8,6,0,3,9,3,1,13,17,7,3,6,16,16,4,22,42,4.4,4.4,3.0,M2020-01-27D,Race(6),,
10,0,0,0,0,0,0,0,0,0,0,0,0,0,0,0,0,34,34,0.0,M2020-01-27D,Race(6),,
11,0,0,0,0,0,0,0,0,0,0,0,0,0,0,0,0,31,31,0.0,M2020-01-27D,Race(6),,
13,0,2,5,7,0,0,0,0,0,3,1,4,0,5,6,11,8,8,0.0,M2020-01-27D,Race(6),,
6,2,5,2,9,1,3,3,7,2,6,5,13,5,14,10,29,9,9,0.0,M2020-01-27D,Race(6),,
1,5,2,0,7,2,1,2,5,1,1,3,5,8,4,5,17,13,13,0.0,M2020-01-27D,Race(7),,
14,0,5,5,10,2,2,3,7,1,3,1,5,3,10,9,22,4.4,4.4,1.0,M2020-01-27D,Race(7),,
13,0,0,0,0,0,0,0,0,0,0,0,0,0,0,0,0,81,81,0.0,M2020-01-27D,Race(7),,
12,0,0,0,0,0,0,1,1,0,0,2,2,0,0,3,3,17,17,0.0,M2020-01-27D,Race(7),,
11,0,0,0,0,0,0,0,0,0,0,0,0,0,0,0,0,81,81,0.0,M2020-01-27D,Race(7),,
10,0,0,3,3,0,0,1,1,0,1,1,2,0,1,5,6,19,19,0.0,M2020-01-27D,Race(7),,
6,0,0,0,0,0,0,0,0,0,1,3,4,0,1,3,4,81,81,0.0,M2020-01-27D,Race(7),,
8,0,0,0,0,0,0,0,0,1,1,0,2,1,1,0,2,15,15,0.0,M2020-01-27D,Race(7),,
4,2,6,8,16,7,18,2,27,5,10,4,19,14,34,14,62,4,4,2.0,M2020-01-27D,Race(7),,
3,5,0,2,7,3,4,15,22,2,6,6,14,10,10,23,43,8,8,0.0,M2020-01-27D,Race(7),,
2,16,2,2,20,15,5,4,24,15,3,3,21,46,10,9,65,5,5,0.0,M2020-01-27D,Race(7),,
7,0,2,0,2,0,0,0,0,0,0,0,0,0,2,0,2,41,41,0.0,M2020-01-27D,Race(7),,
9,2,6,0,8,0,0,1,1,1,0,2,3,3,6,3,12,12,12,3.0,M2020-01-27D,Race(7),,
5,0,7,10,17,1,0,1,2,0,0,1,1,1,7,12,20,13,13,0.0,M2020-01-27D,Race(7),,
5,0,0,0,0,0,2,0,2,0,4,1,5,0,6,1,7,12,10,0.0,M2020-01-27D,Race(8),,
6,0,2,0,2,0,0,0,0,0,0,0,0,0,2,0,2,51,26,0.0,M2020-01-27D,Race(8),,
7,0,0,0,0,0,0,0,0,0,0,0,0,0,0,0,0,51,26,0.0,M2020-01-27D,Race(8),,
8,0,0,0,0,0,0,2,2,0,1,1,2,0,1,3,4,23,21,0.0,M2020-01-27D,Race(8),,
9,0,0,0,0,0,0,0,0,0,0,0,0,0,0,0,0,126,101,0.0,M2020-01-27D,Race(8),,
3,9,8,13,30,1,4,14,19,1,5,10,16,11,17,37,65,3.6,3.5,0.0,M2020-01-27D,Race(8),,
2,0,5,0,5,1,2,7,10,2,4,5,11,3,11,12,26,8.5,8,3.0,M2020-01-27D,Race(8),,
1,16,8,2,26,22,3,4,29,16,3,5,24,54,14,11,79,1.95,1.9,1.0,M2020-01-27D,Race(8),,
4,5,7,15,27,6,19,3,28,7,9,4,20,18,35,22,75,5.5,6.5,2.0,M2020-01-27D,Race(8),,
14,2,0,0,2,0,0,0,0,0,0,0,0,2,0,0,2,51,51,0.0,M2020-01-27D,Race(9),,
1,0,0,2,2,0,0,3,3,0,0,5,5,0,0,10,10,34,34,0.0,M2020-01-27D,Race(9),,
2,0,2,3,5,2,3,2,7,3,4,2,9,5,9,7,21,17,17,0.0,M2020-01-27D,Race(9),,
3,0,0,0,0,0,0,0,0,0,0,0,0,0,0,0,0,71,71,0.0,M2020-01-27D,Race(9),,
5,0,0,2,2,0,0,0,0,1,0,0,1,1,0,2,3,71,67,0.0,M2020-01-27D,Race(9),,
6,0,2,0,2,1,1,0,2,2,2,0,4,3,5,0,8,21,21,0.0,M2020-01-27D,Race(9),,
7,11,0,2,13,1,0,1,2,4,1,3,8,16,1,6,23,7.5,7.5,0.0,M2020-01-27D,Race(9),,
8,0,0,0,0,2,2,11,15,1,0,2,3,3,2,13,18,13,13,0.0,M2020-01-27D,Race(9),,
9,10,8,0,18,16,10,2,28,7,12,2,21,33,30,4,67,3.1,3.1,1.0,M2020-01-27D,Race(9),,
11,0,3,5,8,0,1,0,1,2,2,2,6,2,6,7,15,9,9,2.0,M2020-01-27D,Race(9),,
12,0,0,6,6,0,1,2,3,0,1,3,4,0,2,11,13,17,17,3.0,M2020-01-27D,Race(9),,
13,2,0,8,10,3,0,5,8,3,1,3,7,8,1,16,25,8.5,8.5,0.0,M2020-01-27D,Race(9),,
10,0,0,0,0,0,0,0,0,0,0,0,0,0,0,0,0,41,41,0.0,M2020-01-27D,Race(9),,
4,5,15,2,22,5,12,4,21,3,3,4,10,13,30,10,53,4,4,0.0,M2020-01-27D,Race(9),,
2,0,3,0,3,2,9,4,15,0,1,4,5,2,13,8,23,21,21,0.0,M2020-01-29D,Race(1),,
8,0,11,5,16,12,9,4,25,5,10,3,18,17,30,12,59,5.5,5.5,0.0,M2020-01-29D,Race(1),,
9,0,0,2,2,0,0,2,2,1,0,2,3,1,0,6,7,19,19,0.0,M2020-01-29D,Race(1),,
5,0,0,0,0,0,0,0,0,0,0,0,0,0,0,0,0,81,81,0.0,M2020-01-29D,Race(1),,
10,0,0,0,0,0,0,0,0,0,0,0,0,0,0,0,0,34,34,0.0,M2020-01-29D,Race(1),,
12,3,0,6,9,0,3,7,10,0,2,7,9,3,5,20,28,6,6,0.0,M2020-01-29D,Race(1),,
4,0,0,0,0,0,0,0,0,1,0,0,1,1,0,0,1,41,41,3.0,M2020-01-29D,Race(1),,
3,22,8,0,30,15,5,10,30,19,5,2,26,56,18,12,86,1.95,1.95,1.0,M2020-01-29D,Race(1),,
7,0,2,7,9,0,2,1,3,0,2,5,7,0,6,13,19,21,21,2.0,M2020-01-29D,Race(1),,
6,0,0,3,3,0,0,0,0,0,0,0,0,0,0,3,3,51,51,0.0,M2020-01-29D,Race(1),,
11,2,4,0,6,0,2,1,3,0,4,1,5,2,10,2,14,9.5,11,0.0,M2020-01-29D,Race(1),,
1,3,2,7,12,1,0,1,2,0,2,2,4,4,4,10,18,11,11,0.0,M2020-01-29D,Race(1),,
5,8,15,3,26,14,10,2,26,7,9,3,19,29,34,8,71,6,5.5,0.0,M2020-01-29D,Race(2),,
11,0,0,0,0,0,0,0,0,0,0,0,0,0,0,0,0,81,81,0.0,M2020-01-29D,Race(2),,
9,0,0,0,0,0,0,1,1,0,0,4,4,0,0,5,5,16,16,0.0,M2020-01-29D,Race(2),,
4,0,0,0,0,0,0,2,2,1,0,7,8,1,0,9,10,23,21,2.0,M2020-01-29D,Race(2),,
8,2,0,9,11,0,9,8,17,0,4,3,7,2,13,20,35,7,7,0.0,M2020-01-29D,Race(2),,
7,0,0,2,2,2,0,3,5,0,0,2,2,2,0,7,9,17,16,0.0,M2020-01-29D,Race(2),,
10,3,2,4,9,0,1,1,2,0,2,0,2,3,5,5,13,12,12,3.0,M2020-01-29D,Race(2),,
3,2,0,0,2,3,0,2,5,6,1,1,8,11,1,3,15,10,9,0.0,M2020-01-29D,Race(2),,
1,15,11,2,28,11,9,9,29,12,6,2,20,38,26,13,77,2.15,2.25,1.0,M2020-01-29D,Race(2),,
12,0,0,2,2,0,0,1,1,0,0,2,2,0,0,5,5,31,31,0.0,M2020-01-29D,Race(2),,
6,0,2,8,10,0,1,1,2,0,4,2,6,0,7,11,18,16,15,0.0,M2020-01-29D,Race(2),,
2,0,0,0,0,0,0,0,0,0,0,0,0,0,0,0,0,34,34,0.0,M2020-01-29D,Race(2),,
1,6,8,9,23,9,14,4,27,5,9,4,18,20,31,17,68,3,3,0.0,M2020-01-29D,Race(3),,
2,0,2,0,2,1,1,1,3,0,2,0,2,1,5,1,7,17,17,0.0,M2020-01-29D,Race(3),,
3,2,0,2,4,0,0,0,0,1,0,0,1,3,0,2,5,12,12,3.0,M2020-01-29D,Race(3),,
11,3,5,0,8,1,0,2,3,2,0,2,4,6,5,4,15,8.5,8.5,0.0,M2020-01-29D,Race(3),,
10,3,5,3,11,11,5,9,25,7,2,6,15,21,12,18,51,7.5,8.5,0.0,M2020-01-29D,Race(3),,
9,6,8,4,18,4,8,12,24,3,6,8,17,13,22,24,59,3.6,3.6,1.0,M2020-01-29D,Race(3),,
12,8,0,6,14,2,2,0,4,5,3,1,9,15,5,7,27,7,7,2.0,M2020-01-29D,Race(3),,
7,0,2,0,2,0,0,0,0,1,0,1,2,1,2,1,4,34,34,0.0,M2020-01-29D,Race(3),,
6,0,0,3,3,2,0,1,3,2,2,2,6,4,2,6,12,26,26,0.0,M2020-01-29D,Race(3),,
5,2,0,3,5,0,0,0,0,0,0,0,0,2,0,3,5,31,31,0.0,M2020-01-29D,Race(3),,
4,0,0,0,0,0,0,0,0,0,0,0,0,0,0,0,0,101,101,0.0,M2020-01-29D,Race(3),,
8,0,0,0,0,0,0,1,1,0,2,2,4,0,2,3,5,26,26,0.0,M2020-01-29D,Race(3),,
4,0,0,0,0,0,0,1,1,0,1,0,1,0,1,1,2,21,21,0.0,M2020-01-29D,Race(4),,
5,20,6,2,28,21,2,0,23,18,1,1,20,59,9,3,71,2.25,2.25,0.0,M2020-01-29D,Race(4),,
6,2,3,13,18,0,4,2,6,1,4,5,10,3,11,20,34,4.4,4.5,1.0,M2020-01-29D,Race(4),,
8,0,0,0,0,0,0,0,0,0,0,0,0,0,0,0,0,126,126,0.0,M2020-01-29D,Race(4),,
9,0,0,0,0,0,0,0,0,0,0,0,0,0,0,0,0,81,81,0.0,M2020-01-29D,Race(4),,
11,0,0,0,0,0,0,0,0,0,0,0,0,0,0,0,0,81,81,0.0,M2020-01-29D,Race(4),,
10,0,0,0,0,0,0,0,0,0,0,0,0,0,0,0,0,71,67,0.0,M2020-01-29D,Race(4),,
3,2,4,5,11,1,13,5,19,1,6,0,7,4,23,10,37,9,9,3.0,M2020-01-29D,Race(4),,
2,6,12,5,23,0,6,15,21,0,8,9,17,6,26,29,61,6,6,2.0,M2020-01-29D,Race(4),,
1,0,2,5,7,8,4,2,14,1,5,2,8,9,11,9,29,6,6,0.0,M2020-01-29D,Race(4),,
7,0,0,0,0,0,0,0,0,0,0,0,0,0,0,0,0,71,67,0.0,M2020-01-29D,Race(4),,
12,0,3,0,3,0,1,5,6,0,1,9,10,0,5,14,19,17,17,0.0,M2020-01-29D,Race(4),,
6,0,3,10,13,2,8,10,20,1,2,7,10,3,13,27,43,7.5,7.5,0.0,M2020-01-29D,Race(5),,
4,0,0,0,0,0,1,0,1,0,0,0,0,0,1,0,1,26,26,0.0,M2020-01-29D,Race(5),,
11,0,0,0,0,0,0,0,0,0,0,0,0,0,0,0,0,61,61,0.0,M2020-01-29D,Race(5),,
1,0,3,3,6,0,1,1,2,1,3,1,5,1,7,5,13,12,12,0.0,M2020-01-29D,Race(5),,
2,0,0,0,0,0,0,0,0,0,0,0,0,0,0,0,0,51,51,0.0,M2020-01-29D,Race(5),,
3,0,4,0,4,0,2,1,3,1,2,5,8,1,8,6,15,10,10,0.0,M2020-01-29D,Race(5),,
5,7,0,0,7,0,0,1,1,1,0,2,3,8,0,3,11,11,11,0.0,M2020-01-29D,Race(5),,
8,2,2,5,9,10,2,5,17,3,2,4,9,15,6,14,35,7,7,1.0,M2020-01-29D,Race(5),,
7,13,10,5,28,10,6,9,25,9,9,1,19,32,25,15,72,3.4,3.4,0.0,M2020-01-29D,Race(5),,
9,0,2,3,5,1,1,1,3,0,3,0,3,1,6,4,11,14,14,0.0,M2020-01-29D,Race(5),,
12,0,0,0,0,0,0,0,0,0,0,0,0,0,0,0,0,26,26,3.0,M2020-01-29D,Race(5),,
10,8,6,4,18,7,9,2,18,10,5,6,21,25,20,12,57,4,4,2.0,M2020-01-29D,Race(5),,
5,25,5,0,30,9,13,7,29,9,6,8,23,43,24,15,82,2.2,2.2,1.0,M2020-01-29D,Race(6),,
11,2,0,0,2,1,1,0,2,0,2,0,2,3,3,0,6,61,61,0.0,M2020-01-29D,Race(6),,
1,0,0,2,2,0,3,1,4,0,4,1,5,0,7,4,11,13,13,0.0,M2020-01-29D,Race(6),,
2,0,5,5,10,0,0,3,3,3,1,1,5,3,6,9,18,11,11,0.0,M2020-01-29D,Race(6),,
4,0,0,8,8,0,0,0,0,0,0,0,0,0,0,8,8,9,9,0.0,M2020-01-29D,Race(6),,
6,0,2,0,2,0,0,1,1,0,0,0,0,0,2,1,3,41,41,2.0,M2020-01-29D,Race(6),,
7,0,0,2,2,0,0,1,1,0,0,1,1,0,0,4,4,14,14,0.0,M2020-01-29D,Race(6),,
8,0,0,3,3,0,0,0,0,0,0,0,0,0,0,3,3,51,51,0.0,M2020-01-29D,Race(6),,
9,0,0,6,6,0,0,0,0,0,0,0,0,0,0,6,6,31,31,0.0,M2020-01-29D,Race(6),,
10,3,18,4,25,8,7,10,25,10,5,4,19,21,30,18,69,3,3,3.0,M2020-01-29D,Race(6),,
12,0,0,0,0,0,0,0,0,0,0,0,0,0,0,0,0,61,61,0.0,M2020-01-29D,Race(6),,
3,0,0,0,0,0,0,0,0,0,1,0,1,0,1,0,1,31,31,0.0,M2020-01-29D,Race(6),,
7,2,6,14,22,1,12,9,22,4,7,11,22,7,25,34,66,3.6,4,0.0,M2020-01-29D,Race(7),,
9,0,0,0,0,1,0,1,2,0,2,2,4,1,2,3,6,34,34,0.0,M2020-01-29D,Race(7),,
6,7,13,2,22,14,4,10,28,13,4,4,21,34,21,16,71,2.65,2.6,3.0,M2020-01-29D,Race(7),,
5,7,6,3,16,10,4,2,16,5,3,1,9,22,13,6,41,6,5.5,1.0,M2020-01-29D,Race(7),,
4,11,3,7,21,4,9,6,19,3,10,4,17,18,22,17,57,3.6,3.5,2.0,M2020-01-29D,Race(7),,
3,0,0,2,2,0,0,0,0,0,0,0,0,0,0,2,2,51,51,0.0,M2020-01-29D,Race(7),,
2,3,0,0,3,0,1,0,1,1,0,0,1,4,1,0,5,21,21,0.0,M2020-01-29D,Race(7),,
1,0,0,0,0,0,0,0,0,0,0,0,0,0,0,0,0,126,126,0.0,M2020-01-29D,Race(7),,
8,0,0,0,0,0,0,0,0,0,0,0,0,0,0,0,0,101,101,0.0,M2020-01-29D,Race(7),,
10,0,0,0,0,0,0,0,0,0,0,0,0,0,0,0,0,91,81,0.0,M2020-01-29D,Race(7),,
12,0,2,2,4,0,0,2,2,0,0,4,4,0,2,8,10,26,26,0.0,M2020-01-29D,Race(7),,
11,0,0,0,0,0,0,0,0,0,0,0,0,0,0,0,0,91,81,0.0,M2020-01-29D,Race(7),,
5,0,0,0,0,0,0,0,0,0,0,0,0,0,0,0,0,31,31,2.0,M2020-01-29D,Race(8),,
1,0,0,5,5,1,1,1,3,0,5,1,6,1,6,7,14,26,26,0.0,M2020-01-29D,Race(8),,
2,2,3,3,8,1,5,5,11,1,5,2,8,4,13,10,27,9,9,0.0,M2020-01-29D,Race(8),,
7,5,6,2,13,2,10,3,15,3,2,5,10,10,18,10,38,8,8,0.0,M2020-01-29D,Race(8),,
3,2,4,5,11,9,1,1,11,3,4,3,10,14,9,9,32,9.5,9.5,0.0,M2020-01-29D,Race(8),,
6,3,2,8,13,0,3,5,8,0,2,7,9,3,7,20,30,7.5,7.5,3.0,M2020-01-29D,Race(8),,
10,0,0,0,0,0,0,0,0,0,0,0,0,0,0,0,0,81,81,0.0,M2020-01-29D,Race(8),,
8,0,7,5,12,1,4,5,10,1,3,6,10,2,14,16,32,4.6,4.6,0.0,M2020-01-29D,Race(8),,
4,0,0,0,0,1,0,0,1,0,0,0,0,1,0,0,1,71,67,0.0,M2020-01-29D,Race(8),,
12,0,0,0,0,0,1,0,1,0,0,2,2,0,1,2,3,81,81,0.0,M2020-01-29D,Race(8),,
9,18,8,2,28,15,3,10,28,18,4,0,22,51,15,12,78,2.3,2.3,1.0,M2020-01-29D,Race(8),,
11,0,0,0,0,0,2,0,2,0,1,0,1,0,3,0,3,26,26,0.0,M2020-01-29D,Race(8),,
5,0,0,0,0,1,0,7,8,0,0,9,9,1,0,16,17,41,41,0.0,M2020-01-29D,Race(9),,
2,0,2,3,5,0,0,0,0,1,0,1,2,1,2,4,7,41,41,0.0,M2020-01-29D,Race(9),,
3,0,4,3,7,0,8,6,14,0,10,3,13,0,22,12,34,9.5,9.5,0.0,M2020-01-29D,Race(9),,
12,0,0,3,3,0,1,0,1,0,0,1,1,0,1,4,5,9.5,9.5,1.0,M2020-01-29D,Race(9),,
6,0,0,0,0,0,0,0,0,0,0,0,0,0,0,0,0,81,81,0.0,M2020-01-29D,Race(9),,
7,0,0,0,0,0,0,0,0,0,0,0,0,0,0,0,0,34,34,0.0,M2020-01-29D,Race(9),,
8,17,11,0,28,17,11,1,29,19,3,1,23,53,25,2,80,2.2,2.2,2.0,M2020-01-29D,Race(9),,
9,0,0,0,0,0,0,0,0,0,0,0,0,0,0,0,0,61,61,0.0,M2020-01-29D,Race(9),,
10,10,8,9,27,9,8,4,21,3,10,8,21,22,26,21,69,4.8,4.8,0.0,M2020-01-29D,Race(9),,
11,0,2,6,8,1,1,0,2,0,1,1,2,1,4,7,12,13,13,0.0,M2020-01-29D,Race(9),,
1,3,3,6,12,2,1,12,15,3,1,2,6,8,5,20,33,5,5,0.0,M2020-01-29D,Race(9),,
4,0,0,0,0,0,0,0,0,0,0,0,0,0,0,0,0,51,51,3.0,M2020-01-29D,Race(9),,
12,5,6,7,18,1,3,4,8,0,2,4,6,6,11,15,32,4.2,4.2,1.0,M2020-02-02D,Race(1),,
4,2,0,3,5,1,3,2,6,1,2,0,3,4,5,5,14,17,17,0.0,M2020-02-02D,Race(1),,
5,0,0,0,0,0,0,0,0,0,0,0,0,0,0,0,0,151,151,0.0,M2020-02-02D,Race(1),,
6,0,9,5,14,0,3,15,18,3,6,7,16,3,18,27,48,12,12,0.0,M2020-02-02D,Race(1),,
7,0,0,0,0,0,0,1,1,0,2,2,4,0,2,3,5,26,26,0.0,M2020-02-02D,Race(1),,
8,18,2,10,30,24,5,1,30,16,6,3,25,58,13,14,85,1.95,1.95,0.0,M2020-02-02D,Race(1),,
9,5,11,5,21,3,15,6,24,3,8,6,17,11,34,17,62,4,4,3.0,M2020-02-02D,Race(1),,
10,0,0,0,0,0,0,0,0,0,0,0,0,0,0,0,0,101,101,0.0,M2020-02-02D,Race(1),,
11,0,0,0,0,0,0,1,1,0,0,2,2,0,0,3,3,41,41,0.0,M2020-02-02D,Race(1),,
1,0,0,0,0,1,0,0,1,2,0,0,2,3,0,0,3,41,41,0.0,M2020-02-02D,Race(1),,
3,0,0,0,0,0,0,0,0,0,0,0,0,0,0,0,0,81,81,2.0,M2020-02-02D,Race(1),,
2,0,2,0,2,0,1,0,1,1,0,2,3,1,3,2,6,61,61,0.0,M2020-02-02D,Race(1),,
4,6,4,0,10,3,13,2,18,5,6,2,13,14,23,4,41,8,8,0.0,M2020-02-02D,Race(10),,
1,0,0,0,0,0,0,0,0,0,0,0,0,0,0,0,0,81,81,0.0,M2020-02-02D,Race(10),,
5,0,0,0,0,0,0,0,0,0,0,0,0,0,0,0,0,51,51,0.0,M2020-02-02D,Race(10),,
6,3,5,13,21,8,2,6,16,8,5,7,20,19,12,26,57,4,4,2.0,M2020-02-02D,Race(10),,
7,6,14,5,25,16,10,3,29,5,10,6,21,27,34,14,75,4.4,4.5,0.0,M2020-02-02D,Race(10),,
8,13,7,4,24,1,3,14,18,4,4,3,11,18,14,21,53,3.4,3.4,0.0,M2020-02-02D,Race(10),,
9,0,0,0,0,0,0,0,0,0,0,0,0,0,0,0,0,31,31,0.0,M2020-02-02D,Race(10),,
11,0,0,0,0,0,0,0,0,0,0,0,0,0,0,0,0,101,101,0.0,M2020-02-02D,Race(10),,
10,0,0,0,0,1,0,0,1,0,0,1,1,1,0,1,2,21,21,1.0,M2020-02-02D,Race(10),,
12,0,0,2,2,0,0,0,0,0,0,0,0,0,0,2,2,17,17,0.0,M2020-02-02D,Race(10),,
13,0,0,0,0,0,0,0,0,0,0,0,0,0,0,0,0,26,26,3.0,M2020-02-02D,Race(10),,
14,0,0,0,0,0,0,0,0,0,0,0,0,0,0,0,0,51,51,0.0,M2020-02-02D,Race(10),,
2,2,0,0,2,1,0,0,1,3,0,0,3,6,0,0,6,21,21,0.0,M2020-02-02D,Race(10),,
3,0,0,6,6,0,2,5,7,1,1,7,9,1,3,18,22,10,10,0.0,M2020-02-02D,Race(10),,
12,0,0,3,3,0,1,1,2,0,0,1,1,0,1,5,6,13,13,0.0,M2020-02-02D,Race(2),,
11,0,0,0,0,0,0,0,0,0,0,0,0,0,0,0,0,81,81,0.0,M2020-02-02D,Race(2),,
10,3,0,0,3,2,0,3,5,3,1,3,7,8,1,6,15,11,11,1.0,M2020-02-02D,Race(2),,
9,0,0,0,0,0,0,2,2,0,0,2,2,0,0,4,4,9.5,9.5,2.0,M2020-02-02D,Race(2),,
8,0,0,0,0,0,0,0,0,0,2,0,2,0,2,0,2,26,26,0.0,M2020-02-02D,Race(2),,
7,0,0,0,0,0,0,2,2,0,0,3,3,0,0,5,5,41,41,0.0,M2020-02-02D,Race(2),,
6,7,8,5,20,0,3,15,18,0,2,9,11,7,13,29,49,3.8,3.8,3.0,M2020-02-02D,Race(2),,
5,0,0,3,3,0,0,0,0,0,0,0,0,0,0,3,3,126,126,0.0,M2020-02-02D,Race(2),,
4,0,2,0,2,0,0,0,0,0,0,0,0,0,2,0,2,61,61,0.0,M2020-02-02D,Race(2),,
3,5,5,17,27,6,19,5,30,4,15,5,24,15,39,27,81,6,6,0.0,M2020-02-02D,Race(2),,
2,0,0,2,2,0,0,1,1,0,0,2,2,0,0,5,5,21,21,0.0,M2020-02-02D,Race(2),,
1,15,15,0,30,22,7,1,30,19,6,1,26,56,28,2,86,2.3,2.3,0.0,M2020-02-02D,Race(2),,
14,0,0,0,0,0,0,0,0,0,0,0,0,0,0,0,0,61,61,0.0,M2020-02-02D,Race(3),,
8,11,8,3,22,6,7,15,28,9,3,10,22,26,18,28,72,4.2,4.2,1.0,M2020-02-02D,Race(3),,
6,0,0,0,0,0,0,0,0,0,0,0,0,0,0,0,0,41,41,0.0,M2020-02-02D,Race(3),,
5,3,2,0,5,1,0,1,2,2,1,2,5,6,3,3,12,19,19,2.0,M2020-02-02D,Race(3),,
4,0,0,3,3,0,0,0,0,1,0,0,1,1,0,3,4,51,51,0.0,M2020-02-02D,Race(3),,
3,0,8,17,25,2,14,7,23,0,12,6,18,2,34,30,66,4.2,4.2,3.0,M2020-02-02D,Race(3),,
2,11,10,2,23,21,6,3,30,13,6,5,24,45,22,10,77,2.5,2.7,0.0,M2020-02-02D,Race(3),,
1,0,0,0,0,0,0,0,0,0,0,0,0,0,0,0,0,81,81,0.0,M2020-02-02D,Race(3),,
11,5,0,0,5,0,0,0,0,0,0,0,0,5,0,0,5,17,17,0.0,M2020-02-02D,Race(3),,
12,0,0,0,0,0,0,0,0,0,0,0,0,0,0,0,0,61,61,0.0,M2020-02-02D,Race(3),,
7,0,0,0,0,0,0,0,0,0,0,0,0,0,0,0,0,101,101,0.0,M2020-02-02D,Race(3),,
9,0,2,0,2,0,0,1,1,0,0,1,1,0,2,2,4,31,31,0.0,M2020-02-02D,Race(3),,
13,0,0,3,3,0,1,1,2,0,0,0,0,0,1,4,5,9,9,0.0,M2020-02-02D,Race(3),,
10,0,0,2,2,0,2,2,4,1,4,2,7,1,6,6,13,13,13,0.0,M2020-02-02D,Race(3),,
7,0,0,0,0,0,0,3,3,2,2,1,5,2,2,4,8,17,17,0.0,M2020-02-02D,Race(4),,
5,0,0,0,0,0,0,0,0,0,0,0,0,0,0,0,0,21,21,3.0,M2020-02-02D,Race(4),,
1,0,0,0,0,1,0,0,1,0,0,0,0,1,0,0,1,34,34,0.0,M2020-02-02D,Race(4),,
2,8,11,0,19,1,10,14,25,0,8,12,20,9,29,26,64,5.5,5.5,0.0,M2020-02-02D,Race(4),,
3,8,5,13,26,21,5,3,29,16,4,2,22,45,14,18,77,4.6,4.8,1.0,M2020-02-02D,Race(4),,
9,0,0,0,0,0,0,2,2,0,0,2,2,0,0,4,4,41,41,0.0,M2020-02-02D,Race(4),,
10,3,0,2,5,1,0,1,2,2,1,0,3,6,1,3,10,7.5,7.5,0.0,M2020-02-02D,Race(4),,
6,0,2,3,5,1,0,0,1,1,0,0,1,2,2,3,7,26,26,0.0,M2020-02-02D,Race(4),,
11,0,0,0,0,0,0,0,0,0,1,0,1,0,1,0,1,61,61,0.0,M2020-02-02D,Race(4),,
12,0,2,0,2,0,0,0,0,0,0,1,1,0,2,1,3,41,41,0.0,M2020-02-02D,Race(4),,
13,0,0,0,0,0,0,0,0,0,0,0,0,0,0,0,0,26,26,0.0,M2020-02-02D,Race(4),,
14,11,5,7,23,5,14,7,26,5,10,7,22,21,29,21,71,2.7,2.8,2.0,M2020-02-02D,Race(4),,
4,0,2,2,4,0,1,0,1,0,0,1,1,0,3,3,6,17,17,0.0,M2020-02-02D,Race(4),,
8,0,3,3,6,0,0,0,0,0,0,0,0,0,3,3,6,16,16,0.0,M2020-02-02D,Race(4),,
8,2,2,2,6,0,1,15,16,1,1,6,8,3,4,23,30,8,8,0.0,M2020-02-02D,Race(5),,
7,0,0,0,0,0,0,0,0,0,0,0,0,0,0,0,0,71,67,0.0,M2020-02-02D,Race(5),,
9,0,0,0,0,0,0,0,0,0,0,0,0,0,0,0,0,71,67,0.0,M2020-02-02D,Race(5),,
6,0,0,0,0,0,0,0,0,0,0,0,0,0,0,0,0,151,151,0.0,M2020-02-02D,Race(5),,
11,0,2,0,2,0,0,0,0,0,1,0,1,0,3,0,3,51,67,0.0,M2020-02-02D,Race(5),,
5,13,11,2,26,24,5,0,29,13,9,1,23,50,25,3,78,2.6,2.6,2.0,M2020-02-02D,Race(5),,
10,0,0,0,0,0,2,2,4,1,2,2,5,1,4,4,9,17,17,0.0,M2020-02-02D,Race(5),,
3,2,0,9,11,1,0,3,4,3,1,4,8,6,1,16,23,13,13,3.0,M2020-02-02D,Race(5),,
2,0,0,3,3,0,0,1,1,0,0,0,0,0,0,4,4,16,16,0.0,M2020-02-02D,Race(5),,
1,2,2,8,12,0,0,6,6,0,2,9,11,2,4,23,29,14,14,0.0,M2020-02-02D,Race(5),,
4,11,13,6,30,5,22,3,30,8,10,4,22,24,45,13,82,2.25,2.25,1.0,M2020-02-02D,Race(5),,
4,0,0,0,0,0,0,0,0,0,0,0,0,0,0,0,0,31,31,0.0,M2020-02-02D,Race(6),,
2,0,0,4,4,0,1,3,4,0,1,2,3,0,2,9,11,11,11,0.0,M2020-02-02D,Race(6),,
6,0,0,0,0,0,0,0,0,0,0,0,0,0,0,0,0,31,41,0.0,M2020-02-02D,Race(6),,
7,12,8,6,26,21,6,2,29,17,4,1,22,50,18,9,77,4.4,4.4,3.0,M2020-02-02D,Race(6),,
12,0,2,0,2,1,1,0,2,1,1,0,2,2,4,0,6,16,16,2.0,M2020-02-02D,Race(6),,
8,0,0,6,6,0,1,2,3,0,2,3,5,0,3,11,14,21,21,0.0,M2020-02-02D,Race(6),,
9,0,0,0,0,0,0,0,0,0,0,1,1,0,0,1,1,21,21,0.0,M2020-02-02D,Race(6),,
10,0,3,0,3,0,0,0,0,0,0,1,1,0,3,1,4,15,17,0.0,M2020-02-02D,Race(6),,
11,0,0,0,0,0,0,0,0,0,1,1,2,0,1,1,2,21,21,0.0,M2020-02-02D,Race(6),,
13,2,9,8,19,5,15,6,26,3,8,7,18,10,32,21,63,3.1,3.1,1.0,M2020-02-02D,Race(6),,
1,14,8,6,28,2,6,17,25,4,7,9,20,20,21,32,73,4.4,4.4,0.0,M2020-02-02D,Race(6),,
14,0,0,0,0,0,0,0,0,0,1,0,1,0,1,0,1,41,41,0.0,M2020-02-02D,Race(6),,
3,0,0,0,0,0,0,0,0,1,0,0,1,1,0,0,1,71,71,0.0,M2020-02-02D,Race(6),,
5,2,0,0,2,1,0,0,1,0,1,1,2,3,1,1,5,19,19,0.0,M2020-02-02D,Race(6),,
1,8,14,6,28,16,7,6,29,11,6,6,23,35,27,18,80,2.8,2.8,2.0,M2020-02-02D,Race(7),,
11,4,4,12,20,5,2,14,21,3,4,6,13,12,10,32,54,11,11,0.0,M2020-02-02D,Race(7),,
12,0,0,0,0,0,0,2,2,0,0,2,2,0,0,4,4,17,17,0.0,M2020-02-02D,Race(7),,
9,0,0,0,0,0,0,0,0,0,0,0,0,0,0,0,0,126,126,0.0,M2020-02-02D,Race(7),,
13,0,0,0,0,0,0,0,0,0,0,0,0,0,0,0,0,51,51,0.0,M2020-02-02D,Race(7),,
10,0,0,0,0,0,1,0,1,0,0,2,2,0,1,2,3,26,26,1.0,M2020-02-02D,Race(7),,
5,0,0,0,0,0,1,1,2,0,1,0,1,0,2,1,3,34,35,0.0,M2020-02-02D,Race(7),,
7,0,0,2,2,0,0,4,4,1,1,5,7,1,1,11,13,16,16,0.0,M2020-02-02D,Race(7),,
6,0,0,0,0,0,0,0,0,0,1,1,2,0,1,1,2,81,81,0.0,M2020-02-02D,Race(7),,
4,2,0,0,2,0,0,0,0,0,1,0,1,2,1,0,3,17,21,0.0,M2020-02-02D,Race(7),,
3,2,0,10,12,0,1,2,3,0,3,1,4,2,4,13,19,6,6,3.0,M2020-02-02D,Race(7),,
2,0,0,0,0,0,0,0,0,1,0,0,1,1,0,0,1,71,71,0.0,M2020-02-02D,Race(7),,
8,14,12,0,26,9,18,1,28,10,9,3,22,33,39,4,76,2.5,2.5,0.0,M2020-02-02D,Race(7),,
7,0,0,0,0,0,0,0,0,0,0,0,0,0,0,0,0,34,34,0.0,M2020-02-02D,Race(8),,
5,5,3,9,17,2,4,3,9,1,5,3,9,8,12,15,35,3.4,3.4,3.0,M2020-02-02D,Race(8),,
4,2,0,0,2,0,0,0,0,0,1,0,1,2,1,0,3,91,91,0.0,M2020-02-02D,Race(8),,
3,0,0,0,0,0,0,0,0,0,1,0,1,0,1,0,1,21,21,0.0,M2020-02-02D,Race(8),,
2,2,0,9,11,5,4,11,20,7,2,5,14,14,6,25,45,8.5,8.5,1.0,M2020-02-02D,Race(8),,
1,0,6,0,6,5,1,3,9,5,2,3,10,10,9,6,25,12,12,0.0,M2020-02-02D,Race(8),,
13,0,0,0,0,0,0,0,0,0,0,0,0,0,0,0,0,81,81,0.0,M2020-02-02D,Race(8),,
6,0,0,0,0,0,0,0,0,0,0,0,0,0,0,0,0,151,201,0.0,M2020-02-02D,Race(8),,
12,11,7,0,18,14,6,6,26,5,5,9,19,30,18,15,63,3.8,3.8,0.0,M2020-02-02D,Race(8),,
8,10,7,5,22,2,12,3,17,4,4,1,9,16,23,9,48,5,5,2.0,M2020-02-02D,Race(8),,
9,0,0,0,0,0,0,0,0,1,0,0,1,1,0,0,1,26,26,0.0,M2020-02-02D,Race(8),,
10,0,3,5,8,0,3,4,7,1,6,5,12,1,12,14,27,8,8,0.0,M2020-02-02D,Race(8),,
14,0,2,0,2,0,0,0,0,0,0,0,0,0,2,0,2,81,81,0.0,M2020-02-02D,Race(8),,
11,0,2,2,4,2,0,0,2,2,0,0,2,4,2,2,8,26,26,0.0,M2020-02-02D,Race(8),,
11,0,0,2,2,0,0,0,0,0,0,0,0,0,0,2,2,34,34,3.0,M2020-02-02D,Race(9),,
12,0,8,15,23,0,1,25,26,1,3,14,18,1,12,54,67,5,5,0.0,M2020-02-02D,Race(9),,
10,0,2,3,5,0,0,1,1,0,1,4,5,0,3,8,11,17,17,0.0,M2020-02-02D,Race(9),,
6,0,0,0,0,0,0,0,0,0,0,0,0,0,0,0,0,26,26,0.0,M2020-02-02D,Race(9),,
1,2,13,5,20,7,21,1,29,6,13,3,22,15,47,9,71,6.5,6.5,2.0,M2020-02-02D,Race(9),,
3,0,0,0,0,0,1,0,1,0,0,0,0,0,1,0,1,31,31,0.0,M2020-02-02D,Race(9),,
8,28,2,0,30,23,6,1,30,18,6,1,25,69,14,2,85,1.7,1.7,1.0,M2020-02-02D,Race(9),,
9,0,3,2,5,0,1,0,1,0,1,1,2,0,5,3,8,15,15,0.0,M2020-02-02D,Race(9),,
4,0,2,0,2,0,0,1,1,1,0,1,2,1,2,2,5,31,31,0.0,M2020-02-02D,Race(9),,
7,0,0,3,3,0,0,0,0,0,1,0,1,0,1,3,4,26,26,0.0,M2020-02-02D,Race(9),,
5,0,0,0,0,0,0,0,0,0,0,0,0,0,0,0,0,101,101,0.0,M2020-02-02D,Race(9),,
2,0,0,0,0,0,0,1,1,0,1,2,3,0,1,3,4,34,34,0.0,M2020-02-02D,Race(9),,
8,10,14,2,26,11,4,10,25,9,2,7,18,30,20,19,69,4.2,4.2,0.0,M2020-02-05D,Race(1),,
3,2,0,0,2,1,3,0,4,1,2,5,8,4,5,5,14,9.5,9.5,0.0,M2020-02-05D,Race(1),,
4,5,0,7,12,0,3,0,3,4,5,0,9,9,8,7,24,4.8,4.8,2.0,M2020-02-05D,Race(1),,
5,8,2,2,12,1,4,4,9,2,5,2,9,11,11,8,30,8,8,0.0,M2020-02-05D,Race(1),,
6,0,0,0,0,9,0,4,13,1,0,5,6,10,0,9,19,51,51,0.0,M2020-02-05D,Race(1),,
7,0,0,2,2,1,1,0,2,3,1,0,4,4,2,2,8,61,61,0.0,M2020-02-05D,Race(1),,
10,0,2,0,2,1,0,0,1,2,0,1,3,3,2,1,6,8,8,0.0,M2020-02-05D,Race(1),,
11,0,0,0,0,0,0,0,0,0,0,0,0,0,0,0,0,41,41,1.0,M2020-02-05D,Race(1),,
12,0,5,6,11,0,1,0,1,0,1,2,3,0,7,8,15,9,9,3.0,M2020-02-05D,Race(1),,
1,2,5,3,10,6,11,4,21,3,1,1,5,11,17,8,36,7.5,7.5,0.0,M2020-02-05D,Race(1),,
9,3,2,8,13,1,5,5,11,0,9,3,12,4,16,16,36,7,7,0.0,M2020-02-05D,Race(1),,
2,0,0,0,0,0,0,0,0,1,0,0,1,1,0,0,1,34,34,0.0,M2020-02-05D,Race(1),,
8,12,13,2,27,14,12,3,29,4,13,4,21,30,38,9,77,3.6,3.6,1.0,M2020-02-05D,Race(2),,
5,0,3,6,9,1,10,12,23,3,4,6,13,4,17,24,45,11,11,0.0,M2020-02-05D,Race(2),,
7,0,0,0,0,0,0,0,0,0,0,0,0,0,0,0,0,126,126,0.0,M2020-02-05D,Race(2),,
6,18,4,5,27,15,4,9,28,18,4,2,24,51,12,16,79,2.2,2.2,0.0,M2020-02-05D,Race(2),,
1,0,0,0,0,0,0,0,0,0,0,0,0,0,0,0,0,51,51,0.0,M2020-02-05D,Race(2),,
12,0,5,6,11,0,2,3,5,0,3,8,11,0,10,17,27,11,11,3.0,M2020-02-05D,Race(2),,
11,0,0,3,3,0,0,0,0,0,0,3,3,0,0,6,6,14,15,0.0,M2020-02-05D,Race(2),,
10,0,5,5,10,0,1,0,1,0,1,0,1,0,7,5,12,10,10,2.0,M2020-02-05D,Race(2),,
2,0,0,3,3,0,0,2,2,0,0,0,0,0,0,5,5,12,12,0.0,M2020-02-05D,Race(2),,
3,0,0,0,0,0,0,0,0,1,0,0,1,1,0,0,1,101,101,0.0,M2020-02-05D,Race(2),,
4,0,0,0,0,0,0,0,0,0,0,0,0,0,0,0,0,34,34,0.0,M2020-02-05D,Race(2),,
9,0,0,0,0,0,1,1,2,0,1,3,4,0,2,4,6,21,21,0.0,M2020-02-05D,Race(2),,
8,0,0,0,0,0,0,0,0,1,0,2,3,1,0,2,3,10,10,1.0,M2020-02-05D,Race(3),,
4,0,0,0,0,0,0,0,0,0,0,0,0,0,0,0,0,71,67,0.0,M2020-02-05D,Race(3),,
9,2,4,9,15,10,6,7,23,3,6,4,13,15,16,20,51,10,10,0.0,M2020-02-05D,Race(3),,
3,7,8,0,15,1,6,4,11,1,5,3,9,9,19,7,35,6.5,6.5,2.0,M2020-02-05D,Race(3),,
12,0,0,0,0,0,0,0,0,0,0,0,0,0,0,0,0,41,41,0.0,M2020-02-05D,Race(3),,
7,0,0,3,3,0,0,1,1,0,1,1,2,0,1,5,6,9,9,0.0,M2020-02-05D,Race(3),,
10,0,0,4,4,0,2,0,2,1,3,3,7,1,5,7,13,21,21,0.0,M2020-02-05D,Race(3),,
6,5,3,0,8,5,3,8,16,5,1,1,7,15,7,9,31,7,7,0.0,M2020-02-05D,Race(3),,
2,0,5,0,5,1,1,2,4,1,1,3,5,2,7,5,14,8.5,8.5,3.0,M2020-02-05D,Race(3),,
1,3,3,8,14,1,3,3,7,3,5,4,12,7,11,15,33,15,15,0.0,M2020-02-05D,Race(3),,
11,10,3,3,16,7,8,4,19,7,3,4,14,24,14,11,49,5,5,0.0,M2020-02-05D,Race(3),,
5,3,4,3,10,5,1,1,7,4,1,1,6,12,6,5,23,5,5,0.0,M2020-02-05D,Race(3),,
1,2,9,8,19,1,2,10,13,4,2,4,10,7,13,22,42,5,5,0.0,M2020-02-05D,Race(4),,
2,0,0,0,0,0,0,0,0,1,0,0,1,1,0,0,1,101,101,0.0,M2020-02-05D,Race(4),,
3,15,8,3,26,10,9,3,22,11,8,4,23,36,25,10,71,3.3,3.3,3.0,M2020-02-05D,Race(4),,
4,3,3,5,11,2,0,0,2,3,2,3,8,8,5,8,21,8.5,8.5,1.0,M2020-02-05D,Race(4),,
6,0,0,2,2,0,0,1,1,0,0,0,0,0,0,3,3,31,31,0.0,M2020-02-05D,Race(4),,
8,2,0,0,2,0,1,2,3,0,1,4,5,2,2,6,10,15,15,0.0,M2020-02-05D,Race(4),,
9,0,0,5,5,4,10,6,20,4,4,6,14,8,14,17,39,11,11,2.0,M2020-02-05D,Race(4),,
10,0,0,0,0,0,0,0,0,0,0,0,0,0,0,0,0,71,67,0.0,M2020-02-05D,Race(4),,
11,0,4,0,4,0,0,0,0,1,0,1,2,1,4,1,6,17,17,0.0,M2020-02-05D,Race(4),,
12,0,0,5,5,0,0,0,0,0,0,1,1,0,0,6,6,12,12,0.0,M2020-02-05D,Race(4),,
5,8,6,2,16,13,8,2,23,2,9,3,14,23,23,7,53,3.4,3.4,0.0,M2020-02-05D,Race(4),,
7,0,0,0,0,0,0,0,0,0,0,0,0,0,0,0,0,126,126,0.0,M2020-02-05D,Race(4),,
6,0,0,0,0,1,0,0,1,0,0,0,0,1,0,0,1,31,31,0.0,M2020-02-05D,Race(5),,
8,0,0,0,0,0,0,0,0,0,0,0,0,0,0,0,0,81,81,0.0,M2020-02-05D,Race(5),,
7,0,0,0,0,0,0,0,0,0,0,0,0,0,0,0,0,51,51,0.0,M2020-02-05D,Race(5),,
12,3,0,0,3,0,0,0,0,0,0,0,0,3,0,0,3,19,19,0.0,M2020-02-05D,Race(5),,
4,0,6,9,15,8,14,5,27,7,10,3,20,15,30,17,62,5,5,2.0,M2020-02-05D,Race(5),,
11,2,0,0,2,0,0,0,0,0,0,0,0,2,0,0,2,31,31,0.0,M2020-02-05D,Race(5),,
5,15,5,0,20,3,2,9,14,5,1,1,7,23,8,10,41,2.8,2.8,3.0,M2020-02-05D,Race(5),,
3,0,2,8,10,0,1,3,4,0,0,5,5,0,3,16,19,13,13,0.0,M2020-02-05D,Race(5),,
2,0,8,0,8,10,5,4,19,6,3,3,12,16,16,7,39,10,10,0.0,M2020-02-05D,Race(5),,
1,8,4,8,20,6,7,4,17,2,7,5,14,16,18,17,51,5,5,1.0,M2020-02-05D,Race(5),,
9,0,0,5,5,1,1,1,3,1,1,2,4,2,2,8,12,13,13,0.0,M2020-02-05D,Race(5),,
10,2,5,0,7,1,0,4,5,5,4,7,16,8,9,11,28,8.5,8.5,0.0,M2020-02-05D,Race(5),,
4,0,7,7,14,10,5,6,21,13,8,4,25,23,20,17,60,7.5,7.5,0.0,M2020-02-05D,Race(6),,
5,0,0,2,2,0,2,1,3,0,1,3,4,0,3,6,9,21,21,1.0,M2020-02-05D,Race(6),,
2,0,0,3,3,0,0,0,0,0,0,0,0,0,0,3,3,14,14,0.0,M2020-02-05D,Race(6),,
7,0,0,0,0,0,1,0,1,1,0,0,1,1,1,0,2,19,19,0.0,M2020-02-05D,Race(6),,
3,4,3,8,15,3,1,2,6,3,0,3,6,10,4,13,27,7.5,7.5,0.0,M2020-02-05D,Race(6),,
8,0,0,0,0,0,0,0,0,0,0,0,0,0,0,0,0,81,81,0.0,M2020-02-05D,Race(6),,
9,15,2,0,17,3,6,10,19,3,8,6,17,21,16,16,53,3.4,3.4,0.0,M2020-02-05D,Race(6),,
10,0,3,0,3,0,0,0,0,0,0,0,0,0,3,0,3,13,13,0.0,M2020-02-05D,Race(6),,
6,9,0,7,16,10,5,6,21,3,7,5,15,22,12,18,52,5,5,0.0,M2020-02-05D,Race(6),,
11,0,3,0,3,0,0,3,3,1,0,3,4,1,3,6,10,26,26,3.0,M2020-02-05D,Race(6),,
1,2,2,0,4,1,0,0,1,1,1,0,2,4,3,0,7,13,13,2.0,M2020-02-05D,Race(6),,
12,0,10,3,13,3,10,2,15,1,1,2,4,4,21,7,32,7,7,0.0,M2020-02-05D,Race(6),,
9,0,0,0,0,0,0,0,0,0,0,0,0,0,0,0,0,26,26,0.0,M2020-02-05D,Race(7),,
1,0,0,2,2,0,1,3,4,3,2,2,7,3,3,7,13,15,15,2.0,M2020-02-05D,Race(7),,
8,0,0,3,3,0,0,0,0,0,0,1,1,0,0,4,4,41,41,0.0,M2020-02-05D,Race(7),,
4,5,0,11,16,4,8,2,14,4,9,1,14,13,17,14,44,5,5,0.0,M2020-02-05D,Race(7),,
5,0,0,0,0,0,0,0,0,0,0,0,0,0,0,0,0,34,34,0.0,M2020-02-05D,Race(7),,
7,2,4,2,8,3,3,10,16,2,1,6,9,7,8,18,33,7.5,7.5,3.0,M2020-02-05D,Race(7),,
3,15,6,0,21,11,4,5,20,11,7,2,20,37,17,7,61,2.3,2.3,0.0,M2020-02-05D,Race(7),,
10,0,0,0,0,0,0,0,0,0,0,0,0,0,0,0,0,61,61,0.0,M2020-02-05D,Race(7),,
6,0,0,2,2,0,0,0,0,0,0,0,0,0,0,2,2,41,41,0.0,M2020-02-05D,Race(7),,
12,0,0,0,0,0,0,0,0,0,0,0,0,0,0,0,0,81,81,0.0,M2020-02-05D,Race(7),,
2,2,8,8,18,2,12,4,18,2,6,5,13,6,26,17,49,11,11,0.0,M2020-02-05D,Race(7),,
11,6,12,2,20,10,2,6,18,4,1,8,13,20,15,16,51,4.8,4.8,1.0,M2020-02-05D,Race(7),,
1,2,4,12,18,8,6,8,22,1,6,8,15,11,16,28,55,8.5,8.5,0.0,M2020-02-05D,Race(8),,
3,0,3,0,3,0,0,0,0,1,1,0,2,1,4,0,5,26,26,0.0,M2020-02-05D,Race(8),,
2,0,0,0,0,0,0,0,0,1,0,0,1,1,0,0,1,81,81,0.0,M2020-02-05D,Race(8),,
12,0,0,3,3,0,0,0,0,0,0,1,1,0,0,4,4,34,34,0.0,M2020-02-05D,Race(8),,
11,0,0,0,0,0,0,0,0,0,0,0,0,0,0,0,0,81,81,0.0,M2020-02-05D,Race(8),,
9,0,3,0,3,0,0,1,1,0,0,2,2,0,3,3,6,10,10,3.0,M2020-02-05D,Race(8),,
8,16,5,3,24,11,5,12,28,9,8,4,21,36,18,19,73,2.1,2.1,1.0,M2020-02-05D,Race(8),,
7,0,0,0,0,1,0,0,1,0,0,1,1,1,0,1,2,26,26,0.0,M2020-02-05D,Race(8),,
6,0,7,7,14,1,10,5,16,0,5,5,10,1,22,17,40,12,12,0.0,M2020-02-05D,Race(8),,
5,0,0,0,0,0,0,0,0,0,0,0,0,0,0,0,0,61,61,0.0,M2020-02-05D,Race(8),,
4,12,8,5,25,9,9,4,22,14,6,5,25,35,23,14,72,2.9,2.9,2.0,M2020-02-05D,Race(8),,
10,0,0,0,0,0,0,0,0,0,0,0,0,0,0,0,0,126,126,0.0,M2020-02-05D,Race(8),,
2,0,2,0,2,0,1,2,3,0,0,1,1,0,3,3,6,17,17,0.0,M2020-02-08D,Race(1),,
5,0,0,0,0,0,0,0,0,0,0,0,0,0,0,0,0,71,67,0.0,M2020-02-08D,Race(1),,
6,26,2,2,30,28,0,0,28,22,1,1,24,76,3,3,82,1.8,1.8,0.0,M2020-02-08D,Race(1),,
7,2,7,5,14,0,2,3,5,1,6,3,10,3,15,11,29,9.5,10,0.0,M2020-02-08D,Race(1),,
8,0,2,0,2,0,4,1,5,0,5,3,8,0,11,4,15,26,26,3.0,M2020-02-08D,Race(1),,
9,2,11,12,25,1,13,8,22,3,5,7,15,6,29,27,62,10,10,0.0,M2020-02-08D,Race(1),,
10,0,0,2,2,0,0,0,0,0,0,0,0,0,0,2,2,61,61,0.0,M2020-02-08D,Race(1),,
11,0,0,0,0,0,0,0,0,0,0,0,0,0,0,0,0,51,51,0.0,M2020-02-08D,Race(1),,
12,0,0,3,3,0,4,3,7,0,4,8,12,0,8,14,22,5.5,5.5,1.0,M2020-02-08D,Race(1),,
13,0,0,0,0,0,0,0,0,0,0,0,0,0,0,0,0,81,81,0.0,M2020-02-08D,Race(1),,
14,0,3,0,3,0,0,0,0,0,2,0,2,0,5,0,5,19,19,0.0,M2020-02-08D,Race(1),,
4,0,3,0,3,1,5,10,16,0,1,1,2,1,9,11,21,26,26,0.0,M2020-02-08D,Race(1),,
3,0,0,6,6,0,1,3,4,0,2,2,4,0,3,11,14,15,15,2.0,M2020-02-08D,Race(1),,
1,0,0,0,0,0,0,0,0,0,0,0,0,0,0,0,0,41,41,0.0,M2020-02-08D,Race(1),,
7,0,3,5,8,0,1,0,1,0,1,0,1,0,5,5,10,23,26,2.0,M2020-02-08D,Race(10),,
14,0,0,0,0,0,0,0,0,0,0,1,1,0,0,1,1,26,26,0.0,M2020-02-08D,Race(10),,
10,0,0,0,0,0,0,0,0,0,0,0,0,0,0,0,0,101,101,0.0,M2020-02-08D,Race(10),,
11,0,8,7,15,0,1,5,6,0,3,5,8,0,12,17,29,6.5,6.5,1.0,M2020-02-08D,Race(10),,
12,0,0,0,0,0,0,0,0,0,0,1,1,0,0,1,1,151,151,0.0,M2020-02-08D,Race(10),,
8,0,2,0,2,0,0,1,1,0,1,2,3,0,3,3,6,81,81,0.0,M2020-02-08D,Race(10),,
2,3,8,2,13,3,18,3,24,1,12,3,16,7,38,8,53,9.5,10,0.0,M2020-02-08D,Race(10),,
6,0,4,3,7,0,0,9,9,0,2,7,9,0,6,19,25,9.5,10,0.0,M2020-02-08D,Race(10),,
5,0,0,0,0,0,1,1,2,0,2,1,3,0,3,2,5,51,51,3.0,M2020-02-08D,Race(10),,
13,0,0,0,0,0,0,0,0,0,0,0,0,0,0,0,0,151,201,0.0,M2020-02-08D,Race(10),,
9,2,3,6,11,1,3,3,7,0,2,2,4,3,8,11,22,8.5,8.5,0.0,M2020-02-08D,Race(10),,
4,0,2,2,4,0,0,0,0,0,0,0,0,0,2,2,4,34,34,0.0,M2020-02-08D,Race(10),,
3,25,0,2,27,26,3,1,30,24,1,1,26,75,4,4,83,1.7,1.65,0.0,M2020-02-08D,Race(10),,
1,0,0,3,3,0,3,7,10,1,2,3,6,1,5,13,19,23,26,0.0,M2020-02-08D,Race(10),,
4,14,6,0,20,18,3,4,25,8,7,3,18,40,16,7,63,5,5,0.0,M2020-02-08D,Race(2),,
10,2,0,0,2,0,3,3,6,0,3,3,6,2,6,6,14,21,21,3.0,M2020-02-08D,Race(2),,
11,0,0,8,8,0,3,1,4,2,4,1,7,2,7,10,19,10,10,0.0,M2020-02-08D,Race(2),,
12,0,0,0,0,0,0,0,0,0,0,0,0,0,0,0,0,26,34,0.0,M2020-02-08D,Race(2),,
14,0,0,0,0,0,0,0,0,0,0,0,0,0,0,0,0,101,101,0.0,M2020-02-08D,Race(2),,
7,0,7,3,10,3,3,12,18,4,3,3,10,7,13,18,38,5.5,5.5,1.0,M2020-02-08D,Race(2),,
5,6,9,4,19,6,16,0,22,6,4,1,11,18,29,5,52,4,4,0.0,M2020-02-08D,Race(2),,
1,0,3,5,8,1,1,0,2,0,3,0,3,1,7,5,13,11,11,0.0,M2020-02-08D,Race(2),,
2,0,2,0,2,0,0,0,0,1,0,0,1,1,2,0,3,26,26,0.0,M2020-02-08D,Race(2),,
3,3,0,6,9,2,0,6,8,4,1,7,12,9,1,19,29,14,14,0.0,M2020-02-08D,Race(2),,
13,0,0,0,0,0,0,0,0,0,0,1,1,0,0,1,1,26,26,0.0,M2020-02-08D,Race(2),,
6,0,0,0,0,0,0,0,0,1,0,0,1,1,0,0,1,26,26,0.0,M2020-02-08D,Race(2),,
8,5,3,2,10,0,1,4,5,0,1,5,6,5,5,11,21,9,9,2.0,M2020-02-08D,Race(2),,
9,0,0,2,2,0,0,0,0,0,0,2,2,0,0,4,4,14,14,0.0,M2020-02-08D,Race(2),,
5,3,2,3,8,0,0,0,0,0,0,1,1,3,2,4,9,20,21,0.0,M2020-02-08D,Race(3),,
8,9,3,0,12,1,2,2,5,0,3,4,7,10,8,6,24,8.5,8.5,0.0,M2020-02-08D,Race(3),,
9,3,3,12,18,3,3,15,21,6,5,4,15,12,11,31,54,9,9,0.0,M2020-02-08D,Race(3),,
10,0,0,0,0,0,0,0,0,0,0,0,0,0,0,0,0,91,101,0.0,M2020-02-08D,Race(3),,
11,3,3,2,8,1,11,0,12,0,5,5,10,4,19,7,30,6.5,6.5,1.0,M2020-02-08D,Race(3),,
12,0,0,2,2,0,0,0,0,0,0,0,0,0,0,2,2,21,21,0.0,M2020-02-08D,Race(3),,
1,2,5,5,12,6,3,7,16,3,2,6,11,11,10,18,39,4.4,4.5,3.0,M2020-02-08D,Race(3),,
2,3,0,3,6,0,2,4,6,0,2,3,5,3,4,10,17,16,17,0.0,M2020-02-08D,Race(3),,
3,5,12,3,20,19,9,1,29,15,9,1,25,39,30,5,74,4,4,2.0,M2020-02-08D,Race(3),,
6,0,2,0,2,0,0,0,0,1,0,1,2,1,2,1,4,5,5,0.0,M2020-02-08D,Race(3),,
4,2,0,0,2,0,0,0,0,0,0,1,1,2,0,1,3,101,101,0.0,M2020-02-08D,Race(3),,
7,0,0,0,0,0,0,1,1,1,0,0,1,1,0,1,2,21,21,0.0,M2020-02-08D,Race(3),,
14,0,0,0,0,0,0,0,0,0,0,0,0,0,0,0,0,101,101,0.0,M2020-02-08D,Race(4),,
1,3,7,8,18,1,2,1,4,1,5,1,7,5,14,10,29,6,6,0.0,M2020-02-08D,Race(4),,
2,0,0,0,0,0,1,2,3,1,1,0,2,1,2,2,5,16,16,0.0,M2020-02-08D,Race(4),,
3,6,8,13,27,1,20,4,25,3,12,7,22,10,40,24,74,4,4,3.0,M2020-02-08D,Race(4),,
4,0,3,0,3,0,0,0,0,0,0,0,0,0,3,0,3,71,71,2.0,M2020-02-08D,Race(4),,
5,0,2,3,5,3,1,17,21,4,4,7,15,7,7,27,41,17,17,0.0,M2020-02-08D,Race(4),,
6,4,2,0,6,0,1,1,2,1,0,1,2,5,3,2,10,12,12,0.0,M2020-02-08D,Race(4),,
8,0,0,0,0,0,0,0,0,0,0,0,0,0,0,0,0,151,151,0.0,M2020-02-08D,Race(4),,
9,2,0,0,2,0,0,2,2,0,0,4,4,2,0,6,8,18,18,0.0,M2020-02-08D,Race(4),,
10,0,0,0,0,0,0,0,0,0,0,0,0,0,0,0,0,81,81,0.0,M2020-02-08D,Race(4),,
11,0,0,0,0,0,0,0,0,0,0,0,0,0,0,0,0,151,151,0.0,M2020-02-08D,Race(4),,
12,15,8,3,26,25,4,0,29,16,4,3,23,56,16,6,78,1.95,1.95,1.0,M2020-02-08D,Race(4),,
13,0,0,3,3,0,1,3,4,0,0,3,3,0,1,9,10,31,31,0.0,M2020-02-08D,Race(4),,
7,0,0,0,0,0,0,0,0,0,0,0,0,0,0,0,0,126,126,0.0,M2020-02-08D,Race(4),,
2,0,0,0,0,0,0,0,0,0,0,0,0,0,0,0,0,71,67,0.0,M2020-02-08D,Race(5),,
1,0,3,2,5,0,1,2,3,1,3,3,7,1,7,7,15,17,17,0.0,M2020-02-08D,Race(5),,
4,0,3,5,8,2,1,4,7,2,0,4,6,4,4,13,21,12,12,1.0,M2020-02-08D,Race(5),,
5,2,2,5,9,1,1,2,4,1,4,2,7,4,7,9,20,6.5,6.5,0.0,M2020-02-08D,Race(5),,
6,0,0,0,0,0,0,0,0,0,0,0,0,0,0,0,0,61,61,0.0,M2020-02-08D,Race(5),,
7,0,0,0,0,0,0,0,0,0,0,0,0,0,0,0,0,81,81,0.0,M2020-02-08D,Race(5),,
8,0,0,3,3,0,0,0,0,0,0,1,1,0,0,4,4,41,41,0.0,M2020-02-08D,Race(5),,
9,6,0,2,8,0,2,2,4,0,2,1,3,6,4,5,15,6.5,6.5,0.0,M2020-02-08D,Race(5),,
10,0,0,0,0,0,0,0,0,1,0,0,1,1,0,0,1,26,26,0.0,M2020-02-08D,Race(5),,
3,0,10,6,16,7,3,11,21,9,4,3,16,16,17,20,53,6,6,3.0,M2020-02-08D,Race(5),,
13,10,7,5,22,4,15,4,23,3,6,7,16,17,28,16,61,3.3,3.3,0.0,M2020-02-08D,Race(5),,
12,0,0,0,0,0,0,1,1,0,0,1,1,0,0,2,2,41,41,0.0,M2020-02-08D,Race(5),,
14,0,0,0,0,0,0,0,0,0,0,0,0,0,0,0,0,81,81,0.0,M2020-02-08D,Race(5),,
11,12,5,2,19,16,7,4,27,9,7,4,20,37,19,10,66,4.6,4.6,2.0,M2020-02-08D,Race(5),,
12,2,0,0,2,0,1,0,1,1,1,1,3,3,2,1,6,7,7,0.0,M2020-02-08D,Race(6),,
11,0,0,2,2,0,0,0,0,0,0,0,0,0,0,2,2,31,34,0.0,M2020-02-08D,Race(6),,
10,0,0,0,0,0,0,0,0,0,0,1,1,0,0,1,1,81,81,0.0,M2020-02-08D,Race(6),,
9,0,0,0,0,0,0,0,0,0,0,0,0,0,0,0,0,71,67,0.0,M2020-02-08D,Race(6),,
8,2,5,2,9,1,3,12,16,1,4,3,8,4,12,17,33,11,11,0.0,M2020-02-08D,Race(6),,
7,0,2,0,2,0,1,1,2,0,2,2,4,0,5,3,8,34,34,0.0,M2020-02-08D,Race(6),,
6,0,7,10,17,1,16,3,20,3,6,3,12,4,29,16,49,4.2,4.2,0.0,M2020-02-08D,Race(6),,
5,10,0,3,13,1,2,5,8,2,0,4,6,13,2,12,27,6.5,7,0.0,M2020-02-08D,Race(6),,
4,14,10,0,24,21,4,4,29,9,10,4,23,44,24,8,76,3.1,3.1,3.0,M2020-02-08D,Race(6),,
2,0,3,2,5,0,1,0,1,3,0,2,5,3,4,4,11,31,31,2.0,M2020-02-08D,Race(6),,
1,0,0,0,0,1,1,1,3,2,2,1,5,3,3,2,8,26,26,1.0,M2020-02-08D,Race(6),,
3,2,3,11,16,5,1,4,10,5,1,5,11,12,5,20,37,5.5,5.5,0.0,M2020-02-08D,Race(6),,
2,6,5,6,17,4,17,3,24,5,9,5,19,15,31,14,60,8,7.5,2.0,M2020-02-08D,Race(7),,
3,0,0,0,0,0,0,0,0,1,0,0,1,1,0,0,1,34,34,0.0,M2020-02-08D,Race(7),,
4,0,0,3,3,0,0,0,0,0,3,1,4,0,3,4,7,11,10,0.0,M2020-02-08D,Race(7),,
5,2,8,5,15,0,1,2,3,0,2,3,5,2,11,10,23,11,10,0.0,M2020-02-08D,Race(7),,
12,0,0,0,0,0,0,1,1,0,0,0,0,0,0,1,1,51,51,0.0,M2020-02-08D,Race(7),,
11,2,5,5,12,2,3,17,22,0,7,7,14,4,15,29,48,8,7.5,0.0,M2020-02-08D,Race(7),,
10,0,0,0,0,0,0,0,0,0,0,0,0,0,0,0,0,71,81,0.0,M2020-02-08D,Race(7),,
9,0,2,0,2,0,0,0,0,0,0,0,0,0,2,0,2,41,34,0.0,M2020-02-08D,Race(7),,
1,0,0,0,0,0,0,2,2,0,0,3,3,0,0,5,5,20,19,0.0,M2020-02-08D,Race(7),,
8,0,3,0,3,0,0,0,0,0,0,0,0,0,3,0,3,34,34,0.0,M2020-02-08D,Race(7),,
7,16,5,9,30,21,6,1,28,17,2,1,20,54,13,11,78,2.05,2.4,1.0,M2020-02-08D,Race(7),,
6,4,2,2,8,3,3,4,10,3,3,6,12,10,8,12,30,5,4.5,3.0,M2020-02-08D,Race(7),,
13,0,0,0,0,0,0,0,0,0,0,0,0,0,0,0,0,61,61,0.0,M2020-02-08D,Race(8),,
2,6,3,3,12,2,1,3,6,3,2,3,8,11,6,9,26,15,16,0.0,M2020-02-08D,Race(8),,
3,0,2,0,2,0,0,1,1,1,0,0,1,1,2,1,4,11,11,0.0,M2020-02-08D,Race(8),,
1,3,16,5,24,5,3,10,18,8,9,2,19,16,28,17,61,6,6,0.0,M2020-02-08D,Race(8),,
14,0,0,0,0,0,0,0,0,0,0,0,0,0,0,0,0,21,21,0.0,M2020-02-08D,Race(8),,
5,0,0,0,0,0,1,0,1,0,0,0,0,0,1,0,1,34,34,0.0,M2020-02-08D,Race(8),,
4,5,0,0,5,1,0,1,2,0,0,2,2,6,0,3,9,81,81,0.0,M2020-02-08D,Race(8),,
12,0,0,0,0,0,1,0,1,0,0,0,0,0,1,0,1,15,15,0.0,M2020-02-08D,Race(8),,
11,9,7,2,18,16,6,5,27,11,8,4,23,36,21,11,68,2.7,2.6,1.0,M2020-02-08D,Race(8),,
10,0,0,0,0,0,1,0,1,0,0,0,0,0,1,0,1,31,31,2.0,M2020-02-08D,Race(8),,
6,3,2,5,10,0,1,3,4,0,1,5,6,3,4,13,20,8,9,3.0,M2020-02-08D,Race(8),,
9,0,0,0,0,0,0,0,0,0,0,0,0,0,0,0,0,31,31,0.0,M2020-02-08D,Race(8),,
8,4,0,8,12,6,12,5,23,3,4,8,15,13,16,21,50,9.5,10,0.0,M2020-02-08D,Race(8),,
7,0,0,7,7,0,4,2,6,0,2,2,4,0,6,11,17,8,8,0.0,M2020-02-08D,Race(8),,
8,0,0,0,0,0,0,0,0,0,0,2,2,0,0,2,2,20,19,0.0,M2020-02-08D,Race(9),,
1,0,5,0,5,1,3,3,7,2,3,2,7,3,11,5,19,9.5,9.5,0.0,M2020-02-08D,Race(9),,
2,0,0,0,0,0,0,1,1,0,0,0,0,0,0,1,1,23,26,3.0,M2020-02-08D,Race(9),,
3,0,0,0,0,0,0,0,0,0,0,0,0,0,0,0,0,81,81,0.0,M2020-02-08D,Race(9),,
4,0,0,0,0,0,0,0,0,0,0,0,0,0,0,0,0,51,51,0.0,M2020-02-08D,Race(9),,
5,2,2,0,4,0,3,0,3,1,4,0,5,3,9,0,12,11,10,0.0,M2020-02-08D,Race(9),,
6,14,6,10,30,26,2,2,30,21,2,2,25,61,10,14,85,2.6,2.5,2.0,M2020-02-08D,Race(9),,
7,0,0,0,0,0,0,0,0,0,0,0,0,0,0,0,0,71,67,0.0,M2020-02-08D,Race(9),,
12,0,0,0,0,0,0,1,1,0,0,0,0,0,0,1,1,17,17,1.0,M2020-02-08D,Race(9),,
11,0,0,0,0,0,0,0,0,0,0,0,0,0,0,0,0,71,67,0.0,M2020-02-08D,Race(9),,
9,3,8,13,24,2,18,7,27,1,11,10,22,6,37,30,73,4.4,5,0.0,M2020-02-08D,Race(9),,
10,11,9,7,27,1,4,16,21,1,6,10,17,13,19,33,65,3.9,3.8,0.0,M2020-02-08D,Race(9),,
1,7,0,0,7,0,0,0,0,0,0,0,0,7,0,0,7,7,7,2.0,M2020-02-12D,Race(1),,
12,0,0,0,0,0,0,0,0,0,0,0,0,0,0,0,0,31,31,0.0,M2020-02-12D,Race(1),,
11,2,5,3,10,2,5,3,10,3,8,4,15,7,18,10,35,5.5,5.5,0.0,M2020-02-12D,Race(1),,
2,3,2,4,9,3,3,13,19,3,3,6,12,9,8,23,40,5.5,5.5,0.0,M2020-02-12D,Race(1),,
3,3,3,4,10,0,0,1,1,2,0,0,2,5,3,5,13,9,9,0.0,M2020-02-12D,Race(1),,
5,8,5,7,20,2,14,5,21,1,5,5,11,11,24,17,52,6,6,1.0,M2020-02-12D,Race(1),,
4,0,0,0,0,0,0,0,0,0,0,0,0,0,0,0,0,71,71,0.0,M2020-02-12D,Race(1),,
7,0,3,3,6,7,2,4,13,9,2,3,14,16,7,10,33,14,14,0.0,M2020-02-12D,Race(1),,
8,0,0,0,0,0,0,0,0,0,1,0,1,0,1,0,1,101,101,3.0,M2020-02-12D,Race(1),,
9,0,0,0,0,0,0,0,0,0,0,0,0,0,0,0,0,101,101,0.0,M2020-02-12D,Race(1),,
10,0,0,3,3,1,0,0,1,2,2,2,6,3,2,5,10,11,11,0.0,M2020-02-12D,Race(1),,
6,7,12,6,25,15,5,3,23,6,5,5,16,28,22,14,64,3.7,3.7,0.0,M2020-02-12D,Race(1),,
9,0,0,3,3,0,0,1,1,0,0,0,0,0,0,4,4,12,12,0.0,M2020-02-12D,Race(2),,
1,2,0,3,5,0,4,1,5,1,3,1,5,3,7,5,15,16,16,0.0,M2020-02-12D,Race(2),,
11,24,0,2,26,25,2,2,29,16,4,3,23,65,6,7,78,2.25,2.25,2.0,M2020-02-12D,Race(2),,
10,0,0,2,2,0,0,0,0,0,0,0,0,0,0,2,2,101,101,0.0,M2020-02-12D,Race(2),,
8,0,2,3,5,0,2,2,4,0,0,3,3,0,4,8,12,16,16,0.0,M2020-02-12D,Race(2),,
4,0,7,5,12,0,5,1,6,1,3,0,4,1,15,6,22,6,6,0.0,M2020-02-12D,Race(2),,
6,4,0,2,6,0,0,1,1,0,0,3,3,4,0,6,10,16,16,0.0,M2020-02-12D,Race(2),,
5,0,0,0,0,0,0,0,0,2,0,0,2,2,0,0,2,41,41,0.0,M2020-02-12D,Race(2),,
3,0,12,3,15,4,15,7,26,4,12,7,23,8,39,17,64,6,6,3.0,M2020-02-12D,Race(2),,
12,0,3,2,5,0,0,1,1,0,0,1,1,0,3,4,7,10,10,1.0,M2020-02-12D,Race(2),,
7,0,0,0,0,0,0,0,0,0,1,0,1,0,1,0,1,101,101,0.0,M2020-02-12D,Race(2),,
2,0,6,5,11,1,2,14,17,2,3,8,13,3,11,27,41,11,11,0.0,M2020-02-12D,Race(2),,
3,0,4,10,14,0,4,2,6,0,6,1,7,0,14,13,27,11,11,1.0,M2020-02-12D,Race(3),,
2,0,2,10,12,0,2,3,5,2,1,6,9,2,5,19,26,8,8,0.0,M2020-02-12D,Race(3),,
11,2,3,0,5,0,0,1,1,1,1,1,3,3,4,2,9,13,13,3.0,M2020-02-12D,Race(3),,
4,20,8,0,28,23,6,0,29,15,8,1,24,58,22,1,81,1.7,1.7,0.0,M2020-02-12D,Race(3),,
1,0,2,5,7,0,1,2,3,1,0,2,3,1,3,9,13,19,19,0.0,M2020-02-12D,Race(3),,
5,8,11,3,22,6,15,5,26,5,7,4,16,19,33,12,64,5,5,2.0,M2020-02-12D,Race(3),,
12,0,0,0,0,0,0,0,0,0,0,0,0,0,0,0,0,101,101,0.0,M2020-02-12D,Race(3),,
7,0,0,0,0,0,0,0,0,0,0,0,0,0,0,0,0,81,81,0.0,M2020-02-12D,Race(3),,
8,0,0,2,2,0,0,4,4,0,0,6,6,0,0,12,12,41,41,0.0,M2020-02-12D,Race(3),,
9,0,0,0,0,1,2,12,15,2,3,5,10,3,5,17,25,31,31,0.0,M2020-02-12D,Race(3),,
10,0,0,0,0,0,0,0,0,0,0,0,0,0,0,0,0,101,101,0.0,M2020-02-12D,Race(3),,
6,0,0,0,0,0,0,1,1,0,0,0,0,0,0,1,1,15,15,0.0,M2020-02-12D,Race(3),,
3,0,0,0,0,0,1,1,2,0,0,1,1,0,1,2,3,26,26,0.0,M2020-02-12D,Race(4),,
4,8,3,9,20,16,5,4,25,8,8,3,19,32,16,16,64,4.2,4.2,0.0,M2020-02-12D,Race(4),,
5,3,6,2,11,2,0,1,3,5,1,0,6,10,7,3,20,8.5,8.5,0.0,M2020-02-12D,Race(4),,
6,0,0,0,0,0,0,0,0,0,0,0,0,0,0,0,0,51,51,0.0,M2020-02-12D,Race(4),,
7,0,0,3,3,0,2,4,6,0,3,2,5,0,5,9,14,13,13,0.0,M2020-02-12D,Race(4),,
1,2,0,0,2,0,0,0,0,0,0,2,2,2,0,2,4,10,15,1.0,M2020-02-12D,Race(4),,
9,0,0,0,0,0,0,0,0,0,0,0,0,0,0,0,0,21,21,0.0,M2020-02-12D,Race(4),,
10,0,6,3,9,7,2,2,11,3,2,5,10,10,10,10,30,8,8,0.0,M2020-02-12D,Race(4),,
11,0,0,0,0,0,0,0,0,0,0,0,0,0,0,0,0,101,101,0.0,M2020-02-12D,Race(4),,
2,5,7,5,17,0,15,6,21,3,7,5,15,8,29,16,53,6,6,0.0,M2020-02-12D,Race(4),,
8,12,8,6,26,5,5,12,22,7,5,8,20,24,18,26,68,3.2,3.2,3.0,M2020-02-12D,Race(4),,
12,0,0,2,2,0,0,0,0,0,0,0,0,0,0,2,2,18,18,2.0,M2020-02-12D,Race(4),,
12,0,0,0,0,0,0,0,0,0,0,0,0,0,0,0,0,10,10,0.0,M2020-02-12D,Race(5),,
2,0,3,8,11,1,2,0,3,1,1,0,2,2,6,8,16,11,11,3.0,M2020-02-12D,Race(5),,
4,23,3,4,30,23,4,1,28,15,6,2,23,61,13,7,81,2.8,2.7,2.0,M2020-02-12D,Race(5),,
5,0,0,0,0,0,0,1,1,0,0,0,0,0,0,1,1,51,41,0.0,M2020-02-12D,Race(5),,
6,0,0,0,0,0,0,1,1,0,0,3,3,0,0,4,4,51,41,0.0,M2020-02-12D,Race(5),,
8,0,0,0,0,0,0,0,0,0,0,0,0,0,0,0,0,34,34,0.0,M2020-02-12D,Race(5),,
9,0,0,0,0,0,1,0,1,0,1,1,2,0,2,1,3,51,41,0.0,M2020-02-12D,Race(5),,
3,5,22,3,30,2,18,4,24,4,7,9,20,11,47,16,74,2.7,3,1.0,M2020-02-12D,Race(5),,
1,0,2,5,7,1,1,14,16,3,4,4,11,4,7,23,34,34,31,0.0,M2020-02-12D,Race(5),,
10,0,0,7,7,3,2,7,12,2,4,5,11,5,6,19,30,9,8.5,0.0,M2020-02-12D,Race(5),,
11,2,0,0,2,0,1,0,1,1,0,2,3,3,1,2,6,18,17,0.0,M2020-02-12D,Race(5),,
7,0,0,3,3,0,1,2,3,0,3,0,3,0,4,5,9,15,14,0.0,M2020-02-12D,Race(5),,
12,0,0,2,2,0,0,0,0,0,0,0,0,0,0,2,2,18,17,0.0,M2020-02-12D,Race(6),,
1,0,0,0,0,1,0,0,1,0,0,0,0,1,0,0,1,51,51,0.0,M2020-02-12D,Race(6),,
3,2,0,0,2,0,1,0,1,0,1,0,1,2,2,0,4,21,21,2.0,M2020-02-12D,Race(6),,
4,7,3,16,26,17,3,7,27,10,4,7,21,34,10,30,74,4.4,4.4,3.0,M2020-02-12D,Race(6),,
5,0,0,0,0,0,2,0,2,0,2,0,2,0,4,0,4,34,31,0.0,M2020-02-12D,Race(6),,
8,0,0,0,0,0,0,0,0,0,0,0,0,0,0,0,0,34,31,0.0,M2020-02-12D,Race(6),,
7,7,6,0,13,0,1,0,1,2,2,0,4,9,9,0,18,5,6.5,0.0,M2020-02-12D,Race(6),,
9,0,8,0,8,3,4,13,20,2,7,8,17,5,19,21,45,8.5,8.5,0.0,M2020-02-12D,Race(6),,
10,14,5,7,26,7,14,4,25,6,5,4,15,27,24,15,66,2.8,2.7,1.0,M2020-02-12D,Race(6),,
11,0,3,3,6,1,2,2,5,1,1,2,4,2,6,7,15,15,14,0.0,M2020-02-12D,Race(6),,
2,0,2,2,4,1,1,1,3,4,1,1,6,5,4,4,13,17,16,0.0,M2020-02-12D,Race(6),,
6,0,3,0,3,0,2,3,5,1,3,4,8,1,8,7,16,12,12,0.0,M2020-02-12D,Race(6),,
4,0,8,6,14,3,1,5,9,3,2,5,10,6,11,16,33,9,9,0.0,M2020-02-12D,Race(7),,
5,0,2,2,4,0,1,0,1,0,3,0,3,0,6,2,8,10,10,0.0,M2020-02-12D,Race(7),,
6,0,2,2,4,0,0,2,2,0,0,3,3,0,2,7,9,21,21,0.0,M2020-02-12D,Race(7),,
7,2,0,0,2,0,0,0,0,0,0,2,2,2,0,2,4,9,9,0.0,M2020-02-12D,Race(7),,
9,4,8,8,20,18,6,5,29,6,10,5,21,28,24,18,70,4.4,4.4,1.0,M2020-02-12D,Race(7),,
10,0,0,0,0,0,2,0,2,0,1,0,1,0,3,0,3,21,21,0.0,M2020-02-12D,Race(7),,
2,15,7,0,22,6,16,4,26,10,6,3,19,31,29,7,67,5,5,0.0,M2020-02-12D,Race(7),,
11,0,0,0,0,0,0,0,0,0,0,0,0,0,0,0,0,41,41,0.0,M2020-02-12D,Race(7),,
12,0,0,0,0,0,0,0,0,1,1,1,3,1,1,1,3,10,10,0.0,M2020-02-12D,Race(7),,
3,0,0,0,0,0,1,0,1,1,0,0,1,1,1,0,2,51,51,0.0,M2020-02-12D,Race(7),,
8,6,0,0,6,0,0,0,0,0,0,0,0,6,0,0,6,4.6,6,2.0,M2020-02-12D,Race(7),,
1,3,3,12,18,2,3,14,19,5,3,6,14,10,9,32,51,8,8,3.0,M2020-02-12D,Race(7),,
10,3,8,4,15,1,16,8,25,1,10,8,19,5,34,20,59,8,6.5,0.0,M2020-02-12D,Race(8),,
11,5,0,0,5,0,0,1,1,0,0,0,0,5,0,1,6,7,7.5,2.0,M2020-02-12D,Race(8),,
9,0,0,2,2,0,0,0,0,0,0,0,0,0,0,2,2,61,51,1.0,M2020-02-12D,Race(8),,
8,4,3,3,10,1,5,2,8,0,5,7,12,5,13,12,30,4.4,5.5,0.0,M2020-02-12D,Race(8),,
7,2,0,0,2,0,0,1,1,0,0,2,2,2,0,3,5,21,17,0.0,M2020-02-12D,Race(8),,
6,0,0,0,0,0,0,0,0,0,0,0,0,0,0,0,0,81,61,0.0,M2020-02-12D,Race(8),,
4,6,9,5,20,2,2,12,16,3,5,3,11,11,16,20,47,6,5.5,3.0,M2020-02-12D,Race(8),,
3,3,7,11,21,5,3,3,11,5,2,2,9,13,12,16,41,4.6,3.8,0.0,M2020-02-12D,Race(8),,
1,7,3,5,15,21,4,3,28,17,3,4,24,45,10,12,67,3,4.2,0.0,M2020-02-12D,Race(8),,
12,0,0,0,0,0,0,0,0,0,0,0,0,0,0,0,0,61,61,0.0,M2020-02-12D,Race(8),,
2,0,0,0,0,0,0,0,0,0,1,0,1,0,1,0,1,101,101,0.0,M2020-02-12D,Race(8),,
5,0,0,0,0,0,0,0,0,0,0,0,0,0,0,0,0,101,101,0.0,M2020-02-12D,Race(8),,
12,0,0,3,3,0,0,0,0,0,0,1,1,0,0,4,4,26,26,0.0,M2020-02-16D,Race(1),,
3,0,5,9,14,6,5,10,21,6,3,2,11,12,13,21,46,6.5,7,0.0,M2020-02-16D,Race(1),,
4,0,0,0,0,0,0,0,0,0,0,0,0,0,0,0,0,71,71,0.0,M2020-02-16D,Race(1),,
5,3,4,0,7,0,4,4,8,2,5,5,12,5,13,9,27,7,7,0.0,M2020-02-16D,Race(1),,
6,0,0,0,0,0,0,0,0,0,0,0,0,0,0,0,0,41,41,0.0,M2020-02-16D,Race(1),,
7,0,0,2,2,0,0,0,0,0,0,0,0,0,0,2,2,61,91,0.0,M2020-02-16D,Race(1),,
8,6,0,5,11,1,9,7,17,1,7,5,13,8,16,17,41,6,6,0.0,M2020-02-16D,Race(1),,
9,0,0,0,0,0,0,0,0,0,0,0,0,0,0,0,0,71,51,0.0,M2020-02-16D,Race(1),,
10,2,0,0,2,0,0,0,0,0,0,0,0,2,0,0,2,81,81,0.0,M2020-02-16D,Race(1),,
13,7,8,2,17,15,7,2,24,9,8,4,21,31,23,8,62,4,4.2,2.0,M2020-02-16D,Race(1),,
14,0,0,0,0,0,0,0,0,0,0,0,0,0,0,0,0,151,151,0.0,M2020-02-16D,Race(1),,
11,7,5,3,15,1,0,0,1,1,0,3,4,9,5,6,20,8.5,10,3.0,M2020-02-16D,Race(1),,
2,5,8,6,19,7,5,7,19,7,3,6,16,19,16,19,54,2.9,3,1.0,M2020-02-16D,Race(1),,
1,0,0,0,0,0,0,0,0,0,0,0,0,0,0,0,0,31,34,0.0,M2020-02-16D,Race(1),,
14,0,0,0,0,0,0,1,1,0,0,0,0,0,0,1,1,34,34,0.0,M2020-02-16D,Race(10),,
13,7,2,0,9,1,1,0,2,0,3,2,5,8,6,2,16,6,6.5,0.0,M2020-02-16D,Race(10),,
12,0,0,0,0,0,0,0,0,0,0,0,0,0,0,0,0,101,101,0.0,M2020-02-16D,Race(10),,
11,2,5,5,12,1,5,3,9,3,6,4,13,6,16,12,34,8.5,10,3.0,M2020-02-16D,Race(10),,
10,0,0,0,0,0,0,0,0,0,0,0,0,0,0,0,0,51,51,0.0,M2020-02-16D,Race(10),,
9,0,3,2,5,0,0,0,0,0,0,0,0,0,3,2,5,26,26,0.0,M2020-02-16D,Race(10),,
7,0,0,0,0,0,0,1,1,0,0,2,2,0,0,3,3,13,13,1.0,M2020-02-16D,Race(10),,
6,8,2,3,13,10,6,6,22,5,7,4,16,23,15,13,51,5.5,5,0.0,M2020-02-16D,Race(10),,
5,0,6,10,16,2,1,2,5,3,2,2,7,5,9,14,28,7,6.5,0.0,M2020-02-16D,Race(10),,
4,11,9,8,28,14,11,2,27,13,6,1,20,38,26,11,75,3.5,3.5,2.0,M2020-02-16D,Race(10),,
3,0,0,0,0,0,0,0,0,0,0,0,0,0,0,0,0,61,61,0.0,M2020-02-16D,Race(10),,
1,2,0,0,2,1,2,3,6,0,2,3,5,3,4,6,13,10,9.5,0.0,M2020-02-16D,Race(10),,
2,0,0,2,2,1,4,12,17,2,0,7,9,3,4,21,28,23,21,0.0,M2020-02-16D,Race(10),,
8,0,3,0,3,0,0,0,0,0,0,1,1,0,3,1,4,21,23,0.0,M2020-02-16D,Race(10),,
10,0,0,0,0,0,0,0,0,0,0,0,0,0,0,0,0,151,151,0.0,M2020-02-16D,Race(2),,
8,5,2,11,18,0,3,8,11,2,8,3,13,7,13,22,42,7,7,0.0,M2020-02-16D,Race(2),,
11,0,0,0,0,0,0,0,0,0,0,0,0,0,0,0,0,81,81,0.0,M2020-02-16D,Race(2),,
6,0,0,0,0,0,0,0,0,0,0,0,0,0,0,0,0,61,61,0.0,M2020-02-16D,Race(2),,
5,15,6,3,24,11,12,4,27,7,6,6,19,33,24,13,70,2.4,2.4,3.0,M2020-02-16D,Race(2),,
4,5,13,7,25,17,4,9,30,11,8,4,23,33,25,20,78,4,4,1.0,M2020-02-16D,Race(2),,
3,2,2,7,11,1,10,5,16,4,4,5,13,7,16,17,40,12,12,0.0,M2020-02-16D,Race(2),,
2,0,3,0,3,0,0,0,0,1,0,0,1,1,3,0,4,51,51,0.0,M2020-02-16D,Race(2),,
1,0,0,0,0,0,1,0,1,0,0,0,0,0,1,0,1,19,19,0.0,M2020-02-16D,Race(2),,
7,0,0,0,0,0,0,0,0,0,0,0,0,0,0,0,0,41,41,0.0,M2020-02-16D,Race(2),,
12,0,0,0,0,0,0,0,0,0,0,0,0,0,0,0,0,151,151,0.0,M2020-02-16D,Race(2),,
9,3,4,2,9,0,0,3,3,0,0,4,4,3,4,9,16,13,13,2.0,M2020-02-16D,Race(2),,
14,0,0,0,0,0,0,0,0,0,0,0,0,0,0,0,0,26,26,0.0,M2020-02-16D,Race(2),,
13,0,0,0,0,1,0,1,2,1,0,4,5,2,0,5,7,7.5,7.5,0.0,M2020-02-16D,Race(2),,
11,6,3,8,17,3,4,11,18,4,7,3,14,13,14,22,49,4.2,5,0.0,M2020-02-16D,Race(3),,
7,8,3,7,18,8,12,4,24,10,7,4,21,26,22,15,63,6,6,0.0,M2020-02-16D,Race(3),,
8,0,0,0,0,0,0,0,0,1,0,0,1,1,0,0,1,71,67,0.0,M2020-02-16D,Race(3),,
6,0,0,0,0,0,0,0,0,1,0,0,1,1,0,0,1,18,18,0.0,M2020-02-16D,Race(3),,
12,0,0,0,0,0,0,0,0,0,0,0,0,0,0,0,0,61,61,0.0,M2020-02-16D,Race(3),,
4,14,8,2,24,4,10,4,18,3,7,4,14,21,25,10,56,4.4,4.2,1.0,M2020-02-16D,Race(3),,
5,0,3,2,5,0,0,0,0,0,2,0,2,0,5,2,7,18,17,0.0,M2020-02-16D,Race(3),,
2,2,2,0,4,2,1,1,4,2,0,2,4,6,3,3,12,8.5,8,2.0,M2020-02-16D,Race(3),,
10,0,0,0,0,0,0,0,0,0,1,0,1,0,1,0,1,101,101,0.0,M2020-02-16D,Race(3),,
1,0,0,0,0,0,0,1,1,0,0,2,2,0,0,3,3,41,41,0.0,M2020-02-16D,Race(3),,
14,0,4,6,10,0,1,0,1,0,0,0,0,0,5,6,11,16,16,3.0,M2020-02-16D,Race(3),,
13,0,2,3,5,0,0,0,0,0,0,1,1,0,2,4,6,6,6,0.0,M2020-02-16D,Race(3),,
3,0,5,2,7,12,2,8,22,4,2,10,16,16,9,20,45,9.5,10,0.0,M2020-02-16D,Race(3),,
9,0,0,0,0,1,0,1,2,1,0,0,1,2,0,1,3,26,26,0.0,M2020-02-16D,Race(3),,
6,5,0,9,14,0,1,14,15,1,1,12,14,6,2,35,43,6,5.5,0.0,M2020-02-16D,Race(4),,
12,0,2,2,4,0,0,0,0,0,0,2,2,0,2,4,6,18,17,0.0,M2020-02-16D,Race(4),,
14,0,0,0,0,0,0,0,0,0,0,0,0,0,0,0,0,41,41,0.0,M2020-02-16D,Race(4),,
11,0,0,0,0,0,0,0,0,0,0,0,0,0,0,0,0,18,17,0.0,M2020-02-16D,Race(4),,
10,0,0,0,0,0,0,0,0,0,0,1,1,0,0,1,1,34,34,0.0,M2020-02-16D,Race(4),,
9,0,0,0,0,0,0,0,0,0,0,0,0,0,0,0,0,126,151,0.0,M2020-02-16D,Race(4),,
8,0,0,0,0,0,0,1,1,1,0,1,2,1,0,2,3,41,41,0.0,M2020-02-16D,Race(4),,
13,2,0,0,2,0,2,2,4,0,0,3,3,2,2,5,9,9,10,3.0,M2020-02-16D,Race(4),,
4,0,0,0,0,0,0,0,0,0,2,0,2,0,2,0,2,81,81,0.0,M2020-02-16D,Race(4),,
3,5,16,3,24,11,18,1,30,10,12,2,24,26,46,6,78,4.8,4.8,0.0,M2020-02-16D,Race(4),,
2,16,8,2,26,19,9,8,36,13,9,1,23,48,26,11,85,2.65,2.9,1.0,M2020-02-16D,Race(4),,
1,0,0,0,0,0,0,2,2,1,1,1,3,1,1,3,5,16,15,0.0,M2020-02-16D,Race(4),,
5,0,2,0,2,0,0,1,1,0,0,3,3,0,2,4,6,31,26,0.0,M2020-02-16D,Race(4),,
7,2,2,14,18,0,0,1,1,0,1,0,1,2,3,15,20,6,8,2.0,M2020-02-16D,Race(4),,
11,4,8,7,19,0,4,8,12,0,5,8,13,4,17,23,44,7.5,7,0.0,M2020-02-16D,Race(5),,
3,0,12,3,15,0,5,5,10,1,9,4,14,1,26,12,39,10,12,0.0,M2020-02-16D,Race(5),,
2,0,2,11,13,0,12,10,22,1,7,3,11,1,21,24,46,17,17,0.0,M2020-02-16D,Race(5),,
1,24,4,2,30,22,0,0,22,22,2,1,25,68,6,3,77,1.4,1.4,2.0,M2020-02-16D,Race(5),,
5,0,0,2,2,8,0,1,9,1,0,0,1,9,0,3,12,71,67,0.0,M2020-02-16D,Race(5),,
7,0,2,0,2,0,0,1,1,0,0,2,2,0,2,3,5,19,21,1.0,M2020-02-16D,Race(5),,
8,0,0,0,0,0,9,2,11,0,1,2,3,0,10,4,14,14,10,0.0,M2020-02-16D,Race(5),,
4,0,0,0,0,0,0,0,0,0,0,2,2,0,0,2,2,61,51,3.0,M2020-02-16D,Race(5),,
10,0,0,0,0,0,0,0,0,0,0,0,0,0,0,0,0,81,81,0.0,M2020-02-16D,Race(5),,
6,2,0,2,4,0,0,1,1,1,0,2,3,3,0,5,8,26,21,0.0,M2020-02-16D,Race(5),,
9,0,2,3,5,0,0,2,2,0,2,2,4,0,4,7,11,23,26,0.0,M2020-02-16D,Race(5),,
1,10,10,2,22,12,5,11,28,10,8,3,21,32,23,16,71,4.4,4.4,2.0,M2020-02-16D,Race(6),,
2,0,2,0,2,1,1,0,2,1,1,0,2,2,4,0,6,15,15,1.0,M2020-02-16D,Race(6),,
3,5,5,0,10,1,3,2,6,2,5,3,10,8,13,5,26,8,8,0.0,M2020-02-16D,Race(6),,
12,0,0,0,0,0,0,0,0,0,0,0,0,0,0,0,0,51,67,0.0,M2020-02-16D,Race(6),,
13,0,0,3,3,0,0,0,0,0,0,0,0,0,0,3,3,31,31,0.0,M2020-02-16D,Race(6),,
14,2,3,7,12,1,0,2,3,1,0,5,6,4,3,14,21,6,6,0.0,M2020-02-16D,Race(6),,
11,3,2,2,7,12,6,3,21,5,5,5,15,20,13,10,43,11,11,0.0,M2020-02-16D,Race(6),,
10,0,2,0,2,0,0,0,0,0,0,0,0,0,2,0,2,31,31,0.0,M2020-02-16D,Race(6),,
7,0,0,0,0,0,0,0,0,0,0,0,0,0,0,0,0,71,67,0.0,M2020-02-16D,Race(6),,
9,0,0,0,0,0,0,0,0,0,0,0,0,0,0,0,0,101,101,0.0,M2020-02-16D,Race(6),,
4,0,0,0,0,0,0,0,0,0,1,1,2,0,1,1,2,51,51,0.0,M2020-02-16D,Race(6),,
6,3,3,5,11,2,11,7,20,6,3,4,13,11,17,16,44,5,5,0.0,M2020-02-16D,Race(6),,
8,5,0,8,13,1,3,2,6,1,2,0,3,7,5,10,22,6,6.5,3.0,M2020-02-16D,Race(6),,
5,2,3,3,8,0,1,3,4,0,1,5,6,2,5,11,18,8,8,0.0,M2020-02-16D,Race(6),,
7,0,0,0,0,0,0,1,1,0,0,8,8,0,0,9,9,31,31,2.0,M2020-02-16D,Race(7),,
6,0,0,0,0,0,0,0,0,0,0,0,0,0,0,0,0,12,12,0.0,M2020-02-16D,Race(7),,
2,7,21,2,30,12,18,0,30,13,11,0,24,32,50,2,84,2.45,2.5,0.0,M2020-02-16D,Race(7),,
3,2,3,20,25,1,2,19,22,1,1,13,15,4,6,52,62,5.5,6,3.0,M2020-02-16D,Race(7),,
5,3,2,0,5,0,0,1,1,0,0,1,1,3,2,2,7,41,41,0.0,M2020-02-16D,Race(7),,
4,0,0,0,0,0,0,3,3,0,1,3,4,0,1,6,7,9.5,10,0.0,M2020-02-16D,Race(7),,
1,18,4,8,30,17,10,3,30,12,13,1,26,47,27,12,86,2.45,2.2,1.0,M2020-02-16D,Race(7),,
9,0,0,0,0,1,0,1,2,0,0,5,5,1,0,6,7,21,21,0.0,M2020-02-16D,Race(8),,
6,0,0,0,0,0,0,0,0,0,0,0,0,0,0,0,0,126,126,0.0,M2020-02-16D,Race(8),,
8,0,0,0,0,0,0,0,0,0,0,0,0,0,0,0,0,126,126,0.0,M2020-02-16D,Race(8),,
10,0,0,0,0,0,0,0,0,0,0,0,0,0,0,0,0,41,41,0.0,M2020-02-16D,Race(8),,
1,11,7,4,22,12,8,7,27,5,7,7,19,28,22,18,68,3.8,3.8,3.0,M2020-02-16D,Race(8),,
3,3,0,2,5,1,2,3,6,1,2,3,6,5,4,8,17,19,19,1.0,M2020-02-16D,Race(8),,
2,0,0,3,3,0,0,0,0,0,1,0,1,0,1,3,4,14,14,0.0,M2020-02-16D,Race(8),,
7,2,0,0,2,0,0,2,2,0,1,0,1,2,1,2,5,12,12,0.0,M2020-02-16D,Race(8),,
14,0,3,5,8,0,0,1,1,0,1,2,3,0,4,8,12,16,16,0.0,M2020-02-16D,Race(8),,
13,14,11,5,30,11,7,11,29,11,9,3,23,36,27,19,82,2.7,2.7,0.0,M2020-02-16D,Race(8),,
12,0,2,0,2,1,0,0,1,2,0,0,2,3,2,0,5,20,20,0.0,M2020-02-16D,Race(8),,
11,0,0,6,6,0,2,0,2,0,0,0,0,0,2,6,8,11,11,0.0,M2020-02-16D,Race(8),,
4,0,7,5,12,4,11,5,20,7,5,6,18,11,23,16,50,8,8,2.0,M2020-02-16D,Race(8),,
5,0,0,0,0,0,0,0,0,0,0,0,0,0,0,0,0,51,51,0.0,M2020-02-16D,Race(8),,
3,2,8,13,23,14,0,7,21,10,4,7,21,26,12,27,65,4.8,4.8,0.0,M2020-02-16D,Race(9),,
13,0,0,0,0,0,2,2,4,0,2,4,6,0,4,6,10,13,13,0.0,M2020-02-16D,Race(9),,
12,0,0,2,2,0,0,0,0,0,0,0,0,0,0,2,2,71,61,0.0,M2020-02-16D,Race(9),,
11,0,0,0,0,0,0,0,0,0,0,0,0,0,0,0,0,81,81,0.0,M2020-02-16D,Race(9),,
10,0,0,0,0,0,0,0,0,0,0,0,0,0,0,0,0,81,81,0.0,M2020-02-16D,Race(9),,
9,0,5,3,8,1,1,1,3,0,3,2,5,1,9,6,16,5.5,6,0.0,M2020-02-16D,Race(9),,
8,0,0,0,0,0,0,0,0,0,0,0,0,0,0,0,0,101,101,0.0,M2020-02-16D,Race(9),,
7,0,0,0,0,0,0,0,0,0,0,2,2,0,0,2,2,51,51,0.0,M2020-02-16D,Race(9),,
5,3,4,0,7,1,10,3,14,4,3,3,10,8,17,6,31,11,10,3.0,M2020-02-16D,Race(9),,
4,0,0,0,0,0,1,0,1,0,0,0,0,0,1,0,1,26,26,0.0,M2020-02-16D,Race(9),,
2,2,13,10,25,1,10,11,22,3,10,4,17,6,33,25,64,7,6.5,2.0,M2020-02-16D,Race(9),,
1,0,0,0,0,0,0,0,0,1,0,0,1,1,0,0,1,51,41,0.0,M2020-02-16D,Race(9),,
14,23,0,2,25,13,6,6,25,8,4,4,16,44,10,12,66,2.1,2.4,1.0,M2020-02-16D,Race(9),,
6,0,0,0,0,0,0,0,0,0,0,0,0,0,0,0,0,51,41,0.0,M2020-02-16D,Race(9),,
7,4,2,6,12,1,5,13,19,0,7,4,11,5,14,23,42,6.5,6.5,0.0,M2020-02-19D,Race(1),,
3,0,3,3,6,1,3,2,6,4,1,3,8,5,7,8,20,6,6,3.0,M2020-02-19D,Race(1),,
2,8,5,2,15,4,12,6,22,6,3,3,12,18,20,11,49,8,8,0.0,M2020-02-19D,Race(1),,
6,0,0,5,5,0,1,0,1,1,2,0,3,1,3,5,9,12,12,0.0,M2020-02-19D,Race(1),,
8,0,0,0,0,0,0,0,0,0,0,0,0,0,0,0,0,34,34,0.0,M2020-02-19D,Race(1),,
9,0,0,0,0,0,0,0,0,0,0,0,0,0,0,0,0,126,126,0.0,M2020-02-19D,Race(1),,
10,3,2,5,10,3,1,4,8,2,4,8,14,8,7,17,32,7.5,7.5,0.0,M2020-02-19D,Race(1),,
11,0,0,0,0,0,0,0,0,0,0,1,1,0,0,1,1,14,14,2.0,M2020-02-19D,Race(1),,
12,2,0,2,4,0,1,1,2,1,1,0,2,3,2,3,8,9,9,0.0,M2020-02-19D,Race(1),,
4,0,0,0,0,0,0,0,0,0,0,0,0,0,0,0,0,71,71,0.0,M2020-02-19D,Race(1),,
5,0,6,5,11,0,2,3,5,1,3,5,9,1,11,13,25,7.5,7.5,0.0,M2020-02-19D,Race(1),,
1,13,12,2,27,21,5,1,27,11,5,2,18,45,22,5,72,4,4,1.0,M2020-02-19D,Race(1),,
5,0,0,0,0,0,0,0,0,0,0,0,0,0,0,0,0,81,81,0.0,M2020-02-19D,Race(2),,
6,2,3,0,5,0,0,0,0,0,0,0,0,2,3,0,5,16,16,0.0,M2020-02-19D,Race(2),,
14,0,0,0,0,0,0,0,0,0,0,0,0,0,0,0,0,41,41,0.0,M2020-02-19D,Race(2),,
13,0,0,0,0,0,0,0,0,0,0,0,0,0,0,0,0,61,61,0.0,M2020-02-19D,Race(2),,
12,2,0,4,6,0,0,1,1,0,0,1,1,2,0,6,8,12,12,0.0,M2020-02-19D,Race(2),,
8,0,3,10,13,1,2,14,17,2,6,4,12,3,11,28,42,11,11,1.0,M2020-02-19D,Race(2),,
11,0,0,0,0,1,1,1,3,0,3,0,3,1,4,1,6,17,17,0.0,M2020-02-19D,Race(2),,
10,2,9,6,17,0,3,5,8,0,4,8,12,2,16,19,37,5.5,5.5,0.0,M2020-02-19D,Race(2),,
9,5,2,3,10,0,0,0,0,0,0,0,0,5,2,3,10,13,13,0.0,M2020-02-19D,Race(2),,
2,16,5,2,23,24,3,2,29,20,2,2,24,60,10,6,76,3.2,3.2,3.0,M2020-02-19D,Race(2),,
1,0,0,2,2,0,0,0,0,0,0,0,0,0,0,2,2,11,11,0.0,M2020-02-19D,Race(2),,
7,0,0,0,0,0,0,1,1,0,0,1,1,0,0,2,2,41,41,0.0,M2020-02-19D,Race(2),,
3,3,2,3,8,0,3,2,5,1,2,2,5,4,7,7,18,16,16,0.0,M2020-02-19D,Race(2),,
4,0,6,0,6,0,3,0,3,0,2,1,3,0,11,1,12,5.5,5.5,2.0,M2020-02-19D,Race(2),,
7,7,5,3,15,23,3,4,30,20,1,4,25,50,9,11,70,4.6,4.6,0.0,M2020-02-19D,Race(3),,
10,0,0,0,0,0,0,2,2,0,0,1,1,0,0,3,3,26,26,0.0,M2020-02-19D,Race(3),,
1,2,2,2,6,0,0,0,0,0,0,0,0,2,2,2,6,26,26,0.0,M2020-02-19D,Race(3),,
2,0,6,5,11,2,16,4,22,2,10,5,17,4,32,14,50,7,7,3.0,M2020-02-19D,Race(3),,
3,5,0,2,7,1,2,0,3,0,4,0,4,6,6,2,14,12,12,0.0,M2020-02-19D,Race(3),,
4,0,0,0,0,0,0,1,1,1,0,2,3,1,0,3,4,12,12,0.0,M2020-02-19D,Race(3),,
5,2,7,0,9,0,1,0,1,2,1,1,4,4,9,1,14,9,9,2.0,M2020-02-19D,Race(3),,
12,2,0,0,2,2,0,2,4,1,0,3,4,5,0,5,10,16,16,0.0,M2020-02-19D,Race(3),,
11,0,5,5,10,2,4,4,10,0,3,2,5,2,12,11,25,4.4,4.6,0.0,M2020-02-19D,Race(3),,
8,6,5,6,17,0,3,11,14,0,5,3,8,6,13,20,39,9,9,1.0,M2020-02-19D,Race(3),,
9,0,0,3,3,0,0,0,0,0,0,2,2,0,0,5,5,21,21,0.0,M2020-02-19D,Race(3),,
6,6,0,4,10,0,1,2,3,0,2,3,5,6,3,9,18,8,8,0.0,M2020-02-19D,Race(3),,
10,2,0,3,5,1,2,3,6,1,4,6,11,4,6,12,22,7,7,0.0,M2020-02-19D,Race(4),,
2,3,0,3,6,0,0,0,0,0,0,0,0,3,0,3,6,31,31,3.0,M2020-02-19D,Race(4),,
3,3,3,4,10,2,1,15,18,4,1,8,13,9,5,27,41,9,9,0.0,M2020-02-19D,Race(4),,
12,0,0,0,0,1,1,0,2,1,2,1,4,2,3,1,6,19,19,0.0,M2020-02-19D,Race(4),,
11,0,0,0,0,0,0,0,0,0,0,0,0,0,0,0,0,21,21,0.0,M2020-02-19D,Race(4),,
4,5,11,4,20,15,6,4,25,8,5,3,16,28,22,11,61,4.8,4.8,2.0,M2020-02-19D,Race(4),,
6,7,6,10,23,6,5,2,13,4,8,2,14,17,19,14,50,3.3,3.3,0.0,M2020-02-19D,Race(4),,
7,0,0,0,0,0,0,0,0,0,0,0,0,0,0,0,0,101,101,0.0,M2020-02-19D,Race(4),,
8,0,0,0,0,0,0,0,0,1,0,1,2,1,0,1,2,31,31,1.0,M2020-02-19D,Race(4),,
9,0,2,3,5,1,12,3,16,3,3,4,10,4,17,10,31,8,8,0.0,M2020-02-19D,Race(4),,
1,6,8,3,17,3,1,2,6,4,0,1,5,13,9,6,28,7,7,0.0,M2020-02-19D,Race(4),,
5,4,0,0,4,1,2,1,4,0,3,0,3,5,5,1,11,14,14,0.0,M2020-02-19D,Race(4),,
9,10,10,5,25,20,4,4,28,18,5,2,25,48,19,11,78,2.5,2.5,1.0,M2020-02-19D,Race(5),,
3,2,2,3,7,0,1,1,2,0,1,1,2,2,4,5,11,19,19,0.0,M2020-02-19D,Race(5),,
6,7,6,6,19,2,13,10,25,3,10,7,20,12,29,23,64,5.5,5.5,2.0,M2020-02-19D,Race(5),,
7,0,0,0,0,0,1,0,1,0,0,0,0,0,1,0,1,61,61,0.0,M2020-02-19D,Race(5),,
2,0,0,2,2,1,1,0,2,3,2,0,5,4,3,2,9,19,21,0.0,M2020-02-19D,Race(5),,
10,0,0,0,0,0,0,0,0,0,0,0,0,0,0,0,0,151,151,0.0,M2020-02-19D,Race(5),,
12,5,6,7,18,1,5,4,10,0,5,4,9,6,16,15,37,7,7,3.0,M2020-02-19D,Race(5),,
13,0,0,0,0,0,1,0,1,0,0,0,0,0,1,0,1,21,21,0.0,M2020-02-19D,Race(5),,
14,0,0,0,0,0,0,0,0,0,0,0,0,0,0,0,0,126,126,0.0,M2020-02-19D,Race(5),,
4,0,0,0,0,0,0,0,0,1,0,0,1,1,0,0,1,34,34,0.0,M2020-02-19D,Race(5),,
5,0,2,0,2,1,0,0,1,0,0,1,1,1,2,1,4,18,18,0.0,M2020-02-19D,Race(5),,
11,0,0,0,0,0,0,0,0,0,0,0,0,0,0,0,0,71,67,0.0,M2020-02-19D,Race(5),,
1,3,4,7,14,5,4,11,20,1,3,10,14,9,11,28,48,5,5,0.0,M2020-02-19D,Race(5),,
8,3,0,0,3,0,0,0,0,0,0,1,1,3,0,1,4,12,13,0.0,M2020-02-19D,Race(5),,
7,2,0,0,2,0,1,2,3,0,1,4,5,2,2,6,10,21,21,0.0,M2020-02-19D,Race(6),,
8,21,2,5,28,22,3,4,29,17,1,4,22,60,6,13,79,1.95,1.95,2.0,M2020-02-19D,Race(6),,
9,0,4,2,6,0,0,1,1,0,0,3,3,0,4,6,10,15,15,0.0,M2020-02-19D,Race(6),,
3,0,8,7,15,0,5,11,16,1,6,3,10,1,19,21,41,9,9,0.0,M2020-02-19D,Race(6),,
10,0,0,0,0,0,0,0,0,0,0,0,0,0,0,0,0,31,31,0.0,M2020-02-19D,Race(6),,
12,0,0,3,3,0,0,1,1,0,0,0,0,0,0,4,4,31,31,0.0,M2020-02-19D,Race(6),,
11,0,3,6,9,0,0,3,3,0,2,4,6,0,5,13,18,11,11,3.0,M2020-02-19D,Race(6),,
1,5,13,3,21,7,18,3,28,6,12,4,22,18,43,10,71,4.4,4.4,1.0,M2020-02-19D,Race(6),,
2,0,0,2,2,0,0,0,0,1,0,0,1,1,0,2,3,51,51,0.0,M2020-02-19D,Race(6),,
5,0,0,2,2,0,0,1,1,0,0,2,2,0,0,5,5,41,41,0.0,M2020-02-19D,Race(6),,
6,2,0,0,2,1,3,3,7,1,4,2,7,4,7,5,16,11,11,0.0,M2020-02-19D,Race(6),,
4,0,0,0,0,0,0,1,1,0,0,0,0,0,0,1,1,41,41,0.0,M2020-02-19D,Race(6),,
9,15,8,4,27,8,14,5,27,6,7,5,18,29,29,14,72,2.75,2.7,1.0,M2020-02-19D,Race(7),,
1,13,7,2,22,19,5,4,28,17,5,2,24,49,17,8,74,4.2,4.2,0.0,M2020-02-19D,Race(7),,
10,0,0,0,0,0,0,0,0,0,0,1,1,0,0,1,1,26,26,0.0,M2020-02-19D,Race(7),,
3,0,0,0,0,0,0,0,0,0,0,0,0,0,0,0,0,34,34,0.0,M2020-02-19D,Race(7),,
11,2,0,6,8,0,0,2,2,0,0,2,2,2,0,10,12,12,12,0.0,M2020-02-19D,Race(7),,
4,0,0,0,0,1,0,0,1,1,1,0,2,2,1,0,3,41,41,0.0,M2020-02-19D,Race(7),,
2,0,2,0,2,0,1,0,1,1,1,1,3,1,4,1,6,17,17,0.0,M2020-02-19D,Race(7),,
5,0,0,10,10,1,3,3,7,0,4,3,7,1,7,16,24,10,10,3.0,M2020-02-19D,Race(7),,
6,0,5,5,10,0,1,0,1,0,0,0,0,0,6,5,11,14,16,2.0,M2020-02-19D,Race(7),,
7,0,5,0,5,1,2,13,16,1,2,6,9,2,9,19,30,11,11,0.0,M2020-02-19D,Race(7),,
8,0,3,0,3,0,1,0,1,0,0,1,1,0,4,1,5,26,26,0.0,M2020-02-19D,Race(7),,
12,0,0,0,0,0,2,0,2,0,3,1,4,0,5,1,6,16,16,0.0,M2020-02-19D,Race(7),,
13,0,0,0,0,0,1,3,4,0,2,3,5,0,3,6,9,17,17,0.0,M2020-02-19D,Race(7),,
14,0,0,3,3,0,0,0,0,0,1,1,2,0,1,4,5,34,34,0.0,M2020-02-19D,Race(7),,
5,5,5,3,13,6,3,13,22,5,2,5,12,16,10,21,47,4.4,4.4,2.0,M2020-02-19D,Race(8),,
12,3,4,4,11,3,1,5,9,4,0,4,8,10,5,13,28,4.6,4.6,0.0,M2020-02-19D,Race(8),,
2,0,5,10,15,0,0,1,1,1,1,2,4,1,6,13,20,26,26,0.0,M2020-02-19D,Race(8),,
4,0,0,0,0,0,0,0,0,0,1,0,1,0,1,0,1,34,34,0.0,M2020-02-19D,Race(8),,
6,0,0,0,0,0,1,0,1,0,2,0,2,0,3,0,3,18,18,0.0,M2020-02-19D,Race(8),,
7,0,0,3,3,1,5,5,11,1,9,4,14,2,14,12,28,13,13,3.0,M2020-02-19D,Race(8),,
8,0,6,5,11,0,0,1,1,0,0,2,2,0,6,8,14,8.5,9,0.0,M2020-02-19D,Race(8),,
9,0,0,3,3,0,0,0,0,0,0,1,1,0,0,4,4,41,41,0.0,M2020-02-19D,Race(8),,
10,0,0,0,0,0,0,0,0,0,0,0,0,0,0,0,0,61,61,0.0,M2020-02-19D,Race(8),,
11,2,0,0,2,0,0,0,0,0,0,0,0,2,0,0,2,34,34,0.0,M2020-02-19D,Race(8),,
1,18,7,0,25,20,7,2,29,14,6,3,23,52,20,5,77,3,3,1.0,M2020-02-19D,Race(8),,
3,2,3,2,7,0,13,3,16,1,5,5,11,3,21,10,34,8.5,8.5,0.0,M2020-02-19D,Race(8),,
9,0,0,0,0,0,0,0,0,0,0,1,1,0,0,1,1,81,81,0.0,M2020-02-23D,Race(1),,
5,3,0,4,7,0,3,2,5,2,3,0,5,5,6,6,17,9.5,10,0.0,M2020-02-23D,Race(1),,
11,0,3,0,3,0,0,0,0,0,0,0,0,0,3,0,3,16,16,3.0,M2020-02-23D,Race(1),,
1,0,0,0,0,0,0,0,0,0,0,0,0,0,0,0,0,126,126,0.0,M2020-02-23D,Race(1),,
2,3,8,4,15,8,10,4,22,12,3,3,18,23,21,11,55,8.5,8,2.0,M2020-02-23D,Race(1),,
4,0,0,9,9,0,0,0,0,0,2,0,2,0,2,9,11,16,16,0.0,M2020-02-23D,Race(1),,
8,0,3,0,3,0,0,1,1,1,0,2,3,1,3,3,7,16,16,0.0,M2020-02-23D,Race(1),,
6,6,3,9,18,5,8,7,20,5,7,10,22,16,18,26,60,5,5,0.0,M2020-02-23D,Race(1),,
3,9,9,0,18,3,5,10,18,1,7,4,12,13,21,14,48,2.9,3,1.0,M2020-02-23D,Race(1),,
12,9,2,0,11,13,2,6,21,5,2,6,13,27,6,12,45,4.6,4.8,0.0,M2020-02-23D,Race(1),,
13,0,0,2,2,0,0,0,0,0,0,0,0,0,0,2,2,61,61,0.0,M2020-02-23D,Race(1),,
7,0,0,0,0,0,0,0,0,0,0,0,0,0,0,0,0,126,101,0.0,M2020-02-23D,Race(1),,
10,0,2,2,4,1,2,0,3,0,2,0,2,1,6,2,9,21,21,0.0,M2020-02-23D,Race(1),,
14,0,0,0,0,0,0,0,0,0,0,0,0,0,0,0,0,34,34,0.0,M2020-02-23D,Race(1),,
10,11,5,3,19,17,2,6,25,8,2,9,19,36,9,18,63,3.4,3.4,3.0,M2020-02-23D,Race(10),,
1,8,5,12,25,8,10,11,29,14,9,3,26,30,24,26,80,2.8,2.8,2.0,M2020-02-23D,Race(10),,
2,2,0,0,2,0,0,0,0,0,0,0,0,2,0,0,2,41,41,0.0,M2020-02-23D,Race(10),,
14,0,0,0,0,0,0,0,0,0,0,0,0,0,0,0,0,151,151,0.0,M2020-02-23D,Race(10),,
13,0,0,0,0,0,0,0,0,0,0,0,0,0,0,0,0,31,31,0.0,M2020-02-23D,Race(10),,
3,0,0,2,2,2,0,0,2,1,0,0,1,3,0,2,5,16,16,0.0,M2020-02-23D,Race(10),,
11,0,0,0,0,0,0,0,0,0,0,0,0,0,0,0,0,101,101,0.0,M2020-02-23D,Race(10),,
12,4,5,0,9,0,0,0,0,0,0,0,0,4,5,0,9,16,16,1.0,M2020-02-23D,Race(10),,
9,0,0,0,0,0,0,0,0,0,0,0,0,0,0,0,0,14,14,0.0,M2020-02-23D,Race(10),,
8,2,0,0,2,0,2,2,4,0,0,2,2,2,2,4,8,17,17,0.0,M2020-02-23D,Race(10),,
7,0,0,0,0,0,0,0,0,0,0,0,0,0,0,0,0,71,67,0.0,M2020-02-23D,Race(10),,
6,0,7,0,7,2,1,3,6,2,3,6,11,4,11,9,24,11,11,0.0,M2020-02-23D,Race(10),,
4,3,8,13,24,1,15,8,24,1,12,6,19,5,35,27,67,5.5,5.5,0.0,M2020-02-23D,Race(10),,
5,0,0,0,0,0,0,0,0,0,0,0,0,0,0,0,0,81,81,0.0,M2020-02-23D,Race(10),,
5,0,0,0,0,0,0,0,0,1,1,0,2,1,1,0,2,51,51,0.0,M2020-02-23D,Race(2),,
6,3,16,5,24,10,8,10,28,9,8,2,19,22,32,17,71,5,5,0.0,M2020-02-23D,Race(2),,
3,0,0,0,0,0,0,0,0,0,0,0,0,0,0,0,0,51,51,0.0,M2020-02-23D,Race(2),,
4,10,0,2,12,1,11,5,17,0,9,4,13,11,20,11,42,9,9,2.0,M2020-02-23D,Race(2),,
7,6,7,6,19,3,3,2,8,5,2,1,8,14,12,9,35,4.2,4.2,0.0,M2020-02-23D,Race(2),,
1,0,0,0,0,1,0,0,1,0,0,1,1,1,0,1,2,14,14,0.0,M2020-02-23D,Race(2),,
13,0,0,0,0,0,0,0,0,0,0,0,0,0,0,0,0,101,101,0.0,M2020-02-23D,Race(2),,
12,0,0,0,0,0,0,0,0,0,0,0,0,0,0,0,0,51,51,0.0,M2020-02-23D,Race(2),,
10,0,0,3,3,1,1,5,7,1,0,4,5,2,1,12,15,18,18,0.0,M2020-02-23D,Race(2),,
2,0,5,3,8,2,1,0,3,3,1,0,4,5,7,3,15,11,11,0.0,M2020-02-23D,Race(2),,
8,3,0,4,7,10,4,5,19,4,4,8,16,17,8,17,42,9,9,0.0,M2020-02-23D,Race(2),,
9,0,0,0,0,0,1,1,2,0,0,1,1,0,1,2,3,13,13,0.0,M2020-02-23D,Race(2),,
11,2,2,5,9,1,0,1,2,2,0,1,3,5,2,7,14,18,18,3.0,M2020-02-23D,Race(2),,
14,6,0,2,8,1,1,1,3,1,1,4,6,8,2,7,17,5,5,1.0,M2020-02-23D,Race(2),,
6,0,8,7,15,10,2,2,14,1,5,5,11,11,15,14,40,11,11,0.0,M2020-02-23D,Race(3),,
14,8,0,3,11,3,8,12,23,1,7,2,10,12,15,17,44,2.9,2.8,1.0,M2020-02-23D,Race(3),,
13,0,0,0,0,0,0,0,0,1,0,0,1,1,0,0,1,41,41,0.0,M2020-02-23D,Race(3),,
12,0,0,0,0,0,2,0,2,3,2,0,5,3,4,0,7,34,34,3.0,M2020-02-23D,Race(3),,
7,14,6,3,23,10,8,2,20,9,8,4,21,33,22,9,64,3.7,4.2,0.0,M2020-02-23D,Race(3),,
10,0,0,0,0,0,0,0,0,0,0,0,0,0,0,0,0,126,126,0.0,M2020-02-23D,Race(3),,
11,0,5,0,5,0,0,3,3,2,1,3,6,2,6,6,14,11,11,2.0,M2020-02-23D,Race(3),,
1,0,0,0,0,1,0,1,2,0,0,0,0,1,0,1,2,41,51,0.0,M2020-02-23D,Race(3),,
8,2,6,11,19,1,0,3,4,0,0,3,3,3,6,17,26,5.5,6,0.0,M2020-02-23D,Race(3),,
5,0,2,2,4,0,0,0,0,0,0,0,0,0,2,2,4,23,26,0.0,M2020-02-23D,Race(3),,
4,4,0,2,6,0,0,0,0,0,1,0,1,4,1,2,7,26,26,0.0,M2020-02-23D,Race(3),,
3,2,3,2,7,5,10,7,22,8,2,9,19,15,15,18,48,6.5,6.5,0.0,M2020-02-23D,Race(3),,
2,0,0,0,0,0,0,0,0,1,0,0,1,1,0,0,1,81,91,0.0,M2020-02-23D,Race(3),,
9,0,0,0,0,0,0,0,0,0,0,0,0,0,0,0,0,101,101,0.0,M2020-02-23D,Race(3),,
13,0,0,0,0,0,0,0,0,0,0,0,0,0,0,0,0,26,34,3.0,M2020-02-23D,Race(4),,
14,4,0,3,7,0,1,2,3,2,1,2,5,6,2,7,15,11,11,0.0,M2020-02-23D,Race(4),,
8,5,9,7,21,10,10,6,26,10,5,3,18,25,24,16,65,5,5,2.0,M2020-02-23D,Race(4),,
11,0,0,2,2,2,5,10,17,1,8,5,14,3,13,17,33,7,7,0.0,M2020-02-23D,Race(4),,
10,0,0,0,0,0,0,0,0,0,0,0,0,0,0,0,0,26,26,0.0,M2020-02-23D,Race(4),,
9,3,3,5,11,3,1,1,5,4,4,2,10,10,8,8,26,21,21,0.0,M2020-02-23D,Race(4),,
3,0,0,0,0,1,1,1,3,0,0,0,0,1,1,1,3,21,21,0.0,M2020-02-23D,Race(4),,
2,5,0,3,8,0,1,0,1,1,0,2,3,6,1,5,12,5.5,5.5,0.0,M2020-02-23D,Race(4),,
1,0,0,0,0,2,0,1,3,1,0,1,2,3,0,2,5,81,81,0.0,M2020-02-23D,Race(4),,
6,0,0,0,0,0,0,0,0,0,0,0,0,0,0,0,0,71,71,0.0,M2020-02-23D,Race(4),,
12,0,2,5,7,2,3,5,10,1,5,2,8,3,10,12,25,23,23,0.0,M2020-02-23D,Race(4),,
4,0,7,0,7,0,0,0,0,0,0,0,0,0,7,0,7,34,34,0.0,M2020-02-23D,Race(4),,
7,0,0,0,0,0,0,0,0,1,0,0,1,1,0,0,1,34,34,0.0,M2020-02-23D,Race(4),,
5,13,9,5,27,10,8,6,24,5,3,9,17,28,20,20,68,2.7,2.7,1.0,M2020-02-23D,Race(4),,
5,0,0,0,0,0,0,0,0,0,1,0,1,0,1,0,1,71,81,0.0,M2020-02-23D,Race(5),,
7,0,0,0,0,0,0,0,0,0,0,1,1,0,0,1,1,81,81,0.0,M2020-02-23D,Race(5),,
11,0,2,0,2,0,0,0,0,0,0,1,1,0,2,1,3,51,51,0.0,M2020-02-23D,Race(5),,
12,0,0,0,0,0,0,0,0,0,0,0,0,0,0,0,0,81,91,0.0,M2020-02-23D,Race(5),,
13,2,0,4,6,0,0,5,5,0,2,6,8,2,2,15,19,20,19,2.0,M2020-02-23D,Race(5),,
14,0,0,0,0,0,0,0,0,0,0,1,1,0,0,1,1,101,126,0.0,M2020-02-23D,Race(5),,
4,13,8,2,23,13,5,7,25,4,4,7,15,30,17,16,63,3,2.9,1.0,M2020-02-23D,Race(5),,
1,0,0,0,0,0,0,0,0,0,0,0,0,0,0,0,0,51,51,0.0,M2020-02-23D,Race(5),,
6,0,0,0,0,0,0,0,0,0,0,0,0,0,0,0,0,81,81,0.0,M2020-02-23D,Race(5),,
2,0,2,6,8,2,0,6,8,3,2,9,14,5,4,21,30,6.5,8,3.0,M2020-02-23D,Race(5),,
3,10,14,4,28,12,16,2,30,14,9,0,23,36,39,6,81,3.3,3.2,0.0,M2020-02-23D,Race(5),,
10,0,0,0,0,0,0,0,0,0,0,0,0,0,0,0,0,41,81,0.0,M2020-02-23D,Race(5),,
9,5,4,14,23,3,7,10,20,5,8,1,14,13,19,25,57,3.3,3.2,0.0,M2020-02-23D,Race(5),,
8,0,0,0,0,0,2,0,2,0,0,0,0,0,2,0,2,41,41,0.0,M2020-02-23D,Race(5),,
10,0,0,0,0,0,0,0,0,0,0,0,0,0,0,0,0,126,126,0.0,M2020-02-23D,Race(6),,
8,0,0,0,0,0,0,0,0,1,0,1,2,1,0,1,2,61,61,0.0,M2020-02-23D,Race(6),,
14,8,3,2,13,2,1,1,4,2,1,0,3,12,5,3,20,7,7,0.0,M2020-02-23D,Race(6),,
9,13,8,2,23,6,14,8,28,6,8,10,24,25,30,20,75,2.4,2.4,1.0,M2020-02-23D,Race(6),,
12,0,0,3,3,0,0,0,0,0,0,0,0,0,0,3,3,14,14,0.0,M2020-02-23D,Race(6),,
11,0,0,0,0,0,0,0,0,0,0,0,0,0,0,0,0,126,126,0.0,M2020-02-23D,Race(6),,
6,0,2,0,2,0,0,0,0,0,0,0,0,0,2,0,2,17,17,0.0,M2020-02-23D,Race(6),,
7,0,0,0,0,1,1,0,2,1,0,0,1,2,1,0,3,34,34,0.0,M2020-02-23D,Race(6),,
4,7,6,7,20,15,4,8,27,9,7,7,23,31,17,22,70,6,6,0.0,M2020-02-23D,Race(6),,
3,0,0,0,0,0,0,0,0,0,0,0,0,0,0,0,0,101,101,0.0,M2020-02-23D,Race(6),,
2,0,4,0,4,0,0,1,1,0,2,5,7,0,6,6,12,19,19,3.0,M2020-02-23D,Race(6),,
1,0,4,5,9,2,2,2,6,5,2,1,8,7,8,8,23,12,12,0.0,M2020-02-23D,Race(6),,
5,2,3,11,16,4,8,10,22,2,6,2,10,8,17,23,48,5,5,2.0,M2020-02-23D,Race(6),,
13,0,0,0,0,0,0,0,0,0,0,0,0,0,0,0,0,61,61,0.0,M2020-02-23D,Race(6),,
3,26,4,0,30,18,7,1,26,12,8,5,25,56,19,6,81,2.7,2.25,3.0,M2020-02-23D,Race(7),,
1,4,14,5,23,9,6,11,26,10,9,1,20,23,29,17,69,2.7,3,1.0,M2020-02-23D,Race(7),,
7,0,2,0,2,2,10,5,17,1,4,5,10,3,16,10,29,11,9,0.0,M2020-02-23D,Race(7),,
8,0,0,2,2,0,0,1,1,0,0,5,5,0,0,8,8,19,9.5,0.0,M2020-02-23D,Race(7),,
9,0,0,0,0,0,0,0,0,0,0,0,0,0,0,0,0,61,51,0.0,M2020-02-23D,Race(7),,
10,0,0,3,3,0,0,0,0,0,0,0,0,0,0,3,3,34,26,0.0,M2020-02-23D,Race(7),,
4,0,7,11,18,0,2,4,6,2,2,4,8,2,11,19,32,5.5,4.5,0.0,M2020-02-23D,Race(7),,
2,0,3,9,12,1,5,5,11,1,3,6,10,2,11,20,33,10,8.5,2.0,M2020-02-23D,Race(7),,
5,0,0,0,0,0,0,0,0,0,0,0,0,0,0,0,0,21,12,0.0,M2020-02-23D,Race(7),,
6,0,0,0,0,0,0,0,0,0,0,0,0,0,0,0,0,71,51,0.0,M2020-02-23D,Race(7),,
1,0,0,0,0,0,0,0,0,0,0,0,0,0,0,0,0,61,61,0.0,M2020-02-23D,Race(8),,
4,0,0,0,0,0,0,0,0,1,1,0,2,1,1,0,2,34,34,0.0,M2020-02-23D,Race(8),,
2,11,8,7,26,5,6,10,21,6,3,3,12,22,17,20,59,3.3,3.3,3.0,M2020-02-23D,Race(8),,
12,0,0,0,0,0,0,0,0,0,0,0,0,0,0,0,0,20,26,1.0,M2020-02-23D,Race(8),,
11,0,0,0,0,1,0,0,1,0,0,0,0,1,0,0,1,71,67,0.0,M2020-02-23D,Race(8),,
10,2,0,4,6,0,3,2,5,0,2,0,2,2,5,6,13,18,18,0.0,M2020-02-23D,Race(8),,
9,0,0,0,0,1,0,1,2,0,0,0,0,1,0,1,2,0,0,0.0,M2020-02-23D,Race(8),,
3,3,8,3,14,4,15,5,24,2,11,6,19,9,34,14,57,6.5,6.5,0.0,M2020-02-23D,Race(8),,
7,3,4,7,14,1,3,7,11,4,7,6,17,8,14,20,42,5,5,0.0,M2020-02-23D,Race(8),,
6,11,8,6,25,18,3,4,25,12,1,7,20,41,12,17,70,2.45,2.6,2.0,M2020-02-23D,Race(8),,
5,0,2,3,5,0,0,1,1,0,0,2,2,0,2,6,8,14,14,0.0,M2020-02-23D,Race(8),,
8,0,0,0,0,0,0,0,0,0,0,0,0,0,0,0,0,81,81,0.0,M2020-02-23D,Race(8),,
9,7,5,3,15,12,8,2,22,7,1,3,11,26,14,8,48,8.5,8.5,0.0,M2020-02-23D,Race(9),,
8,0,0,0,0,0,0,0,0,0,0,0,0,0,0,0,0,126,101,0.0,M2020-02-23D,Race(9),,
7,0,0,0,0,0,0,0,0,0,0,0,0,0,0,0,0,71,67,0.0,M2020-02-23D,Race(9),,
6,0,0,0,0,0,0,0,0,0,0,0,0,0,0,0,0,61,61,0.0,M2020-02-23D,Race(9),,
5,17,4,3,24,16,14,0,30,14,10,0,24,47,28,3,78,1.8,1.8,1.0,M2020-02-23D,Race(9),,
4,0,6,9,15,1,4,17,22,1,4,6,11,2,14,32,48,13,12,0.0,M2020-02-23D,Race(9),,
13,0,0,3,3,0,0,0,0,0,0,0,0,0,0,3,3,23,21,0.0,M2020-02-23D,Race(9),,
2,0,3,3,6,0,1,1,2,0,0,0,0,0,4,4,8,17,18,0.0,M2020-02-23D,Race(9),,
12,4,2,4,10,0,1,4,5,1,2,2,5,5,5,10,20,8.5,14,0.0,M2020-02-23D,Race(9),,
11,0,0,0,0,0,0,0,0,0,0,0,0,0,0,0,0,71,67,0.0,M2020-02-23D,Race(9),,
1,0,0,0,0,0,0,0,0,1,0,0,1,1,0,0,1,41,41,0.0,M2020-02-23D,Race(9),,
10,0,0,0,0,1,1,0,2,0,1,1,2,1,2,1,4,15,15,3.0,M2020-02-23D,Race(9),,
3,2,10,5,17,0,1,5,6,2,2,5,9,4,13,15,32,5.5,5,2.0,M2020-02-23D,Race(9),,
14,0,0,0,0,0,0,1,1,0,0,0,0,0,0,1,1,151,151,0.0,M2020-02-23D,Race(9),,
3,0,3,8,11,5,1,2,8,5,1,7,13,10,5,17,32,7.5,7.5,0.0,M2020-02-26D,Race(1),,
12,0,0,0,0,0,0,1,1,0,0,1,1,0,0,2,2,21,21,0.0,M2020-02-26D,Race(1),,
8,0,0,0,0,0,0,0,0,0,1,0,1,0,1,0,1,18,18,0.0,M2020-02-26D,Race(1),,
7,0,3,0,3,15,3,3,21,5,3,5,13,20,9,8,37,8.5,8.5,3.0,M2020-02-26D,Race(1),,
6,7,5,3,15,2,16,4,22,4,3,5,12,13,24,12,49,7.5,7.5,0.0,M2020-02-26D,Race(1),,
5,2,2,3,7,2,0,0,2,2,1,0,3,6,3,3,12,17,17,1.0,M2020-02-26D,Race(1),,
4,0,8,5,13,1,3,4,8,3,4,2,9,4,15,11,30,8.5,8.5,0.0,M2020-02-26D,Race(1),,
11,0,2,0,2,0,0,0,0,0,0,0,0,0,2,0,2,51,51,0.0,M2020-02-26D,Race(1),,
2,0,0,4,4,1,2,2,5,3,2,3,8,4,4,9,17,17,17,2.0,M2020-02-26D,Race(1),,
1,13,4,5,22,4,3,12,19,4,6,1,11,21,13,18,52,3.6,3.6,0.0,M2020-02-26D,Race(1),,
10,6,3,2,11,0,2,2,4,0,5,2,7,6,10,6,22,4.2,4.2,0.0,M2020-02-26D,Race(1),,
9,2,0,0,2,0,0,0,0,0,0,0,0,2,0,0,2,51,51,0.0,M2020-02-26D,Race(1),,
9,0,0,0,0,1,0,0,1,2,0,0,2,3,0,0,3,41,41,0.0,M2020-02-26D,Race(2),,
8,0,0,0,0,0,0,0,0,0,0,0,0,0,0,0,0,151,151,0.0,M2020-02-26D,Race(2),,
7,0,0,0,0,0,0,0,0,0,0,0,0,0,0,0,0,151,151,0.0,M2020-02-26D,Race(2),,
10,2,3,0,5,0,0,0,0,1,0,0,1,3,3,0,6,19,19,0.0,M2020-02-26D,Race(2),,
6,0,0,0,0,0,0,0,0,0,0,0,0,0,0,0,0,17,17,0.0,M2020-02-26D,Race(2),,
5,7,2,8,17,5,21,1,27,4,13,1,18,16,36,10,62,3.1,3.1,1.0,M2020-02-26D,Race(2),,
4,0,8,4,12,2,1,14,17,2,3,7,12,4,12,25,41,7,7,0.0,M2020-02-26D,Race(2),,
3,4,2,6,12,1,1,6,8,3,2,7,12,8,5,19,32,5,5,0.0,M2020-02-26D,Race(2),,
11,3,0,0,3,1,1,4,6,3,3,2,8,7,4,6,17,12,12,0.0,M2020-02-26D,Race(2),,
12,3,5,3,11,0,0,0,0,0,0,2,2,3,5,5,13,13,13,2.0,M2020-02-26D,Race(2),,
1,2,10,4,16,19,6,3,28,10,4,5,19,31,20,12,63,4.4,4.4,3.0,M2020-02-26D,Race(2),,
2,9,0,5,14,1,0,2,3,1,1,2,4,11,1,9,21,13,13,0.0,M2020-02-26D,Race(2),,
2,12,7,8,27,26,2,0,28,18,3,1,22,56,12,9,77,3.5,3.5,0.0,M2020-02-26D,Race(3),,
3,0,3,0,3,0,1,5,6,0,0,3,3,0,4,8,12,10,10,0.0,M2020-02-26D,Race(3),,
4,0,5,9,14,3,18,4,25,7,9,5,21,10,32,18,60,5,5,3.0,M2020-02-26D,Race(3),,
6,0,0,0,0,0,0,0,0,0,0,0,0,0,0,0,0,18,18,0.0,M2020-02-26D,Race(3),,
8,0,3,0,3,0,4,2,6,1,5,2,8,1,12,4,17,11,11,2.0,M2020-02-26D,Race(3),,
9,0,5,0,5,0,1,2,3,0,1,2,3,0,7,4,11,9.5,9.5,0.0,M2020-02-26D,Race(3),,
11,0,0,0,0,0,0,0,0,0,0,0,0,0,0,0,0,51,51,0.0,M2020-02-26D,Race(3),,
10,6,3,0,9,0,2,3,5,0,2,2,4,6,7,5,18,15,15,0.0,M2020-02-26D,Race(3),,
12,2,0,0,2,0,0,1,1,0,0,3,3,2,0,4,6,13,13,0.0,M2020-02-26D,Race(3),,
1,3,2,7,12,1,2,12,15,0,5,7,12,4,9,26,39,13,13,0.0,M2020-02-26D,Race(3),,
7,0,2,3,5,0,0,0,0,0,0,0,0,0,2,3,5,15,15,1.0,M2020-02-26D,Race(3),,
5,7,0,3,10,0,0,1,1,0,1,1,2,7,1,5,13,7.5,7.5,0.0,M2020-02-26D,Race(3),,
9,0,3,0,3,0,0,0,0,2,1,0,3,2,4,0,6,31,31,0.0,M2020-02-26D,Race(4),,
1,3,0,5,8,0,1,3,4,1,0,3,4,4,1,11,16,7,7,0.0,M2020-02-26D,Race(4),,
2,0,3,0,3,0,1,0,1,0,1,2,3,0,5,2,7,13,13,0.0,M2020-02-26D,Race(4),,
3,2,4,5,11,4,14,3,21,4,6,2,12,10,24,10,44,8,8,1.0,M2020-02-26D,Race(4),,
4,11,3,5,19,3,3,3,9,0,3,4,7,14,9,12,35,7,7,0.0,M2020-02-26D,Race(4),,
5,2,5,7,14,16,4,7,27,9,6,2,17,27,15,16,58,8,9,3.0,M2020-02-26D,Race(4),,
6,0,0,0,0,0,0,0,0,0,0,3,3,0,0,3,3,51,51,0.0,M2020-02-26D,Race(4),,
8,0,2,6,8,0,1,0,1,0,1,0,1,0,4,6,10,15,15,2.0,M2020-02-26D,Race(4),,
10,0,0,0,0,0,0,0,0,0,0,0,0,0,0,0,0,71,67,0.0,M2020-02-26D,Race(4),,
11,8,10,2,20,6,4,11,21,5,3,6,14,19,17,19,55,2.75,2.7,0.0,M2020-02-26D,Race(4),,
12,0,0,0,0,0,0,0,0,0,0,0,0,0,0,0,0,61,61,0.0,M2020-02-26D,Race(4),,
7,4,0,0,4,1,2,3,6,5,5,4,14,10,7,7,24,6,6,0.0,M2020-02-26D,Race(4),,
1,6,3,2,11,6,2,12,20,5,2,3,10,17,7,17,41,5,5,0.0,M2020-02-26D,Race(5),,
7,0,0,0,0,0,1,0,1,0,0,1,1,0,1,1,2,26,26,0.0,M2020-02-26D,Race(5),,
11,2,6,0,8,1,2,1,4,1,3,2,6,4,11,3,18,9.5,9.5,0.0,M2020-02-26D,Race(5),,
2,2,5,6,13,2,0,0,2,3,0,3,6,7,5,9,21,17,17,0.0,M2020-02-26D,Race(5),,
10,0,2,2,4,0,0,1,1,3,1,1,5,3,3,4,10,10,10,0.0,M2020-02-26D,Race(5),,
9,0,0,3,3,0,0,2,2,0,1,1,2,0,1,6,7,15,15,2.0,M2020-02-26D,Race(5),,
4,14,7,3,24,15,3,9,27,8,2,8,18,37,12,20,69,4,4,1.0,M2020-02-26D,Race(5),,
3,6,7,5,18,4,22,3,29,4,15,3,22,14,44,11,69,3.3,3.3,0.0,M2020-02-26D,Race(5),,
5,0,0,2,2,1,0,0,1,2,0,1,3,3,0,3,6,19,19,0.0,M2020-02-26D,Race(5),,
6,0,0,0,0,0,0,0,0,0,2,0,2,0,2,0,2,26,26,3.0,M2020-02-26D,Race(5),,
8,0,0,7,7,1,0,2,3,0,0,3,3,1,0,12,13,15,15,0.0,M2020-02-26D,Race(5),,
1,21,2,7,30,21,9,0,30,10,9,3,22,52,20,10,82,1.95,1.95,3.0,M2020-02-26D,Race(6),,
12,0,0,0,0,0,0,0,0,0,0,0,0,0,0,0,0,34,34,0.0,M2020-02-26D,Race(6),,
11,0,0,0,0,0,1,0,1,1,3,1,5,1,4,1,6,14,14,0.0,M2020-02-26D,Race(6),,
2,0,5,5,10,1,1,2,4,1,1,1,3,2,7,8,17,19,19,1.0,M2020-02-26D,Race(6),,
10,0,0,0,0,0,0,0,0,0,0,0,0,0,0,0,0,71,67,0.0,M2020-02-26D,Race(6),,
7,2,0,0,2,1,1,6,8,2,2,6,10,5,3,12,20,7,7,2.0,M2020-02-26D,Race(6),,
6,2,11,3,16,3,3,12,18,4,5,6,15,9,19,21,49,11,11,0.0,M2020-02-26D,Race(6),,
5,0,0,0,0,0,0,0,0,0,0,0,0,0,0,0,0,41,41,0.0,M2020-02-26D,Race(6),,
4,0,2,5,7,0,0,2,2,1,2,1,4,1,4,8,13,12,12,0.0,M2020-02-26D,Race(6),,
3,5,10,10,25,4,15,6,25,7,4,4,15,16,29,20,65,7,7,0.0,M2020-02-26D,Race(6),,
9,0,0,0,0,0,0,2,2,0,0,4,4,0,0,6,6,21,21,0.0,M2020-02-26D,Race(6),,
8,0,0,0,0,0,0,0,0,0,0,0,0,0,0,0,0,15,15,0.0,M2020-02-26D,Race(6),,
9,0,0,0,0,0,0,0,0,0,0,1,1,0,0,1,1,41,41,3.0,M2020-02-26D,Race(7),,
8,0,7,3,10,2,2,7,11,1,4,6,11,3,13,16,32,8,8,1.0,M2020-02-26D,Race(7),,
10,0,0,0,0,0,0,0,0,0,0,0,0,0,0,0,0,91,91,0.0,M2020-02-26D,Race(7),,
7,0,0,3,3,0,0,0,0,0,0,0,0,0,0,3,3,17,17,0.0,M2020-02-26D,Race(7),,
2,0,7,14,21,1,3,16,20,2,5,7,14,3,15,37,55,7,7,0.0,M2020-02-26D,Race(7),,
4,23,3,4,30,24,5,1,30,19,2,2,23,66,10,7,83,1.7,1.7,0.0,M2020-02-26D,Race(7),,
5,0,0,0,0,0,1,1,2,1,2,4,7,1,3,5,9,12,12,0.0,M2020-02-26D,Race(7),,
1,5,11,6,22,3,19,3,25,3,10,3,16,11,40,12,63,6.5,6.5,2.0,M2020-02-26D,Race(7),,
3,2,0,0,2,0,0,0,0,0,1,0,1,2,1,0,3,34,34,0.0,M2020-02-26D,Race(7),,
6,0,2,0,2,0,0,2,2,0,2,3,5,0,4,5,9,16,16,0.0,M2020-02-26D,Race(7),,
2,0,9,2,11,1,1,12,14,0,2,5,7,1,12,19,32,17,17,0.0,M2020-02-26D,Race(8),,
3,0,0,0,0,0,0,0,0,2,0,0,2,2,0,0,2,41,41,0.0,M2020-02-26D,Race(8),,
10,13,7,5,25,9,14,1,24,8,12,1,21,30,33,7,70,3.2,3.2,2.0,M2020-02-26D,Race(8),,
9,2,0,0,2,0,0,2,2,0,0,1,1,2,0,3,5,12,12,0.0,M2020-02-26D,Race(8),,
8,0,0,5,5,1,4,4,9,0,1,4,5,1,5,13,19,7.5,7.5,0.0,M2020-02-26D,Race(8),,
6,0,0,0,0,0,1,1,2,0,0,2,2,0,1,3,4,31,31,0.0,M2020-02-26D,Race(8),,
5,5,11,3,19,2,5,5,12,6,4,6,16,13,20,14,47,4,4,1.0,M2020-02-26D,Race(8),,
7,0,0,0,0,0,0,0,0,0,0,0,0,0,0,0,0,31,31,0.0,M2020-02-26D,Race(8),,
1,3,0,4,7,2,2,3,7,2,2,2,6,7,4,9,20,8.5,8.5,0.0,M2020-02-26D,Race(8),,
12,0,0,0,0,0,0,0,0,0,1,0,1,0,1,0,1,21,21,0.0,M2020-02-26D,Race(8),,
11,0,0,0,0,0,0,0,0,0,0,0,0,0,0,0,0,51,51,0.0,M2020-02-26D,Race(8),,
4,7,3,11,21,15,3,2,20,8,4,5,17,30,10,18,58,6,6,3.0,M2020-02-26D,Race(8),,
7,0,6,6,12,0,0,1,1,0,0,3,3,0,6,10,16,6,6,0.0,M2020-02-26D,Race(9),,
4,0,0,0,0,0,0,0,0,1,0,0,1,1,0,0,1,26,26,0.0,M2020-02-26D,Race(9),,
5,10,0,3,13,0,14,5,19,0,1,3,4,10,15,11,36,5,5,1.0,M2020-02-26D,Race(9),,
6,0,2,7,9,9,4,12,25,9,11,2,22,18,17,21,56,10,10,2.0,M2020-02-26D,Race(9),,
8,3,9,4,16,2,2,6,10,1,4,8,13,6,15,18,39,4.2,4.2,3.0,M2020-02-26D,Race(9),,
9,0,0,0,0,0,0,0,0,0,0,2,2,0,0,2,2,34,34,0.0,M2020-02-26D,Race(9),,
10,0,0,0,0,0,0,0,0,0,0,0,0,0,0,0,0,51,51,0.0,M2020-02-26D,Race(9),,
11,2,0,2,4,2,0,1,3,0,1,2,3,4,1,5,10,26,26,0.0,M2020-02-26D,Race(9),,
2,0,4,3,7,0,0,1,1,1,0,0,1,1,4,4,9,26,26,0.0,M2020-02-26D,Race(9),,
12,0,0,0,0,0,0,0,0,0,0,0,0,0,0,0,0,61,61,0.0,M2020-02-26D,Race(9),,
3,3,0,2,5,0,2,2,4,0,0,5,5,3,2,9,14,10,10,0.0,M2020-02-26D,Race(9),,
1,12,9,3,24,17,8,2,27,14,9,1,24,43,26,6,75,3.4,3.4,0.0,M2020-02-26D,Race(9),,
6,5,2,2,9,2,2,14,18,2,4,10,16,9,8,26,43,8,8,0.0,M2020-03-01D,Race(1),,
4,0,0,0,0,0,0,0,0,0,0,0,0,0,0,0,0,61,61,0.0,M2020-03-01D,Race(1),,
5,7,3,3,13,0,2,2,4,1,4,1,6,8,9,6,23,5,5,3.0,M2020-03-01D,Race(1),,
2,0,9,10,19,3,8,3,14,6,8,2,16,9,25,15,49,6.5,6.5,2.0,M2020-03-01D,Race(1),,
7,0,2,3,5,3,1,0,4,2,0,0,2,5,3,3,11,11,11,0.0,M2020-03-01D,Race(1),,
8,0,0,0,0,0,0,0,0,0,0,0,0,0,0,0,0,151,151,0.0,M2020-03-01D,Race(1),,
3,8,4,7,19,15,5,3,23,5,5,3,13,28,14,13,55,2.7,2.7,1.0,M2020-03-01D,Race(1),,
9,2,0,0,2,0,0,0,0,1,0,1,2,3,0,1,4,61,61,0.0,M2020-03-01D,Race(1),,
11,0,0,3,3,0,0,2,2,1,0,2,3,1,0,7,8,15,15,0.0,M2020-03-01D,Race(1),,
12,0,0,0,0,1,0,1,2,0,0,0,0,1,0,1,2,101,101,0.0,M2020-03-01D,Race(1),,
13,0,0,0,0,0,0,0,0,0,1,1,2,0,1,1,2,71,67,0.0,M2020-03-01D,Race(1),,
14,0,0,0,0,0,0,0,0,0,0,0,0,0,0,0,0,151,151,0.0,M2020-03-01D,Race(1),,
1,8,7,2,17,6,12,4,22,8,2,4,14,22,21,10,53,6,6,0.0,M2020-03-01D,Race(1),,
10,0,3,0,3,0,0,1,1,0,2,2,4,0,5,3,8,31,31,0.0,M2020-03-01D,Race(1),,
7,12,0,3,15,14,9,4,27,8,9,6,23,34,18,13,65,2.5,2.5,1.0,M2020-03-01D,Race(10),,
6,0,0,0,0,0,0,0,0,0,2,0,2,0,2,0,2,151,151,0.0,M2020-03-01D,Race(10),,
8,0,6,8,14,5,5,11,21,6,5,2,13,11,16,21,48,12,12,0.0,M2020-03-01D,Race(10),,
1,9,12,2,23,7,9,9,25,5,1,11,17,21,22,22,65,3.9,3.8,2.0,M2020-03-01D,Race(10),,
13,0,0,2,2,0,0,0,0,0,0,0,0,0,0,2,2,19,19,3.0,M2020-03-01D,Race(10),,
5,0,0,0,0,0,0,0,0,0,0,0,0,0,0,0,0,61,61,0.0,M2020-03-01D,Race(10),,
12,0,2,0,2,0,0,0,0,0,0,0,0,0,2,0,2,41,41,0.0,M2020-03-01D,Race(10),,
11,0,0,0,0,0,0,0,0,0,0,0,0,0,0,0,0,31,31,0.0,M2020-03-01D,Race(10),,
14,0,3,0,3,0,0,0,0,0,0,0,0,0,3,0,3,18,19,0.0,M2020-03-01D,Race(10),,
4,0,2,5,7,0,1,1,2,1,3,2,6,1,6,8,15,13,13,0.0,M2020-03-01D,Race(10),,
9,3,0,3,6,1,2,1,4,1,1,2,4,5,3,6,14,16,16,0.0,M2020-03-01D,Race(10),,
2,6,5,2,13,2,4,1,7,5,5,0,10,13,14,3,30,7,7,0.0,M2020-03-01D,Race(10),,
10,0,0,5,5,1,0,3,4,0,0,2,2,1,0,10,11,31,31,0.0,M2020-03-01D,Race(10),,
3,0,0,0,0,0,0,0,0,0,0,1,1,0,0,1,1,31,31,0.0,M2020-03-01D,Race(10),,
14,0,0,0,0,0,0,0,0,0,0,0,0,0,0,0,0,41,41,0.0,M2020-03-01D,Race(2),,
13,0,0,2,2,0,0,0,0,0,0,0,0,0,0,2,2,17,17,0.0,M2020-03-01D,Race(2),,
12,0,0,0,0,0,0,3,3,0,0,3,3,0,0,6,6,31,31,0.0,M2020-03-01D,Race(2),,
11,0,0,0,0,1,0,1,2,1,0,1,2,2,0,2,4,31,31,0.0,M2020-03-01D,Race(2),,
10,0,0,0,0,0,0,0,0,0,0,0,0,0,0,0,0,61,61,0.0,M2020-03-01D,Race(2),,
5,5,12,0,17,2,5,5,12,6,8,4,18,13,25,9,47,5,5,2.0,M2020-03-01D,Race(2),,
3,3,3,8,14,0,0,1,1,0,0,3,3,3,3,12,18,9,9,0.0,M2020-03-01D,Race(2),,
4,3,0,0,3,0,0,2,2,2,0,4,6,5,0,6,11,17,17,0.0,M2020-03-01D,Race(2),,
2,7,0,2,9,2,13,4,19,3,4,3,10,12,17,9,38,6.5,6.5,0.0,M2020-03-01D,Race(2),,
1,2,0,0,2,1,1,0,2,0,1,2,3,3,2,2,7,13,13,3.0,M2020-03-01D,Race(2),,
6,2,3,3,8,2,4,2,8,2,4,1,7,6,11,6,23,10,10,0.0,M2020-03-01D,Race(2),,
7,3,0,9,12,12,4,10,26,9,3,5,17,24,7,24,55,9,9,0.0,M2020-03-01D,Race(2),,
8,0,0,0,0,0,0,0,0,0,1,0,1,0,1,0,1,126,126,0.0,M2020-03-01D,Race(2),,
9,5,12,6,23,10,3,2,15,3,5,0,8,18,20,8,46,3.4,3.4,1.0,M2020-03-01D,Race(2),,
3,0,0,2,2,0,1,1,2,0,0,3,3,0,1,6,7,31,31,0.0,M2020-03-01D,Race(3),,
12,15,10,0,25,12,8,4,24,5,12,3,20,32,30,7,69,3.9,3.9,3.0,M2020-03-01D,Race(3),,
4,0,0,5,5,0,0,0,0,1,0,1,2,1,0,6,7,26,26,0.0,M2020-03-01D,Race(3),,
11,3,0,8,11,0,1,1,2,0,0,2,2,3,1,11,15,5.5,5.5,0.0,M2020-03-01D,Race(3),,
10,0,0,0,0,1,0,1,2,0,0,0,0,1,0,1,2,41,41,0.0,M2020-03-01D,Race(3),,
2,0,2,2,4,0,1,3,4,0,1,2,3,0,4,7,11,15,15,0.0,M2020-03-01D,Race(3),,
9,0,3,3,6,1,0,1,2,1,2,3,6,2,5,7,14,10,10,0.0,M2020-03-01D,Race(3),,
8,0,0,0,0,0,0,0,0,0,1,0,1,0,1,0,1,31,31,0.0,M2020-03-01D,Race(3),,
7,0,0,2,2,0,0,1,1,0,0,2,2,0,0,5,5,12,14,1.0,M2020-03-01D,Race(3),,
13,0,0,0,0,0,0,0,0,0,0,0,0,0,0,0,0,20,20,0.0,M2020-03-01D,Race(3),,
1,10,10,8,28,14,8,8,30,16,6,1,23,40,24,17,81,3.4,3.4,0.0,M2020-03-01D,Race(3),,
5,0,0,0,0,0,0,0,0,0,0,0,0,0,0,0,0,61,61,0.0,M2020-03-01D,Race(3),,
6,2,5,0,7,2,11,10,23,3,4,9,16,7,20,19,46,9,9,0.0,M2020-03-01D,Race(3),,
14,0,0,0,0,0,0,0,0,0,0,0,0,0,0,0,0,0,0,2.0,M2020-03-01D,Race(3),,
2,0,0,3,3,1,0,0,1,1,0,0,1,2,0,3,5,26,26,0.0,M2020-03-01D,Race(4),,
3,9,13,0,22,10,7,2,19,11,9,2,22,30,29,4,63,2.45,2.5,2.0,M2020-03-01D,Race(4),,
4,0,0,0,0,0,0,0,0,1,0,0,1,1,0,0,1,126,126,0.0,M2020-03-01D,Race(4),,
5,10,7,7,24,13,5,10,28,5,3,10,18,28,15,27,70,3.6,3.6,1.0,M2020-03-01D,Race(4),,
6,0,0,0,0,0,0,0,0,0,0,0,0,0,0,0,0,101,101,0.0,M2020-03-01D,Race(4),,
7,0,0,0,0,0,0,0,0,0,1,0,1,0,1,0,1,101,101,0.0,M2020-03-01D,Race(4),,
8,0,0,0,0,0,0,0,0,0,0,0,0,0,0,0,0,71,67,0.0,M2020-03-01D,Race(4),,
9,0,2,6,8,2,9,5,16,2,4,7,13,4,15,18,37,11,11,0.0,M2020-03-01D,Race(4),,
1,11,5,9,25,4,9,11,24,5,9,4,18,20,23,24,67,4.6,4.6,3.0,M2020-03-01D,Race(4),,
11,0,3,0,3,0,0,0,0,0,0,0,0,0,3,0,3,16,16,0.0,M2020-03-01D,Race(4),,
12,0,0,0,0,0,0,0,0,0,0,0,0,0,0,0,0,41,41,0.0,M2020-03-01D,Race(4),,
13,0,0,2,2,0,0,0,0,0,0,0,0,0,0,2,2,41,41,0.0,M2020-03-01D,Race(4),,
14,0,0,3,3,0,0,0,0,1,0,0,1,1,0,3,4,16,16,0.0,M2020-03-01D,Race(4),,
10,0,0,0,0,0,0,2,2,0,0,3,3,0,0,5,5,26,26,0.0,M2020-03-01D,Race(4),,
1,10,8,0,18,10,11,2,23,5,10,2,17,25,29,4,58,7,7,2.0,M2020-03-01D,Race(5),,
2,6,9,7,22,14,11,4,29,14,3,8,25,34,23,19,76,4.6,4.6,1.0,M2020-03-01D,Race(5),,
3,0,0,0,0,0,0,0,0,0,0,0,0,0,0,0,0,41,41,0.0,M2020-03-01D,Race(5),,
4,0,3,5,8,0,1,2,3,0,1,1,2,0,5,8,13,6.5,6.5,0.0,M2020-03-01D,Race(5),,
5,0,3,0,3,0,0,1,1,0,0,1,1,0,3,2,5,17,17,0.0,M2020-03-01D,Race(5),,
7,7,0,0,7,0,2,0,2,0,2,0,2,7,4,0,11,14,14,0.0,M2020-03-01D,Race(5),,
14,3,2,8,13,2,3,8,13,4,3,7,14,9,8,23,40,7.5,7.5,0.0,M2020-03-01D,Race(5),,
9,2,0,8,10,2,0,0,2,0,1,1,2,4,1,9,14,8,8.5,3.0,M2020-03-01D,Race(5),,
10,0,0,0,0,0,0,0,0,0,0,0,0,0,0,0,0,126,126,0.0,M2020-03-01D,Race(5),,
6,0,0,0,0,0,0,0,0,0,1,0,1,0,1,0,1,31,34,0.0,M2020-03-01D,Race(5),,
11,0,5,2,7,2,2,13,17,3,4,6,13,5,11,21,37,4,4,0.0,M2020-03-01D,Race(5),,
12,2,0,0,2,0,0,0,0,0,0,0,0,2,0,0,2,31,31,0.0,M2020-03-01D,Race(5),,
13,0,0,0,0,0,0,0,0,0,0,0,0,0,0,0,0,51,51,0.0,M2020-03-01D,Race(5),,
8,0,0,0,0,0,0,0,0,0,1,0,1,0,1,0,1,51,51,0.0,M2020-03-01D,Race(5),,
1,3,2,3,8,1,3,4,8,0,1,2,3,4,6,9,19,7,7.5,0.0,M2020-03-01D,Race(6),,
2,0,2,0,2,1,0,2,3,2,1,1,4,3,3,3,9,13,13,0.0,M2020-03-01D,Race(6),,
11,0,2,0,2,0,0,1,1,0,0,0,0,0,2,1,3,26,23,3.0,M2020-03-01D,Race(6),,
5,0,0,0,0,0,0,0,0,1,0,0,1,1,0,0,1,81,81,0.0,M2020-03-01D,Race(6),,
6,0,2,9,11,3,7,10,20,3,8,4,15,6,17,23,46,5.5,7,0.0,M2020-03-01D,Race(6),,
7,0,0,0,0,0,0,1,1,0,0,2,2,0,0,3,3,126,126,0.0,M2020-03-01D,Race(6),,
8,3,0,9,12,0,1,0,1,0,0,3,3,3,1,12,16,7.5,8.5,1.0,M2020-03-01D,Race(6),,
9,0,0,0,0,0,0,0,0,0,0,0,0,0,0,0,0,51,51,0.0,M2020-03-01D,Race(6),,
10,0,0,0,0,0,0,0,0,0,0,0,0,0,0,0,0,61,61,0.0,M2020-03-01D,Race(6),,
4,5,17,6,28,8,15,5,28,9,8,5,22,22,40,16,78,4,4.2,0.0,M2020-03-01D,Race(6),,
3,0,0,0,0,0,0,0,0,0,0,0,0,0,0,0,0,16,17,0.0,M2020-03-01D,Race(6),,
12,0,0,0,0,0,0,2,2,0,1,6,7,0,1,8,9,18,21,0.0,M2020-03-01D,Race(6),,
14,19,5,3,27,17,4,5,26,11,7,3,21,47,16,11,74,2.65,2.8,2.0,M2020-03-01D,Race(6),,
13,0,0,0,0,0,0,0,0,0,0,0,0,0,0,0,0,151,151,0.0,M2020-03-01D,Race(6),,
13,0,2,0,2,0,0,0,0,0,0,1,1,0,2,1,3,151,151,0.0,M2020-03-01D,Race(7),,
12,,,,,,,,,,,,,,,,,,,0.0,M2020-03-01D,Race(7),,
11,0,0,2,2,0,0,0,0,0,0,0,0,0,0,2,2,17,17,0.0,M2020-03-01D,Race(7),,
10,2,0,5,7,0,0,2,2,1,0,1,2,3,0,8,11,7,7,3.0,M2020-03-01D,Race(7),,
9,0,0,0,0,0,0,0,0,0,0,0,0,0,0,0,0,151,151,0.0,M2020-03-01D,Race(7),,
8,0,0,3,3,0,0,1,1,1,1,0,2,1,1,4,6,26,26,0.0,M2020-03-01D,Race(7),,
7,0,0,3,3,0,0,0,0,0,0,0,0,0,0,3,3,41,41,0.0,M2020-03-01D,Race(7),,
6,2,0,2,4,1,1,5,7,2,0,7,9,5,1,14,20,10,10,0.0,M2020-03-01D,Race(7),,
5,0,0,0,0,0,0,0,0,0,0,0,0,0,0,0,0,61,61,0.0,M2020-03-01D,Race(7),,
3,0,0,0,0,0,0,0,0,0,0,0,0,0,0,0,0,126,126,0.0,M2020-03-01D,Race(7),,
14,0,0,3,3,0,0,0,0,0,0,0,0,0,0,3,3,91,91,0.0,M2020-03-01D,Race(7),,
4,8,18,2,28,7,13,6,26,4,10,8,22,19,41,16,76,3,3,2.0,M2020-03-01D,Race(7),,
2,18,7,5,30,21,9,0,30,18,6,1,25,57,22,6,85,2.4,2.4,1.0,M2020-03-01D,Race(7),,
1,0,3,5,8,0,6,16,22,0,8,7,15,0,17,28,45,8.5,8.5,0.0,M2020-03-01D,Race(7),,
3,0,5,2,7,0,1,2,3,0,0,2,2,0,6,6,12,6.5,6,0.0,M2020-03-01D,Race(8),,
4,0,0,0,0,0,0,0,0,0,1,0,1,0,1,0,1,34,34,0.0,M2020-03-01D,Race(8),,
5,0,0,2,2,0,0,0,0,0,0,0,0,0,0,2,2,126,126,0.0,M2020-03-01D,Race(8),,
14,2,0,2,4,0,0,2,2,0,0,2,2,2,0,6,8,20,26,1.0,M2020-03-01D,Race(8),,
13,0,0,0,0,0,0,0,0,0,0,0,0,0,0,0,0,61,67,3.0,M2020-03-01D,Race(8),,
6,0,0,2,2,0,3,0,3,0,6,0,6,0,9,2,11,20,21,2.0,M2020-03-01D,Race(8),,
7,0,0,0,0,0,0,0,0,0,0,0,0,0,0,0,0,151,151,0.0,M2020-03-01D,Race(8),,
9,0,0,0,0,1,1,1,3,0,1,1,2,1,2,2,5,9.5,9,0.0,M2020-03-01D,Race(8),,
10,5,15,3,23,1,4,14,19,2,4,5,11,8,23,22,53,6,5,0.0,M2020-03-01D,Race(8),,
11,0,0,13,13,7,10,5,22,0,8,5,13,7,18,23,48,7.5,9,0.0,M2020-03-01D,Race(8),,
12,0,0,0,0,0,0,0,0,0,0,0,0,0,0,0,0,31,31,0.0,M2020-03-01D,Race(8),,
2,23,4,3,30,21,8,1,30,23,2,0,25,67,14,4,85,2.45,2.4,0.0,M2020-03-01D,Race(8),,
8,0,6,3,9,0,3,5,8,1,4,11,16,1,13,19,33,14,13,0.0,M2020-03-01D,Race(8),,
1,0,0,0,0,0,0,0,0,0,0,0,0,0,0,0,0,51,51,0.0,M2020-03-01D,Race(8),,
1,28,2,0,30,21,8,1,30,24,0,1,25,73,10,2,85,1.45,1.45,0.0,M2020-03-01D,Race(9),,
14,0,0,0,0,0,0,0,0,0,0,0,0,0,0,0,0,91,91,0.0,M2020-03-01D,Race(9),,
5,0,0,0,0,0,0,0,0,1,2,0,3,1,2,0,3,61,61,0.0,M2020-03-01D,Race(9),,
6,0,0,0,0,1,0,1,2,0,0,2,2,1,0,3,4,17,17,3.0,M2020-03-01D,Race(9),,
7,0,0,0,0,0,0,0,0,0,0,1,1,0,0,1,1,101,101,0.0,M2020-03-01D,Race(9),,
8,0,2,0,2,0,1,15,16,0,0,7,7,0,3,22,25,16,16,1.0,M2020-03-01D,Race(9),,
9,0,8,7,15,0,2,1,3,0,0,2,2,0,10,10,20,11,11,2.0,M2020-03-01D,Race(9),,
10,0,0,0,0,0,0,0,0,0,0,0,0,0,0,0,0,51,51,0.0,M2020-03-01D,Race(9),,
11,0,0,3,3,0,0,0,0,0,0,0,0,0,0,3,3,61,61,0.0,M2020-03-01D,Race(9),,
12,2,10,11,23,8,13,5,26,1,15,5,21,11,38,21,70,6.5,6.5,0.0,M2020-03-01D,Race(9),,
13,0,0,0,0,0,0,3,3,0,1,2,3,0,1,5,6,71,67,0.0,M2020-03-01D,Race(9),,
2,0,2,2,4,0,1,2,3,0,2,3,5,0,5,7,12,17,17,0.0,M2020-03-01D,Race(9),,
3,0,0,2,2,0,0,0,0,0,0,0,0,0,0,2,2,31,31,0.0,M2020-03-01D,Race(9),,
4,0,6,5,11,0,5,2,7,0,6,3,9,0,17,10,27,23,23,0.0,M2020-03-01D,Race(9),,
6,5,0,9,14,1,4,3,8,2,5,2,9,8,9,14,31,6,6,0.0,M2020-03-04D,Race(1),,
12,5,6,0,11,2,2,4,8,3,4,4,11,10,12,8,30,5,5,0.0,M2020-03-04D,Race(1),,
11,0,0,0,0,2,0,0,2,2,0,1,3,4,0,1,5,21,21,0.0,M2020-03-04D,Race(1),,
1,0,8,7,15,5,11,5,21,5,3,5,13,10,22,17,49,7,8,0.0,M2020-03-04D,Race(1),,
2,3,0,0,3,0,0,2,2,1,2,2,5,4,2,4,10,18,18,2.0,M2020-03-04D,Race(1),,
3,2,0,3,5,1,1,0,2,1,0,1,2,4,1,4,9,9,9,0.0,M2020-03-04D,Race(1),,
4,13,7,5,25,18,7,2,27,10,3,3,16,41,17,10,68,3,3,0.0,M2020-03-04D,Race(1),,
5,2,2,4,8,1,4,11,16,1,5,2,8,4,11,17,32,15,15,3.0,M2020-03-04D,Race(1),,
10,0,3,0,3,0,1,1,2,0,1,2,3,0,5,3,8,21,21,0.0,M2020-03-04D,Race(1),,
7,0,0,0,0,0,0,2,2,0,3,3,6,0,3,5,8,26,26,1.0,M2020-03-04D,Race(1),,
8,0,2,0,2,0,0,0,0,1,0,1,2,1,2,1,4,31,31,0.0,M2020-03-04D,Race(1),,
9,0,2,2,4,0,0,0,0,0,0,0,0,0,2,2,4,18,18,0.0,M2020-03-04D,Race(1),,
3,2,0,2,4,0,2,2,4,0,1,3,4,2,3,7,12,11,11,0.0,M2020-03-04D,Race(2),,
2,6,10,3,19,5,4,13,22,7,5,5,17,18,19,21,58,4.8,4.8,0.0,M2020-03-04D,Race(2),,
1,0,0,0,0,0,0,0,0,0,0,0,0,0,0,0,0,71,67,3.0,M2020-03-04D,Race(2),,
11,0,0,0,0,0,0,1,1,0,0,0,0,0,0,1,1,61,61,0.0,M2020-03-04D,Race(2),,
8,11,5,7,23,17,6,3,26,13,8,3,24,41,19,13,73,2.9,2.9,2.0,M2020-03-04D,Race(2),,
9,0,0,0,0,0,0,1,1,0,1,0,1,0,1,1,2,17,17,0.0,M2020-03-04D,Race(2),,
10,0,2,0,2,3,2,3,8,0,3,5,8,3,7,8,18,8.5,8.5,1.0,M2020-03-04D,Race(2),,
6,0,3,5,8,1,1,2,4,3,2,2,7,4,6,9,19,13,13,0.0,M2020-03-04D,Race(2),,
7,0,0,0,0,0,0,0,0,0,0,0,0,0,0,0,0,41,41,0.0,M2020-03-04D,Race(2),,
4,3,5,0,8,2,12,3,17,1,6,3,10,6,23,6,35,7.5,7.5,0.0,M2020-03-04D,Race(2),,
12,3,2,7,12,0,1,1,2,1,0,3,4,4,3,11,18,11,11,0.0,M2020-03-04D,Race(2),,
5,5,3,6,14,2,2,1,5,1,0,2,3,8,5,9,22,10,10,0.0,M2020-03-04D,Race(2),,
12,0,0,0,0,0,0,0,0,0,0,0,0,0,0,0,0,151,151,0.0,M2020-03-04D,Race(3),,
2,0,7,5,12,4,13,7,24,2,6,3,11,6,26,15,47,8.5,8.5,3.0,M2020-03-04D,Race(3),,
1,12,3,9,24,3,3,1,7,8,2,2,12,23,8,12,43,3.5,3.5,0.0,M2020-03-04D,Race(3),,
5,12,6,5,23,17,7,2,26,10,9,2,21,39,22,9,70,4.4,4.4,1.0,M2020-03-04D,Race(3),,
6,0,2,0,2,0,0,0,0,0,0,0,0,0,2,0,2,51,51,0.0,M2020-03-04D,Race(3),,
7,0,0,6,6,2,2,6,10,2,3,5,10,4,5,17,26,7,7,0.0,M2020-03-04D,Race(3),,
8,0,0,2,2,0,0,0,0,0,1,1,2,0,1,3,4,12,14,0.0,M2020-03-04D,Race(3),,
9,3,9,0,12,0,1,3,4,2,1,5,8,5,11,8,24,8.5,8.5,2.0,M2020-03-04D,Race(3),,
10,0,0,0,0,0,0,0,0,0,0,0,0,0,0,0,0,81,81,0.0,M2020-03-04D,Race(3),,
11,0,0,0,0,0,0,2,2,0,0,4,4,0,0,6,6,17,17,0.0,M2020-03-04D,Race(3),,
3,3,0,3,6,1,1,2,4,0,0,2,2,4,1,7,12,9.5,9.5,0.0,M2020-03-04D,Race(3),,
4,0,3,0,3,3,3,7,13,2,4,2,8,5,10,9,24,9,9,0.0,M2020-03-04D,Race(3),,
1,0,0,3,3,2,1,1,4,1,2,0,3,3,3,4,10,17,17,0.0,M2020-03-04D,Race(4),,
2,0,0,3,3,0,3,0,3,0,1,0,1,0,4,3,7,16,16,0.0,M2020-03-04D,Race(4),,
4,0,5,0,5,0,0,0,0,0,0,0,0,0,5,0,5,26,26,0.0,M2020-03-04D,Race(4),,
5,0,3,2,5,0,2,1,3,0,3,1,4,0,8,4,12,21,21,3.0,M2020-03-04D,Race(4),,
6,17,2,9,28,16,4,6,26,12,4,5,21,45,10,20,75,3,3,0.0,M2020-03-04D,Race(4),,
7,3,0,0,3,2,2,4,8,2,5,4,11,7,7,8,22,14,14,0.0,M2020-03-04D,Race(4),,
8,2,13,10,25,1,2,13,16,1,2,7,10,4,17,30,51,4.2,4.2,1.0,M2020-03-04D,Race(4),,
9,4,7,3,14,8,14,3,25,7,6,5,18,19,27,11,57,5.5,5.5,2.0,M2020-03-04D,Race(4),,
10,0,0,0,0,0,0,0,0,0,0,0,0,0,0,0,0,34,34,0.0,M2020-03-04D,Race(4),,
11,2,0,0,2,0,0,0,0,1,0,0,1,3,0,0,3,15,15,0.0,M2020-03-04D,Race(4),,
12,0,0,0,0,0,0,0,0,0,1,0,1,0,1,0,1,41,41,0.0,M2020-03-04D,Race(4),,
3,2,0,0,2,0,1,1,2,0,1,3,4,2,2,4,8,8,8,0.0,M2020-03-04D,Race(4),,
6,0,6,5,11,4,5,14,23,5,5,5,15,9,16,24,49,5.5,5.5,0.0,M2020-03-04D,Race(5),,
7,0,0,0,0,0,0,0,0,0,0,0,0,0,0,0,0,151,151,0.0,M2020-03-04D,Race(5),,
9,0,4,0,4,0,0,0,0,0,0,3,3,0,4,3,7,7.5,7.5,2.0,M2020-03-04D,Race(5),,
11,0,0,0,0,0,0,0,0,0,0,0,0,0,0,0,0,10,10,0.0,M2020-03-04D,Race(5),,
10,0,0,0,0,0,0,0,0,1,0,0,1,1,0,0,1,34,34,0.0,M2020-03-04D,Race(5),,
5,0,3,5,8,0,0,0,0,0,0,0,0,0,3,5,8,11,11,0.0,M2020-03-04D,Race(5),,
12,0,0,0,0,0,0,0,0,0,0,0,0,0,0,0,0,91,91,0.0,M2020-03-04D,Race(5),,
3,0,0,3,3,0,0,0,0,0,1,0,1,0,1,3,4,41,41,0.0,M2020-03-04D,Race(5),,
8,8,0,5,13,1,2,2,5,1,6,3,10,10,8,10,28,5,5,0.0,M2020-03-04D,Race(5),,
2,20,8,2,30,19,8,3,30,13,7,4,24,52,23,9,84,2.6,2.6,3.0,M2020-03-04D,Race(5),,
4,0,0,0,0,0,0,0,0,0,0,1,1,0,0,1,1,151,151,0.0,M2020-03-04D,Race(5),,
1,2,9,10,21,4,13,7,24,5,5,9,19,11,27,26,64,9,9,1.0,M2020-03-04D,Race(5),,
10,0,0,0,0,0,0,0,0,0,0,1,1,0,0,1,1,71,71,0.0,M2020-03-04D,Race(6),,
12,0,2,0,2,0,0,0,0,0,0,0,0,0,2,0,2,31,31,0.0,M2020-03-04D,Race(6),,
1,7,5,3,15,8,14,4,26,10,6,6,22,25,25,13,63,4.6,4.6,0.0,M2020-03-04D,Race(6),,
3,5,2,11,18,1,6,3,10,2,6,5,13,8,14,19,41,5.5,5.5,1.0,M2020-03-04D,Race(6),,
2,2,3,7,12,3,0,2,5,0,3,2,5,5,6,11,22,7,7,0.0,M2020-03-04D,Race(6),,
5,0,6,5,11,15,5,5,25,7,5,2,14,22,16,12,50,6.5,6.5,2.0,M2020-03-04D,Race(6),,
6,2,3,0,5,0,2,2,4,1,2,1,4,3,7,3,13,26,26,0.0,M2020-03-04D,Race(6),,
7,11,5,4,20,2,1,14,17,6,1,8,15,19,7,26,52,3.8,3.8,3.0,M2020-03-04D,Race(6),,
8,3,2,0,5,1,2,0,3,0,2,1,3,4,6,1,11,12,12,0.0,M2020-03-04D,Race(6),,
9,0,0,0,0,0,0,0,0,0,1,0,1,0,1,0,1,51,51,0.0,M2020-03-04D,Race(6),,
4,0,0,0,0,0,0,0,0,0,0,0,0,0,0,0,0,17,17,0.0,M2020-03-04D,Race(6),,
11,0,2,0,2,0,0,0,0,0,0,0,0,0,2,0,2,14,14,0.0,M2020-03-04D,Race(6),,
5,0,0,0,0,0,0,0,0,0,1,0,1,0,1,0,1,17,17,3.0,M2020-03-04D,Race(7),,
3,2,0,6,8,0,2,1,3,3,2,3,8,5,4,10,19,13,13,0.0,M2020-03-04D,Race(7),,
4,8,10,3,21,1,13,4,18,4,7,5,16,13,30,12,55,6,6,0.0,M2020-03-04D,Race(7),,
8,4,5,0,9,3,4,13,20,3,3,5,11,10,12,18,40,6,6,0.0,M2020-03-04D,Race(7),,
6,0,3,8,11,15,6,4,25,12,7,3,22,27,16,15,58,7,7,0.0,M2020-03-04D,Race(7),,
9,0,0,3,3,0,0,0,0,0,0,0,0,0,0,3,3,11,11,2.0,M2020-03-04D,Race(7),,
10,7,5,2,14,5,3,4,12,1,1,5,7,13,9,11,33,4.4,4.5,1.0,M2020-03-04D,Race(7),,
11,0,0,0,0,0,0,0,0,0,0,0,0,0,0,0,0,61,61,0.0,M2020-03-04D,Race(7),,
7,0,5,0,5,3,1,3,7,1,3,2,6,4,9,5,18,8.5,8.5,0.0,M2020-03-04D,Race(7),,
1,9,2,8,19,3,1,0,4,2,2,1,5,14,5,9,28,5.5,5.5,0.0,M2020-03-04D,Race(7),,
2,0,0,0,0,0,0,1,1,0,0,2,2,0,0,3,3,26,26,0.0,M2020-03-04D,Race(7),,
8,0,0,0,0,0,0,2,2,0,0,0,0,0,0,2,2,11,11,0.0,M2020-03-04D,Race(8),,
7,2,5,7,14,2,4,4,10,1,7,7,15,5,16,18,39,6,6,0.0,M2020-03-04D,Race(8),,
6,0,4,3,7,1,2,4,7,0,4,5,9,1,10,12,23,15,15,2.0,M2020-03-04D,Race(8),,
10,6,2,0,8,0,3,0,3,2,5,0,7,8,10,0,18,13,13,0.0,M2020-03-04D,Race(8),,
4,0,0,0,0,0,1,0,1,0,1,0,1,0,2,0,2,101,101,0.0,M2020-03-04D,Race(8),,
3,0,3,8,11,0,14,1,15,2,3,3,8,2,20,12,34,16,16,0.0,M2020-03-04D,Race(8),,
2,20,5,2,27,26,2,1,29,20,4,1,25,66,11,4,81,2.35,2.35,1.0,M2020-03-04D,Race(8),,
1,0,0,3,3,0,0,0,0,0,0,0,0,0,0,3,3,13,13,0.0,M2020-03-04D,Race(8),,
12,0,2,2,4,0,0,0,0,0,0,0,0,0,2,2,4,19,19,0.0,M2020-03-04D,Race(8),,
11,0,0,0,0,0,0,0,0,0,0,0,0,0,0,0,0,101,101,0.0,M2020-03-04D,Race(8),,
9,2,9,5,16,1,4,17,22,1,2,10,13,4,15,32,51,4.6,4.5,3.0,M2020-03-04D,Race(8),,
5,0,0,0,0,0,0,0,0,0,0,0,0,0,0,0,0,51,51,0.0,M2020-03-04D,Race(8),,
2,0,2,6,8,1,1,10,12,3,0,3,6,4,3,19,26,15,15,0.0,M2020-03-08D,Race(1),,
6,0,2,0,2,1,0,1,2,2,0,0,2,3,2,1,6,15,15,0.0,M2020-03-08D,Race(1),,
7,0,0,5,5,0,3,7,10,0,5,3,8,0,8,15,23,10,9.5,1.0,M2020-03-08D,Race(1),,
8,0,0,0,0,0,0,0,0,0,0,0,0,0,0,0,0,101,101,0.0,M2020-03-08D,Race(1),,
10,12,8,4,24,11,12,3,26,8,11,3,22,31,31,10,72,2.65,3,0.0,M2020-03-08D,Race(1),,
3,0,6,0,6,0,1,1,2,1,1,2,4,1,8,3,12,18,18,0.0,M2020-03-08D,Race(1),,
11,2,0,0,2,0,0,0,0,0,0,0,0,2,0,0,2,91,81,0.0,M2020-03-08D,Race(1),,
12,0,0,6,6,0,0,0,0,0,0,0,0,0,0,6,6,21,21,0.0,M2020-03-08D,Race(1),,
13,0,3,3,6,0,1,2,3,0,2,4,6,0,6,9,15,9,8.5,3.0,M2020-03-08D,Race(1),,
14,0,0,0,0,0,0,0,0,0,0,0,0,0,0,0,0,20,21,0.0,M2020-03-08D,Race(1),,
4,0,0,0,0,0,0,2,2,0,0,1,1,0,0,3,3,91,81,0.0,M2020-03-08D,Race(1),,
1,16,9,3,28,17,11,2,30,12,6,5,23,45,26,10,81,2.8,2.7,2.0,M2020-03-08D,Race(1),,
9,0,0,3,3,0,0,0,0,0,0,0,0,0,0,3,3,41,41,0.0,M2020-03-08D,Race(1),,
5,0,0,0,0,0,0,0,0,0,0,0,0,0,0,0,0,151,126,0.0,M2020-03-08D,Race(1),,
4,0,2,3,5,0,1,2,3,0,1,4,5,0,4,9,13,23,21,0.0,M2020-03-08D,Race(10),,
14,0,0,0,0,0,0,0,0,0,0,0,0,0,0,0,0,91,81,0.0,M2020-03-08D,Race(10),,
3,20,5,2,27,20,8,2,30,16,10,0,26,56,23,4,83,2.8,2.8,3.0,M2020-03-08D,Race(10),,
1,0,2,0,2,0,0,1,1,0,0,0,0,0,2,1,3,23,21,0.0,M2020-03-08D,Race(10),,
11,2,0,4,6,0,1,2,3,0,0,1,1,2,1,7,10,16,21,0.0,M2020-03-08D,Race(10),,
12,0,9,6,15,7,14,4,25,5,7,7,19,12,30,17,59,4.2,4.6,0.0,M2020-03-08D,Race(10),,
13,0,0,0,0,0,0,0,0,0,0,0,0,0,0,0,0,51,51,2.0,M2020-03-08D,Race(10),,
10,3,0,9,12,0,1,1,2,0,3,4,7,3,4,14,21,8,8,1.0,M2020-03-08D,Race(10),,
9,0,0,0,0,0,0,0,0,0,0,0,0,0,0,0,0,17,26,0.0,M2020-03-08D,Race(10),,
2,5,12,6,23,3,5,17,25,5,4,10,19,13,21,33,67,4,4,0.0,M2020-03-08D,Race(10),,
6,0,0,0,0,0,0,0,0,0,0,0,0,0,0,0,0,101,101,0.0,M2020-03-08D,Race(10),,
8,0,0,0,0,0,0,0,0,0,0,0,0,0,0,0,0,34,26,0.0,M2020-03-08D,Race(10),,
5,0,0,0,0,0,0,1,1,0,1,0,1,0,1,1,2,31,31,0.0,M2020-03-08D,Race(10),,
7,0,0,0,0,0,0,0,0,0,0,0,0,0,0,0,0,31,31,0.0,M2020-03-08D,Race(10),,
5,2,5,3,10,0,1,8,9,1,1,8,10,3,7,19,29,7.5,7.5,3.0,M2020-03-08D,Race(11),,
6,3,15,7,25,10,8,3,21,5,4,3,12,18,27,13,58,4.4,4.4,2.0,M2020-03-08D,Race(11),,
8,3,0,0,3,0,0,1,1,0,1,0,1,3,1,1,5,10,10,0.0,M2020-03-08D,Race(11),,
7,0,0,0,0,0,0,0,0,0,0,0,0,0,0,0,0,71,51,0.0,M2020-03-08D,Race(11),,
3,0,0,0,0,1,1,1,3,1,1,0,2,2,2,1,5,21,21,0.0,M2020-03-08D,Race(11),,
11,0,0,0,0,0,0,0,0,0,0,1,1,0,0,1,1,31,34,0.0,M2020-03-08D,Race(11),,
12,0,4,10,14,3,6,11,20,3,5,3,11,6,15,24,45,4.2,4.2,0.0,M2020-03-08D,Race(11),,
10,0,0,0,0,0,0,0,0,0,1,0,1,0,1,0,1,126,101,0.0,M2020-03-08D,Race(11),,
2,0,3,7,10,1,0,6,7,3,0,4,7,4,3,17,24,31,31,0.0,M2020-03-08D,Race(11),,
1,22,3,3,28,15,14,0,29,13,9,1,23,50,26,4,80,2.6,2.6,1.0,M2020-03-08D,Race(11),,
4,0,0,0,0,0,0,0,0,0,0,0,0,0,0,0,0,41,41,0.0,M2020-03-08D,Race(11),,
9,0,0,0,0,0,0,0,0,0,0,0,0,0,0,0,0,34,34,0.0,M2020-03-08D,Race(11),,
9,0,5,0,5,0,0,0,0,0,0,2,2,0,5,2,7,10,10,0.0,M2020-03-08D,Race(2),,
1,0,4,4,8,2,1,2,5,4,0,1,5,6,5,7,18,10,10,0.0,M2020-03-08D,Race(2),,
10,7,9,4,20,7,7,12,26,2,8,10,20,16,24,26,66,4.8,4.8,2.0,M2020-03-08D,Race(2),,
11,0,0,0,0,2,0,1,3,3,1,1,5,5,1,2,8,31,31,0.0,M2020-03-08D,Race(2),,
12,0,0,6,6,0,0,0,0,0,1,0,1,0,1,6,7,26,26,0.0,M2020-03-08D,Race(2),,
2,5,4,9,18,14,9,3,26,10,7,3,20,29,20,15,64,6,6,3.0,M2020-03-08D,Race(2),,
3,8,0,7,15,1,1,2,4,1,1,2,4,10,2,11,23,5.5,5.5,1.0,M2020-03-08D,Race(2),,
6,2,0,0,2,0,1,1,2,1,2,2,5,3,3,3,9,10,10,0.0,M2020-03-08D,Race(2),,
7,8,6,0,14,4,11,5,20,5,6,2,13,17,23,7,47,4.6,4.6,0.0,M2020-03-08D,Race(2),,
8,0,0,0,0,0,0,0,0,0,0,0,0,0,0,0,0,51,51,0.0,M2020-03-08D,Race(2),,
4,0,0,0,0,0,0,2,2,0,0,2,2,0,0,4,4,21,21,0.0,M2020-03-08D,Race(2),,
5,0,2,0,2,0,0,2,2,0,0,1,1,0,2,3,5,16,16,0.0,M2020-03-08D,Race(2),,
1,12,3,8,23,14,5,9,28,11,6,4,21,37,14,21,72,3.3,3.3,3.0,M2020-03-08D,Race(3),,
14,0,0,0,0,0,0,0,0,0,0,0,0,0,0,0,0,81,81,0.0,M2020-03-08D,Race(3),,
13,3,5,0,8,2,0,0,2,3,2,1,6,8,7,1,16,12,12,0.0,M2020-03-08D,Race(3),,
11,6,6,5,17,1,9,7,17,3,1,4,8,10,16,16,42,4.6,4.6,2.0,M2020-03-08D,Race(3),,
9,0,0,0,0,0,0,0,0,0,1,1,2,0,1,1,2,19,19,0.0,M2020-03-08D,Race(3),,
8,0,0,0,0,0,0,0,0,0,0,0,0,0,0,0,0,41,41,0.0,M2020-03-08D,Race(3),,
7,0,0,0,0,0,0,0,0,0,0,0,0,0,0,0,0,151,151,0.0,M2020-03-08D,Race(3),,
6,0,0,2,2,0,0,0,0,0,0,0,0,0,0,2,2,26,26,0.0,M2020-03-08D,Race(3),,
5,2,7,10,19,12,6,6,24,5,8,6,19,19,21,22,62,7,7,0.0,M2020-03-08D,Race(3),,
4,0,0,0,0,0,0,0,0,0,1,0,1,0,1,0,1,23,23,0.0,M2020-03-08D,Race(3),,
3,5,9,5,19,1,7,8,16,4,5,8,17,10,21,21,52,4.6,4.6,0.0,M2020-03-08D,Race(3),,
2,2,0,0,2,0,3,0,3,0,2,0,2,2,5,0,7,19,19,0.0,M2020-03-08D,Race(3),,
10,0,0,0,0,0,0,0,0,0,0,2,2,0,0,2,2,34,34,1.0,M2020-03-08D,Race(3),,
12,0,0,0,0,0,0,0,0,0,0,0,0,0,0,0,0,18,18,0.0,M2020-03-08D,Race(3),,
7,0,0,0,0,0,0,1,1,0,0,0,0,0,0,1,1,26,18,0.0,M2020-03-08D,Race(4),,
6,0,0,0,0,0,0,0,0,0,0,0,0,0,0,0,0,19,17,0.0,M2020-03-08D,Race(4),,
5,12,11,2,25,11,10,6,27,4,5,10,19,27,26,18,71,2.35,2.45,0.0,M2020-03-08D,Race(4),,
4,0,14,11,25,1,18,6,25,2,17,3,22,3,49,20,72,4,3.8,2.0,M2020-03-08D,Race(4),,
2,0,5,0,5,0,0,2,2,2,1,4,7,2,6,6,14,20,19,3.0,M2020-03-08D,Race(4),,
1,18,0,12,30,18,2,10,30,18,2,5,25,54,4,27,85,2.75,2.6,1.0,M2020-03-08D,Race(4),,
3,0,0,5,5,0,0,5,5,0,1,4,5,0,1,14,15,18,16,0.0,M2020-03-08D,Race(4),,
12,0,0,0,0,0,0,0,0,0,0,0,0,0,0,0,0,19,19,0.0,M2020-03-08D,Race(5),,
9,3,0,3,6,0,0,1,1,1,0,1,2,4,0,5,9,10,10,0.0,M2020-03-08D,Race(5),,
8,0,0,0,0,0,0,0,0,0,0,1,1,0,0,1,1,126,126,0.0,M2020-03-08D,Race(5),,
7,0,0,0,0,1,0,1,2,1,0,2,3,2,0,3,5,18,18,0.0,M2020-03-08D,Race(5),,
6,0,2,0,2,1,0,0,1,0,1,1,2,1,3,1,5,31,31,1.0,M2020-03-08D,Race(5),,
4,8,5,3,16,3,6,14,23,6,7,7,20,17,18,24,59,8,8,0.0,M2020-03-08D,Race(5),,
5,3,12,8,23,13,13,0,26,14,4,1,19,30,29,9,68,2.7,2.7,2.0,M2020-03-08D,Race(5),,
1,0,0,0,0,0,0,0,0,0,0,0,0,0,0,0,0,101,101,0.0,M2020-03-08D,Race(5),,
3,5,3,0,8,2,0,3,5,0,1,5,6,7,4,8,19,12,12,0.0,M2020-03-08D,Race(5),,
10,11,8,5,24,10,7,7,24,4,10,3,17,25,25,15,65,3.4,3.4,0.0,M2020-03-08D,Race(5),,
11,0,0,9,9,0,4,3,7,0,3,4,7,0,7,16,23,9,9,0.0,M2020-03-08D,Race(5),,
2,0,0,2,2,0,0,0,0,0,0,0,0,0,0,2,2,23,23,3.0,M2020-03-08D,Race(5),,
5,0,0,0,0,0,0,0,0,1,0,0,1,1,0,0,1,61,61,0.0,M2020-03-08D,Race(6),,
14,0,0,0,0,0,0,0,0,0,0,0,0,0,0,0,0,41,41,0.0,M2020-03-08D,Race(6),,
13,0,0,0,0,0,0,0,0,0,0,0,0,0,0,0,0,61,61,0.0,M2020-03-08D,Race(6),,
12,0,5,2,7,0,0,2,2,0,3,1,4,0,8,5,13,10,10,2.0,M2020-03-08D,Race(6),,
11,0,0,0,0,0,0,0,0,0,0,0,0,0,0,0,0,151,251,0.0,M2020-03-08D,Race(6),,
10,5,2,4,11,0,2,1,3,0,4,3,7,5,8,8,21,10,10,0.0,M2020-03-08D,Race(6),,
2,0,0,0,0,0,0,0,0,0,0,0,0,0,0,0,0,41,41,0.0,M2020-03-08D,Race(6),,
8,4,6,2,12,0,2,5,7,0,3,5,8,4,11,12,27,9.5,9.5,0.0,M2020-03-08D,Race(6),,
6,0,0,0,0,0,0,0,0,0,1,0,1,0,1,0,1,151,151,0.0,M2020-03-08D,Race(6),,
4,0,8,6,14,1,1,3,5,1,1,3,5,2,10,12,24,9,9,0.0,M2020-03-08D,Race(6),,
1,0,4,3,7,1,4,11,16,2,4,2,8,3,12,16,31,9.5,9.5,3.0,M2020-03-08D,Race(6),,
9,0,0,0,0,0,1,2,3,1,1,1,3,1,2,3,6,14,16,0.0,M2020-03-08D,Race(6),,
3,21,2,7,30,27,2,1,30,21,1,2,24,69,5,10,84,1.95,1.95,1.0,M2020-03-08D,Race(6),,
7,0,3,6,9,0,1,1,2,0,3,3,6,0,7,10,17,11,11,0.0,M2020-03-08D,Race(6),,
4,0,11,15,26,1,8,8,17,1,5,9,15,2,24,32,58,5,5,0.0,M2020-03-08D,Race(7),,
7,0,0,2,2,0,0,1,1,0,0,3,3,0,0,6,6,12,12,0.0,M2020-03-08D,Race(7),,
2,0,15,9,24,10,7,9,26,4,6,7,17,14,28,25,67,6,6,0.0,M2020-03-08D,Race(7),,
6,28,0,2,30,18,12,0,30,17,7,2,26,63,19,4,86,1.8,1.8,1.0,M2020-03-08D,Race(7),,
1,0,0,2,2,0,0,1,1,0,2,0,2,0,2,3,5,31,31,0.0,M2020-03-08D,Race(7),,
5,0,2,0,2,0,0,0,0,0,0,0,0,0,2,0,2,41,41,0.0,M2020-03-08D,Race(7),,
11,0,2,0,2,0,0,2,2,1,0,2,3,1,2,4,7,31,31,0.0,M2020-03-08D,Race(7),,
8,0,0,0,0,0,0,0,0,0,0,0,0,0,0,0,0,31,31,0.0,M2020-03-08D,Race(7),,
10,0,0,0,0,0,1,0,1,0,3,0,3,0,4,0,4,23,23,3.0,M2020-03-08D,Race(7),,
3,0,0,0,0,0,0,0,0,1,0,0,1,1,0,0,1,61,61,0.0,M2020-03-08D,Race(7),,
9,2,0,0,2,0,2,0,2,0,3,0,3,2,5,0,7,18,18,2.0,M2020-03-08D,Race(7),,
12,0,0,0,0,1,0,9,10,2,0,3,5,3,0,12,15,31,31,0.0,M2020-03-08D,Race(7),,
1,0,0,0,0,0,0,0,0,1,1,0,2,1,1,0,2,81,81,0.0,M2020-03-08D,Race(8),,
4,7,2,0,9,0,0,2,2,1,0,2,3,8,2,4,14,7.5,7.5,0.0,M2020-03-08D,Race(8),,
13,0,0,0,0,0,0,0,0,0,0,0,0,0,0,0,0,26,26,0.0,M2020-03-08D,Race(8),,
12,0,0,0,0,0,0,0,0,0,0,0,0,0,0,0,0,41,41,0.0,M2020-03-08D,Race(8),,
11,0,0,0,0,0,0,0,0,0,0,0,0,0,0,0,0,81,81,0.0,M2020-03-08D,Race(8),,
14,0,5,5,10,5,1,4,10,7,0,3,10,12,6,12,30,5,5,3.0,M2020-03-08D,Race(8),,
9,0,0,0,0,0,0,0,0,0,0,1,1,0,0,1,1,151,151,0.0,M2020-03-08D,Race(8),,
2,0,0,0,0,0,0,0,0,0,0,0,0,0,0,0,0,31,31,0.0,M2020-03-08D,Race(8),,
3,0,3,3,6,2,0,3,5,3,2,3,8,5,5,9,19,5,5,0.0,M2020-03-08D,Race(8),,
5,14,7,2,23,6,18,2,26,5,6,5,16,25,31,9,65,5.5,5.5,1.0,M2020-03-08D,Race(8),,
6,5,11,4,20,14,7,5,26,7,9,5,21,26,27,14,67,4.8,4.8,0.0,M2020-03-08D,Race(8),,
7,2,0,16,18,3,2,11,16,2,4,1,7,7,6,28,41,6,6,0.0,M2020-03-08D,Race(8),,
8,2,2,0,4,0,2,2,4,0,4,6,10,2,8,8,18,18,18,2.0,M2020-03-08D,Race(8),,
10,0,0,0,0,0,0,1,1,0,0,0,0,0,0,1,1,151,151,0.0,M2020-03-08D,Race(8),,
4,0,0,0,0,0,0,1,1,1,1,0,2,1,1,1,3,34,34,0.0,M2020-03-08D,Race(9),,
1,17,9,0,26,4,14,3,21,7,5,1,13,28,28,4,60,2.7,2.7,0.0,M2020-03-08D,Race(9),,
2,0,0,0,0,0,0,0,0,0,0,0,0,0,0,0,0,101,101,0.0,M2020-03-08D,Race(9),,
10,0,0,0,0,0,0,1,1,0,0,1,1,0,0,2,2,91,81,0.0,M2020-03-08D,Race(9),,
11,2,9,3,14,2,4,3,9,3,5,4,12,7,18,10,35,5,4.8,0.0,M2020-03-08D,Race(9),,
9,0,0,7,7,2,2,1,5,2,4,4,10,4,6,12,22,15,15,3.0,M2020-03-08D,Race(9),,
8,0,3,7,10,1,4,1,6,1,5,2,8,2,12,10,24,9.5,10,0.0,M2020-03-08D,Race(9),,
7,3,0,2,5,1,0,1,2,2,1,1,4,6,1,4,11,8.5,8.5,1.0,M2020-03-08D,Race(9),,
3,6,2,8,16,16,2,7,25,7,4,7,18,29,8,22,59,4.8,4.8,0.0,M2020-03-08D,Race(9),,
5,2,3,3,8,4,4,10,18,3,1,2,6,9,8,15,32,17,17,0.0,M2020-03-08D,Race(9),,
12,0,4,0,4,0,0,2,2,0,0,4,4,0,4,6,10,9.5,13,2.0,M2020-03-08D,Race(9),,
6,0,0,0,0,0,0,0,0,0,0,0,0,0,0,0,0,51,51,0.0,M2020-03-08D,Race(9),,
3,0,8,0,8,1,2,4,7,1,4,2,7,2,14,6,22,13,13,0.0,M2020-03-11D,Race(1),,
7,5,0,5,10,2,1,13,16,3,2,6,11,10,3,24,37,14,14,0.0,M2020-03-11D,Race(1),,
8,0,0,0,0,0,0,0,0,0,0,0,0,0,0,0,0,126,126,0.0,M2020-03-11D,Race(1),,
1,10,7,3,20,8,17,2,27,10,5,3,18,28,29,8,65,4.2,4.2,0.0,M2020-03-11D,Race(1),,
9,0,2,6,8,0,1,4,5,0,3,3,6,0,6,13,19,7.5,7.5,0.0,M2020-03-11D,Race(1),,
2,11,7,7,25,19,7,2,28,12,6,3,21,42,20,12,74,2.6,2.6,3.0,M2020-03-11D,Race(1),,
10,0,0,0,0,0,0,0,0,0,0,0,0,0,0,0,0,34,34,0.0,M2020-03-11D,Race(1),,
11,0,0,0,0,0,0,0,0,0,1,0,1,0,1,0,1,101,101,2.0,M2020-03-11D,Race(1),,
12,0,0,0,0,0,1,0,1,0,0,1,1,0,1,1,2,15,15,0.0,M2020-03-11D,Race(1),,
5,2,3,6,11,0,1,5,6,0,4,6,10,2,8,17,27,5.5,5.5,1.0,M2020-03-11D,Race(1),,
4,2,0,3,5,0,0,0,0,0,0,1,1,2,0,4,6,31,31,0.0,M2020-03-11D,Race(1),,
6,0,3,0,3,0,0,0,0,0,1,1,2,0,4,1,5,21,21,0.0,M2020-03-11D,Race(1),,
11,7,10,10,27,2,14,4,20,2,4,5,11,11,28,19,58,4.2,4.2,3.0,M2020-03-11D,Race(2),,
10,0,0,0,0,0,0,0,0,0,0,0,0,0,0,0,0,81,81,0.0,M2020-03-11D,Race(2),,
9,7,5,5,17,7,3,4,14,6,3,8,17,20,11,17,48,4.8,4.8,2.0,M2020-03-11D,Race(2),,
8,2,5,0,7,4,6,15,25,3,11,6,20,9,22,21,52,4.2,4.2,0.0,M2020-03-11D,Race(2),,
3,0,0,0,0,0,0,0,0,0,0,0,0,0,0,0,0,151,151,0.0,M2020-03-11D,Race(2),,
6,0,0,0,0,0,0,0,0,0,0,0,0,0,0,0,0,101,101,0.0,M2020-03-11D,Race(2),,
4,0,0,0,0,0,0,0,0,1,0,0,1,1,0,0,1,81,81,0.0,M2020-03-11D,Race(2),,
12,0,4,6,10,0,2,2,4,0,1,4,5,0,7,12,19,7,7,0.0,M2020-03-11D,Race(2),,
2,0,0,0,0,1,1,0,2,4,2,1,7,5,3,1,9,13,13,0.0,M2020-03-11D,Race(2),,
1,8,6,5,19,16,4,5,25,10,4,1,15,34,14,11,59,4.4,4.4,1.0,M2020-03-11D,Race(2),,
5,3,0,0,3,0,0,0,0,0,1,0,1,3,1,0,4,26,26,0.0,M2020-03-11D,Race(2),,
7,3,0,4,7,0,0,0,0,0,0,1,1,3,0,5,8,15,15,0.0,M2020-03-11D,Race(2),,
5,5,8,9,22,0,2,1,3,0,1,1,2,5,11,11,27,6,6,0.0,M2020-03-11D,Race(3),,
2,2,5,2,9,1,1,1,3,3,2,2,7,6,8,5,19,13,13,2.0,M2020-03-11D,Race(3),,
4,2,2,2,6,3,12,6,21,7,7,5,19,12,21,13,46,12,12,0.0,M2020-03-11D,Race(3),,
6,2,0,2,4,2,1,0,3,3,1,0,4,7,2,2,11,8,8,0.0,M2020-03-11D,Race(3),,
9,0,0,0,0,1,0,0,1,0,0,1,1,1,0,1,2,51,51,0.0,M2020-03-11D,Race(3),,
8,,,,,,,,,,,,,,,,,,,0.0,M2020-03-11D,Race(3),,
10,0,0,0,0,0,0,1,1,0,0,0,0,0,0,1,1,41,41,0.0,M2020-03-11D,Race(3),,
11,0,0,0,0,0,0,0,0,0,0,0,0,0,0,0,0,151,151,0.0,M2020-03-11D,Race(3),,
7,0,3,2,5,0,0,3,3,0,1,4,5,0,4,9,13,10,10,0.0,M2020-03-11D,Race(3),,
12,0,0,3,3,0,2,0,2,0,0,0,0,0,2,3,5,12,12,3.0,M2020-03-11D,Race(3),,
3,6,2,8,16,2,4,16,22,1,3,9,13,9,9,33,51,6.5,6.5,1.0,M2020-03-11D,Race(3),,
1,13,10,2,25,20,7,1,28,12,9,1,22,45,26,4,75,2.45,2.45,0.0,M2020-03-11D,Race(3),,
4,8,13,5,26,18,7,2,27,12,10,1,23,38,30,8,76,8,8,0.0,M2020-03-11D,Race(4),,
5,0,6,2,8,0,0,3,3,0,1,3,4,0,7,8,15,11,11,0.0,M2020-03-11D,Race(4),,
12,0,0,0,0,0,1,0,1,0,0,0,0,0,1,0,1,21,21,0.0,M2020-03-11D,Race(4),,
1,2,5,2,9,1,2,6,9,1,2,6,9,4,9,14,27,7,7,1.0,M2020-03-11D,Race(4),,
9,8,3,12,23,3,1,2,6,5,2,1,8,16,6,15,37,5,5,2.0,M2020-03-11D,Race(4),,
11,0,0,0,0,0,0,1,1,0,0,0,0,0,0,1,1,41,41,0.0,M2020-03-11D,Race(4),,
7,5,0,0,5,2,1,4,7,4,1,5,10,11,2,9,22,7.5,7.5,0.0,M2020-03-11D,Race(4),,
6,2,0,3,5,1,0,1,2,0,0,1,1,3,0,5,8,81,81,0.0,M2020-03-11D,Race(4),,
8,0,0,0,0,0,0,0,0,0,0,0,0,0,0,0,0,126,126,0.0,M2020-03-11D,Race(4),,
2,2,3,0,5,0,2,7,9,2,1,4,7,4,6,11,21,21,21,3.0,M2020-03-11D,Race(4),,
3,3,0,6,9,4,15,4,23,2,9,4,15,9,24,14,47,2.5,2.5,0.0,M2020-03-11D,Race(4),,
10,0,0,0,0,1,1,0,2,0,0,1,1,1,1,1,3,21,21,0.0,M2020-03-11D,Race(4),,
11,0,4,5,9,1,1,12,14,2,3,6,11,3,8,23,34,7.5,7.5,0.0,M2020-03-11D,Race(5),,
10,2,0,0,2,0,0,3,3,1,0,5,6,3,0,8,11,17,17,0.0,M2020-03-11D,Race(5),,
9,8,7,10,25,8,14,3,25,7,7,5,19,23,28,18,69,5.5,5.5,2.0,M2020-03-11D,Race(5),,
8,0,0,3,3,1,1,4,6,1,0,4,5,2,1,11,14,15,15,0.0,M2020-03-11D,Race(5),,
7,0,0,0,0,0,0,0,0,0,0,0,0,0,0,0,0,34,34,0.0,M2020-03-11D,Race(5),,
6,2,3,3,8,0,2,0,2,0,2,0,2,2,7,3,12,14,14,0.0,M2020-03-11D,Race(5),,
5,6,0,0,6,0,0,3,3,0,0,2,2,6,0,5,11,10,10,3.0,M2020-03-11D,Race(5),,
4,3,5,2,10,1,1,1,3,0,1,0,1,4,7,3,14,7,7,0.0,M2020-03-11D,Race(5),,
3,0,0,0,0,0,0,0,0,1,0,0,1,1,0,0,1,151,151,0.0,M2020-03-11D,Race(5),,
12,0,0,0,0,0,0,0,0,0,1,1,2,0,1,1,2,16,16,0.0,M2020-03-11D,Race(5),,
2,0,2,3,5,0,1,3,4,0,2,3,5,0,5,9,14,61,61,0.0,M2020-03-11D,Race(5),,
1,9,9,4,22,19,10,1,30,14,10,0,24,42,29,5,76,2.45,2.45,1.0,M2020-03-11D,Race(5),,
1,0,8,4,12,0,13,9,22,5,4,5,14,5,25,18,48,8.5,8.5,0.0,M2020-03-11D,Race(6),,
11,0,0,0,0,0,0,0,0,0,0,0,0,0,0,0,0,31,31,0.0,M2020-03-11D,Race(6),,
10,0,0,0,0,0,0,0,0,0,0,0,0,0,0,0,0,41,41,0.0,M2020-03-11D,Race(6),,
9,18,3,4,25,25,4,1,30,16,5,2,23,59,12,7,78,3.3,3.3,2.0,M2020-03-11D,Race(6),,
8,0,0,3,3,0,2,0,2,0,2,1,3,0,4,4,8,26,26,0.0,M2020-03-11D,Race(6),,
7,0,0,0,0,0,0,0,0,0,1,1,2,0,1,1,2,61,61,0.0,M2020-03-11D,Race(6),,
6,2,3,6,11,0,0,0,0,0,0,1,1,2,3,7,12,13,13,0.0,M2020-03-11D,Race(6),,
5,2,0,5,7,0,2,3,5,2,5,5,12,4,7,13,24,10,10,0.0,M2020-03-11D,Race(6),,
4,3,10,5,18,2,3,4,9,2,3,1,6,7,16,10,33,2.7,2.7,1.0,M2020-03-11D,Race(6),,
2,3,6,3,12,2,5,12,19,0,3,7,10,5,14,22,41,7.5,7.5,3.0,M2020-03-11D,Race(6),,
12,2,0,0,2,1,0,1,2,1,0,2,3,4,0,3,7,21,21,0.0,M2020-03-11D,Race(6),,
3,0,0,0,0,0,1,0,1,0,3,1,4,0,4,1,5,61,61,0.0,M2020-03-11D,Race(6),,
4,5,3,10,18,1,13,6,20,5,2,9,16,11,18,25,54,5.5,5.5,0.0,M2020-03-11D,Race(7),,
5,0,0,0,0,0,0,1,1,0,1,1,2,0,1,2,3,23,23,0.0,M2020-03-11D,Race(7),,
6,0,2,3,5,0,0,1,1,0,1,1,2,0,3,5,8,14,14,3.0,M2020-03-11D,Race(7),,
7,0,2,0,2,0,1,2,3,0,0,6,6,0,3,8,11,14,14,0.0,M2020-03-11D,Race(7),,
9,6,6,6,18,10,5,12,27,10,6,4,20,26,17,22,65,5.5,5.5,2.0,M2020-03-11D,Race(7),,
10,0,0,0,0,0,0,0,0,0,0,0,0,0,0,0,0,61,61,0.0,M2020-03-11D,Race(7),,
11,6,0,2,8,0,1,0,1,0,1,0,1,6,2,2,10,19,19,0.0,M2020-03-11D,Race(7),,
2,0,0,3,3,1,1,0,2,1,0,0,1,2,1,3,6,16,16,0.0,M2020-03-11D,Race(7),,
3,8,0,0,8,1,2,4,7,0,7,1,8,9,9,5,23,8.5,8.5,0.0,M2020-03-11D,Race(7),,
8,0,0,0,0,0,0,0,0,0,0,0,0,0,0,0,0,23,23,0.0,M2020-03-11D,Race(7),,
1,5,17,6,28,17,7,4,28,10,8,4,22,32,32,14,78,2.3,2.3,1.0,M2020-03-11D,Race(7),,
4,0,8,0,8,0,5,4,9,2,4,1,7,2,17,5,24,6,6,2.0,M2020-03-11D,Race(8),,
2,0,0,3,3,0,1,0,1,0,1,0,1,0,2,3,5,13,13,0.0,M2020-03-11D,Race(8),,
3,0,4,3,7,0,0,4,4,2,0,4,6,2,4,11,17,12,12,0.0,M2020-03-11D,Race(8),,
1,15,0,3,18,7,13,5,25,11,8,0,19,33,21,8,62,7,7,0.0,M2020-03-11D,Race(8),,
12,0,0,2,2,0,0,0,0,0,0,2,2,0,0,4,4,21,21,0.0,M2020-03-11D,Race(8),,
11,2,3,7,12,0,2,14,16,0,1,8,9,2,6,29,37,6.5,6.5,1.0,M2020-03-11D,Race(8),,
10,0,2,0,2,0,0,1,1,0,0,3,3,0,2,4,6,14,14,0.0,M2020-03-11D,Race(8),,
9,0,0,4,4,1,0,2,3,1,0,4,5,2,0,10,12,13,13,0.0,M2020-03-11D,Race(8),,
7,0,3,5,8,0,0,0,0,0,0,0,0,0,3,5,8,26,26,3.0,M2020-03-11D,Race(8),,
6,11,10,3,24,22,6,0,28,10,8,2,20,43,24,5,72,3,3,0.0,M2020-03-11D,Race(8),,
8,2,0,0,2,0,0,0,0,0,1,1,2,2,1,1,4,26,26,0.0,M2020-03-11D,Race(8),,
5,0,0,0,0,0,3,0,3,0,3,1,4,0,6,1,7,20,20,0.0,M2020-03-11D,Race(8),,
5,5,8,6,19,1,4,13,18,1,7,3,11,7,19,22,48,4.8,5,0.0,M2020-03-14D,Race(1),,
1,3,6,2,11,1,4,1,6,0,6,1,7,4,16,4,24,12,12,0.0,M2020-03-14D,Race(1),,
2,5,2,0,7,0,13,6,19,0,2,8,10,5,17,14,36,6.5,6.5,0.0,M2020-03-14D,Race(1),,
3,10,2,13,25,8,2,4,14,9,3,6,18,27,7,23,57,3.6,3.7,2.0,M2020-03-14D,Race(1),,
6,0,0,0,0,0,0,0,0,1,0,0,1,1,0,0,1,61,61,0.0,M2020-03-14D,Race(1),,
7,0,3,0,3,0,0,1,1,0,0,0,0,0,3,1,4,20,21,1.0,M2020-03-14D,Race(1),,
9,0,0,0,0,1,0,1,2,0,0,1,1,1,0,2,3,31,31,3.0,M2020-03-14D,Race(1),,
8,7,9,7,23,17,6,2,25,14,6,2,22,38,21,11,70,3.2,3.4,0.0,M2020-03-14D,Race(1),,
12,0,0,0,0,0,0,0,0,0,0,0,0,0,0,0,0,41,41,0.0,M2020-03-14D,Race(1),,
11,0,0,0,0,0,0,1,1,0,0,3,3,0,0,4,4,21,19,0.0,M2020-03-14D,Race(1),,
10,0,0,0,0,0,0,0,0,0,0,2,2,0,0,2,2,26,26,0.0,M2020-03-14D,Race(1),,
4,0,0,2,2,2,1,1,4,1,2,0,3,3,3,3,9,13,16,0.0,M2020-03-14D,Race(1),,
2,0,3,0,3,0,3,2,5,0,5,3,8,0,11,5,16,13,13,0.0,M2020-03-14D,Race(10),,
8,0,3,4,7,1,1,5,7,0,1,6,7,1,5,15,21,9.5,9.5,0.0,M2020-03-14D,Race(10),,
6,0,0,0,0,0,0,0,0,0,0,0,0,0,0,0,0,81,81,0.0,M2020-03-14D,Race(10),,
5,0,0,0,0,0,0,0,0,0,1,0,1,0,1,0,1,101,101,0.0,M2020-03-14D,Race(10),,
4,0,6,11,17,2,17,7,26,1,8,6,15,3,31,24,58,6,6,2.0,M2020-03-14D,Race(10),,
7,2,0,0,2,0,0,0,0,0,1,3,4,2,1,3,6,26,26,0.0,M2020-03-14D,Race(10),,
10,0,0,2,2,0,0,0,0,0,0,0,0,0,0,2,2,34,34,0.0,M2020-03-14D,Race(10),,
11,0,7,0,7,0,1,1,2,0,0,0,0,0,8,1,9,17,17,3.0,M2020-03-14D,Race(10),,
12,0,0,3,3,0,0,0,0,0,0,0,0,0,0,3,3,41,41,0.0,M2020-03-14D,Race(10),,
9,0,0,0,0,0,0,0,0,0,0,0,0,0,0,0,0,101,101,0.0,M2020-03-14D,Race(10),,
1,0,0,2,2,0,0,1,1,0,0,1,1,0,0,4,4,31,31,0.0,M2020-03-14D,Race(10),,
3,26,2,2,30,25,3,1,29,24,2,0,26,75,7,3,85,1.8,1.8,1.0,M2020-03-14D,Race(10),,
14,0,0,0,0,0,0,0,0,0,0,0,0,0,0,0,0,151,201,0.0,M2020-03-14D,Race(10),,
13,2,9,6,17,2,5,13,20,1,8,7,16,5,22,26,53,6.5,6.5,0.0,M2020-03-14D,Race(10),,
11,0,4,0,4,0,0,3,3,0,0,2,2,0,4,5,9,26,26,0.0,M2020-03-14D,Race(2),,
10,3,6,10,19,0,0,1,1,0,3,2,5,3,9,13,25,7,7,0.0,M2020-03-14D,Race(2),,
9,0,0,0,0,0,0,0,0,0,1,0,1,0,1,0,1,126,126,0.0,M2020-03-14D,Race(2),,
8,2,0,2,4,1,10,14,25,2,7,6,15,5,17,22,44,9.5,9.5,2.0,M2020-03-14D,Race(2),,
7,4,5,14,23,0,17,7,24,1,6,12,19,5,28,33,66,3.6,3.6,3.0,M2020-03-14D,Race(2),,
6,0,3,0,3,0,0,0,0,0,0,0,0,0,3,0,3,101,101,0.0,M2020-03-14D,Race(2),,
1,0,3,0,3,1,0,1,2,2,1,1,4,3,4,2,9,15,15,0.0,M2020-03-14D,Race(2),,
5,21,7,2,30,27,3,0,30,20,5,0,25,68,15,2,85,1.95,1.95,1.0,M2020-03-14D,Race(2),,
4,0,0,0,0,0,0,0,0,0,0,0,0,0,0,0,0,61,61,0.0,M2020-03-14D,Race(2),,
3,0,2,0,2,0,0,1,1,0,1,2,3,0,3,3,6,26,26,0.0,M2020-03-14D,Race(2),,
2,0,0,2,2,1,0,2,3,1,2,1,4,2,2,5,9,26,26,0.0,M2020-03-14D,Race(2),,
12,0,0,0,0,0,0,1,1,0,0,0,0,0,0,1,1,41,41,0.0,M2020-03-14D,Race(2),,
12,0,0,0,0,0,0,0,0,0,0,0,0,0,0,0,0,151,151,0.0,M2020-03-14D,Race(3),,
13,4,0,3,7,0,0,2,2,0,3,2,5,4,3,7,14,5,5,2.0,M2020-03-14D,Race(3),,
4,0,0,0,0,0,0,0,0,1,0,0,1,1,0,0,1,81,81,0.0,M2020-03-14D,Race(3),,
1,12,6,0,18,9,11,8,28,8,6,6,20,29,23,14,66,4,4,0.0,M2020-03-14D,Race(3),,
2,0,0,0,0,0,0,1,1,0,1,1,2,0,1,2,3,31,31,0.0,M2020-03-14D,Race(3),,
3,0,8,3,11,1,2,0,3,2,2,2,6,3,12,5,20,6,6,0.0,M2020-03-14D,Race(3),,
11,5,3,7,15,3,5,13,21,3,4,9,16,11,12,29,52,7,7,1.0,M2020-03-14D,Race(3),,
10,0,4,2,6,1,0,2,3,0,0,1,1,1,4,5,10,13,13,0.0,M2020-03-14D,Race(3),,
9,0,0,0,0,0,0,0,0,0,0,0,0,0,0,0,0,71,67,0.0,M2020-03-14D,Race(3),,
7,0,0,0,0,0,1,0,1,0,0,0,0,0,1,0,1,81,81,0.0,M2020-03-14D,Race(3),,
6,6,6,13,25,16,11,2,29,10,9,1,20,32,26,16,74,4,4,3.0,M2020-03-14D,Race(3),,
8,3,0,0,3,0,0,1,1,1,0,1,2,4,0,2,6,19,19,0.0,M2020-03-14D,Race(3),,
14,0,0,0,0,0,0,0,0,0,0,0,0,0,0,0,0,151,151,0.0,M2020-03-14D,Race(3),,
5,0,3,2,5,0,0,1,1,1,1,3,5,1,4,6,11,18,18,0.0,M2020-03-14D,Race(3),,
8,0,5,2,7,0,5,2,7,0,7,1,8,0,17,5,22,19,19,2.0,M2020-03-14D,Race(4),,
9,0,0,0,0,0,0,1,1,0,0,4,4,0,0,5,5,41,41,0.0,M2020-03-14D,Race(4),,
10,2,0,3,5,0,0,0,0,0,0,0,0,2,0,3,5,51,51,0.0,M2020-03-14D,Race(4),,
11,0,0,0,0,0,0,0,0,0,0,0,0,0,0,0,0,151,251,0.0,M2020-03-14D,Race(4),,
12,0,3,12,15,1,3,16,20,3,5,7,15,4,11,35,50,11,13,0.0,M2020-03-14D,Race(4),,
13,0,0,2,2,0,1,1,2,1,0,2,3,1,1,5,7,26,26,0.0,M2020-03-14D,Race(4),,
14,0,0,0,0,0,0,0,0,0,0,0,0,0,0,0,0,101,101,0.0,M2020-03-14D,Race(4),,
7,0,0,3,3,0,0,0,0,0,0,0,0,0,0,3,3,31,31,0.0,M2020-03-14D,Race(4),,
5,0,0,0,0,1,0,3,4,0,2,3,5,1,2,6,9,21,21,0.0,M2020-03-14D,Race(4),,
2,0,0,0,0,0,0,0,0,0,0,0,0,0,0,0,0,126,126,0.0,M2020-03-14D,Race(4),,
4,26,4,0,30,28,2,0,30,20,3,1,24,74,9,1,84,1.5,1.5,1.0,M2020-03-14D,Race(4),,
1,0,0,0,0,0,0,0,0,0,0,0,0,0,0,0,0,51,51,0.0,M2020-03-14D,Race(4),,
6,2,18,5,25,0,19,6,25,1,9,6,16,3,46,17,66,6,6,3.0,M2020-03-14D,Race(4),,
3,0,0,3,3,0,0,1,1,1,0,2,3,1,0,6,7,9,9,0.0,M2020-03-14D,Race(4),,
5,0,0,0,0,0,0,0,0,0,2,0,2,0,2,0,2,71,71,0.0,M2020-03-14D,Race(5),,
4,4,8,13,25,3,7,12,22,2,8,4,14,9,23,29,61,6,6,3.0,M2020-03-14D,Race(5),,
3,0,0,0,0,0,0,1,1,0,0,1,1,0,0,2,2,34,34,0.0,M2020-03-14D,Race(5),,
2,21,2,5,28,25,4,1,30,19,4,1,24,65,10,7,82,1.65,1.65,2.0,M2020-03-14D,Race(5),,
1,0,2,4,6,2,2,1,5,3,2,1,6,5,6,6,17,15,15,0.0,M2020-03-14D,Race(5),,
6,0,0,0,0,0,1,0,1,0,1,0,1,0,2,0,2,31,31,0.0,M2020-03-14D,Race(5),,
14,0,0,0,0,0,0,0,0,0,0,0,0,0,0,0,0,51,51,0.0,M2020-03-14D,Race(5),,
8,0,0,0,0,0,0,0,0,0,0,0,0,0,0,0,0,41,41,0.0,M2020-03-14D,Race(5),,
9,0,0,0,0,0,0,0,0,1,0,0,1,1,0,0,1,61,61,0.0,M2020-03-14D,Race(5),,
10,2,3,3,8,0,0,2,2,0,2,1,3,2,5,6,13,31,31,1.0,M2020-03-14D,Race(5),,
11,0,0,0,0,0,0,0,0,0,1,1,2,0,1,1,2,31,31,0.0,M2020-03-14D,Race(5),,
12,0,0,0,0,0,0,0,0,0,0,1,1,0,0,1,1,17,17,0.0,M2020-03-14D,Race(5),,
13,0,0,0,0,0,0,0,0,0,1,0,1,0,1,0,1,26,26,0.0,M2020-03-14D,Race(5),,
7,3,15,5,23,0,16,13,29,1,5,16,22,4,36,34,74,7,7,0.0,M2020-03-14D,Race(5),,
6,0,0,0,0,0,0,0,0,0,2,0,2,0,2,0,2,26,26,0.0,M2020-03-14D,Race(6),,
5,7,0,0,7,0,0,0,0,0,0,3,3,7,0,3,10,11,11,0.0,M2020-03-14D,Race(6),,
4,4,2,5,11,3,2,2,7,4,2,3,9,11,6,10,27,6,6,0.0,M2020-03-14D,Race(6),,
3,3,2,3,8,1,0,7,8,3,2,4,9,7,4,14,25,14,14,0.0,M2020-03-14D,Race(6),,
1,0,0,3,3,0,0,0,0,0,0,0,0,0,0,3,3,26,26,0.0,M2020-03-14D,Race(6),,
2,0,0,0,0,7,10,2,19,6,1,0,7,13,11,2,26,17,17,0.0,M2020-03-14D,Race(6),,
8,0,0,8,8,1,1,8,10,1,1,3,5,2,2,19,23,12,14,0.0,M2020-03-14D,Race(6),,
10,5,10,5,20,2,4,3,9,2,6,4,12,9,20,12,41,4.6,4.6,3.0,M2020-03-14D,Race(6),,
11,0,0,0,0,0,0,0,0,0,0,0,0,0,0,0,0,71,67,0.0,M2020-03-14D,Race(6),,
12,0,3,0,3,1,2,1,4,1,1,2,4,2,6,3,11,16,16,0.0,M2020-03-14D,Race(6),,
13,0,0,0,0,0,0,0,0,0,1,0,1,0,1,0,1,17,17,0.0,M2020-03-14D,Race(6),,
14,0,0,0,0,0,0,1,1,0,0,0,0,0,0,1,1,71,67,0.0,M2020-03-14D,Race(6),,
9,9,10,6,25,13,10,3,26,5,7,4,16,27,27,13,67,4,4,2.0,M2020-03-14D,Race(6),,
7,2,3,0,5,2,1,3,6,2,2,3,7,6,6,6,18,8,8,1.0,M2020-03-14D,Race(6),,
1,0,4,6,10,0,1,0,1,0,0,0,0,0,5,6,11,19,19,0.0,M2020-03-14D,Race(7),,
14,0,0,0,0,0,0,0,0,0,0,0,0,0,0,0,0,26,26,0.0,M2020-03-14D,Race(7),,
11,0,2,2,4,0,1,2,3,0,2,2,4,0,5,6,11,17,17,3.0,M2020-03-14D,Race(7),,
10,0,0,0,0,0,0,0,0,0,0,0,0,0,0,0,0,51,51,0.0,M2020-03-14D,Race(7),,
9,0,10,5,15,0,19,4,23,1,8,6,15,1,37,15,53,5.5,5.5,0.0,M2020-03-14D,Race(7),,
8,2,3,5,10,0,2,12,14,0,5,5,10,2,10,22,34,12,12,0.0,M2020-03-14D,Race(7),,
12,0,3,3,6,0,0,1,1,0,0,3,3,0,3,7,10,18,18,0.0,M2020-03-14D,Race(7),,
7,0,0,0,0,0,0,2,2,0,1,2,3,0,1,4,5,26,26,0.0,M2020-03-14D,Race(7),,
5,0,0,0,0,0,0,0,0,0,2,0,2,0,2,0,2,11,11,2.0,M2020-03-14D,Race(7),,
2,3,0,3,6,2,3,4,9,4,4,3,11,9,7,10,26,9.5,9.5,1.0,M2020-03-14D,Race(7),,
6,7,0,2,9,0,1,5,6,0,1,2,3,7,2,9,18,9.5,9.5,0.0,M2020-03-14D,Race(7),,
3,0,0,2,2,0,1,0,1,1,2,0,3,1,3,2,6,21,21,0.0,M2020-03-14D,Race(7),,
13,0,0,0,0,0,0,0,0,0,0,1,1,0,0,1,1,31,31,0.0,M2020-03-14D,Race(7),,
4,18,8,2,28,28,2,0,30,20,1,2,23,66,11,4,81,2.7,2.7,0.0,M2020-03-14D,Race(7),,
7,0,6,11,17,1,4,14,19,0,9,5,14,1,19,30,50,8,8,0.0,M2020-03-14D,Race(8),,
4,0,2,4,6,1,0,1,2,3,0,3,6,4,2,8,14,11,11,1.0,M2020-03-14D,Race(8),,
8,0,0,0,0,0,0,1,1,0,0,0,0,0,0,1,1,26,26,0.0,M2020-03-14D,Race(8),,
3,0,7,9,16,0,4,4,8,1,2,8,11,1,13,21,35,14,15,2.0,M2020-03-14D,Race(8),,
10,0,0,2,2,0,1,1,2,0,0,1,1,0,1,4,5,18,18,0.0,M2020-03-14D,Race(8),,
11,18,4,0,22,4,16,5,25,8,10,2,20,30,30,7,67,3,3.1,0.0,M2020-03-14D,Race(8),,
6,0,0,2,2,0,3,0,3,1,1,0,2,1,4,2,7,17,17,0.0,M2020-03-14D,Race(8),,
1,7,11,0,18,24,2,1,27,12,4,1,17,43,17,2,62,3.1,3,0.0,M2020-03-14D,Race(8),,
2,0,0,0,0,0,0,3,3,0,0,6,6,0,0,9,9,19,21,0.0,M2020-03-14D,Race(8),,
5,0,0,0,0,0,0,0,0,0,0,0,0,0,0,0,0,31,34,3.0,M2020-03-14D,Race(8),,
9,5,0,2,7,0,0,0,0,1,0,0,1,6,0,2,8,9,9,0.0,M2020-03-14D,Race(8),,
1,12,6,3,21,14,6,5,25,9,7,5,21,35,19,13,67,4.2,4.2,3.0,M2020-03-14D,Race(9),,
4,5,5,9,19,2,4,12,18,3,4,3,10,10,13,24,47,6,6,0.0,M2020-03-14D,Race(9),,
12,5,0,0,5,2,0,1,3,0,0,2,2,7,0,3,10,11,11,0.0,M2020-03-14D,Race(9),,
11,0,0,0,0,0,0,0,0,0,0,0,0,0,0,0,0,71,67,0.0,M2020-03-14D,Race(9),,
10,0,2,15,17,4,3,5,12,4,4,5,13,8,9,25,42,5.5,5.5,2.0,M2020-03-14D,Race(9),,
8,0,0,0,0,0,0,0,0,0,0,0,0,0,0,0,0,71,67,0.0,M2020-03-14D,Race(9),,
7,0,0,0,0,0,0,0,0,0,0,0,0,0,0,0,0,151,201,0.0,M2020-03-14D,Race(9),,
6,0,3,0,3,0,1,0,1,2,2,2,6,2,6,2,10,21,21,0.0,M2020-03-14D,Race(9),,
5,0,0,0,0,0,0,0,0,0,0,0,0,0,0,0,0,71,67,0.0,M2020-03-14D,Race(9),,
2,0,2,0,2,1,3,1,5,2,2,1,5,3,7,2,12,9,9,1.0,M2020-03-14D,Race(9),,
3,0,0,3,3,6,2,3,11,3,2,2,7,9,4,8,21,6.5,6.5,0.0,M2020-03-14D,Race(9),,
9,8,12,0,20,1,11,3,15,3,5,6,14,12,28,9,49,4.2,4.2,0.0,M2020-03-14D,Race(9),,
9,3,0,0,3,0,2,1,3,0,2,1,3,3,4,2,9,15,15,0.0,M2020-03-18D,Race(1),,
10,0,0,0,0,0,0,1,1,0,1,1,2,0,1,2,3,11,11,2.0,M2020-03-18D,Race(1),,
1,9,3,4,16,4,2,12,18,5,4,7,16,18,9,23,50,7,7,0.0,M2020-03-18D,Race(1),,
2,11,8,8,27,5,15,5,25,5,1,5,11,21,24,18,63,3.7,3.6,1.0,M2020-03-18D,Race(1),,
3,0,2,6,8,17,7,2,26,7,10,0,17,24,19,8,51,5.5,6,3.0,M2020-03-18D,Race(1),,
4,0,0,0,0,0,0,0,0,0,0,0,0,0,0,0,0,41,51,0.0,M2020-03-18D,Race(1),,
5,3,0,0,3,0,0,2,2,2,0,2,4,5,0,4,9,7.5,8.5,0.0,M2020-03-18D,Race(1),,
12,0,0,0,0,0,0,0,0,0,0,0,0,0,0,0,0,41,51,0.0,M2020-03-18D,Race(1),,
6,2,10,2,14,3,0,4,7,5,2,5,12,10,12,11,33,6.5,6,0.0,M2020-03-18D,Race(1),,
7,0,2,0,2,0,0,0,0,0,0,0,0,0,2,0,2,23,23,0.0,M2020-03-18D,Race(1),,
8,2,5,10,17,1,4,2,7,2,6,3,11,5,15,15,35,8,8.5,0.0,M2020-03-18D,Race(1),,
11,0,0,0,0,0,0,1,1,0,0,2,2,0,0,3,3,23,21,0.0,M2020-03-18D,Race(1),,
4,0,0,0,0,0,0,0,0,0,0,0,0,0,0,0,0,101,126,0.0,M2020-03-18D,Race(2),,
8,0,2,3,5,0,0,0,0,0,0,3,3,0,2,6,8,11,17,0.0,M2020-03-18D,Race(2),,
1,0,0,0,0,0,0,0,0,1,0,0,1,1,0,0,1,51,51,0.0,M2020-03-18D,Race(2),,
2,4,2,5,11,3,3,16,22,7,4,4,15,14,9,25,48,5.5,6,2.0,M2020-03-18D,Race(2),,
3,5,0,2,7,1,1,1,3,1,4,2,7,7,5,5,17,4.8,4.4,0.0,M2020-03-18D,Race(2),,
5,0,0,0,0,0,0,0,0,0,0,0,0,0,0,0,0,81,81,0.0,M2020-03-18D,Race(2),,
6,0,0,0,0,0,0,0,0,0,0,0,0,0,0,0,0,101,101,0.0,M2020-03-18D,Race(2),,
7,0,8,3,11,1,1,1,3,1,1,3,5,2,10,7,19,11,10,0.0,M2020-03-18D,Race(2),,
11,0,0,8,8,1,1,1,3,0,2,2,4,1,3,11,15,14,14,0.0,M2020-03-18D,Race(2),,
10,0,5,9,14,6,16,6,28,6,7,5,18,12,28,20,60,9.5,9.5,0.0,M2020-03-18D,Race(2),,
12,7,6,0,13,0,3,2,5,0,3,2,5,7,12,4,23,6.5,7,1.0,M2020-03-18D,Race(2),,
9,14,7,0,21,18,5,3,26,10,5,5,20,42,17,8,67,2.9,2.8,3.0,M2020-03-18D,Race(2),,
11,3,8,7,18,3,1,3,7,2,3,4,9,8,12,14,34,6,6,1.0,M2020-03-18D,Race(3),,
7,0,0,0,0,0,0,0,0,1,0,0,1,1,0,0,1,101,101,0.0,M2020-03-18D,Race(3),,
8,6,7,3,16,4,4,7,15,3,5,5,13,13,16,15,44,7,7,0.0,M2020-03-18D,Race(3),,
9,0,0,2,2,1,0,1,2,2,0,3,5,3,0,6,9,12,12,2.0,M2020-03-18D,Race(3),,
5,0,0,0,0,2,1,1,4,2,2,1,5,4,3,2,9,15,15,0.0,M2020-03-18D,Race(3),,
6,0,0,3,3,0,0,0,0,0,0,0,0,0,0,3,3,26,26,0.0,M2020-03-18D,Race(3),,
4,2,3,2,7,1,1,7,9,0,1,4,5,3,5,13,21,13,13,0.0,M2020-03-18D,Race(3),,
1,5,4,5,14,3,17,4,24,8,6,0,14,16,27,9,52,3.2,3.2,0.0,M2020-03-18D,Race(3),,
2,0,0,0,0,0,0,0,0,0,0,0,0,0,0,0,0,61,61,0.0,M2020-03-18D,Race(3),,
10,12,8,3,23,16,5,3,24,7,6,3,16,35,19,9,63,4.4,4.4,0.0,M2020-03-18D,Race(3),,
12,0,0,5,5,0,1,3,4,0,2,5,7,0,3,13,16,14,14,0.0,M2020-03-18D,Race(3),,
3,2,0,0,2,0,0,0,0,0,0,1,1,2,0,1,3,15,15,3.0,M2020-03-18D,Race(3),,
1,8,6,4,18,6,3,13,22,4,7,8,19,18,16,25,59,3.8,4,1.0,M2020-03-18D,Race(4),,
2,0,3,0,3,0,5,1,6,0,4,1,5,0,12,2,14,11,10,0.0,M2020-03-18D,Race(4),,
4,5,9,8,22,19,5,1,25,10,3,2,15,34,17,11,62,3.7,3.8,3.0,M2020-03-18D,Race(4),,
3,0,2,0,2,2,0,2,4,1,0,2,3,3,2,4,9,12,11,0.0,M2020-03-18D,Race(4),,
6,0,0,0,0,1,0,1,2,0,0,0,0,1,0,1,2,14,13,0.0,M2020-03-18D,Race(4),,
7,8,2,11,21,2,2,2,6,8,2,4,14,18,6,17,41,7,7.5,0.0,M2020-03-18D,Race(4),,
8,2,8,7,17,0,13,9,22,1,7,5,13,3,28,21,52,5.5,6,0.0,M2020-03-18D,Race(4),,
9,7,0,0,7,0,1,1,2,1,2,2,5,8,3,3,14,15,16,2.0,M2020-03-18D,Race(4),,
10,0,0,0,0,0,0,0,0,0,0,1,1,0,0,1,1,20,19,0.0,M2020-03-18D,Race(4),,
11,0,0,0,0,0,1,0,1,0,1,0,1,0,2,0,2,20,19,0.0,M2020-03-18D,Race(4),,
12,0,0,0,0,0,0,0,0,0,0,0,0,0,0,0,0,61,61,0.0,M2020-03-18D,Race(4),,
5,0,0,0,0,0,0,0,0,1,0,1,2,1,0,1,2,71,67,0.0,M2020-03-18D,Race(4),,
2,6,3,0,9,3,2,0,5,3,1,2,6,12,6,2,20,13,14,0.0,M2020-03-18D,Race(5),,
6,0,0,5,5,0,0,1,1,1,0,1,2,1,0,7,8,13,13,1.0,M2020-03-18D,Race(5),,
1,12,9,4,25,16,7,4,27,10,6,3,19,38,22,11,71,4.4,4.2,2.0,M2020-03-18D,Race(5),,
7,2,2,0,4,1,0,1,2,1,0,3,4,4,2,4,10,7.5,8,0.0,M2020-03-18D,Race(5),,
4,0,0,0,0,2,3,2,7,4,3,2,9,6,6,4,16,11,11,0.0,M2020-03-18D,Race(5),,
5,2,0,3,5,0,0,0,0,0,1,0,1,2,1,3,6,21,23,0.0,M2020-03-18D,Race(5),,
3,0,3,8,11,0,3,12,15,0,5,5,10,0,11,25,36,8,8.5,3.0,M2020-03-18D,Race(5),,
8,3,3,0,6,1,0,0,1,0,2,0,2,4,5,0,9,13,14,0.0,M2020-03-18D,Race(5),,
9,0,2,2,4,0,0,0,0,0,0,1,1,0,2,3,5,17,16,0.0,M2020-03-18D,Race(5),,
10,3,8,2,13,7,12,8,27,7,5,6,18,17,25,16,58,3.8,3.7,0.0,M2020-03-18D,Race(5),,
11,2,0,6,8,0,3,2,5,0,3,3,6,2,6,11,19,9.5,10,0.0,M2020-03-18D,Race(5),,
12,0,0,0,0,0,0,0,0,0,0,0,0,0,0,0,0,126,101,0.0,M2020-03-18D,Race(5),,
9,2,0,4,6,0,1,0,1,1,0,0,1,3,1,4,8,13,13,1.0,M2020-03-18D,Race(6),,
8,14,6,8,28,18,6,3,27,9,12,2,23,41,24,13,78,3.9,4,2.0,M2020-03-18D,Race(6),,
7,4,9,3,16,0,0,4,4,1,0,7,8,5,9,14,28,7,7,0.0,M2020-03-18D,Race(6),,
6,0,0,2,2,1,1,0,2,0,0,1,1,1,1,3,5,11,11,0.0,M2020-03-18D,Race(6),,
5,8,2,6,16,8,16,2,26,11,11,0,22,27,29,8,64,4.6,4.6,0.0,M2020-03-18D,Race(6),,
12,0,0,0,0,0,0,0,0,0,0,0,0,0,0,0,0,34,34,0.0,M2020-03-18D,Race(6),,
4,0,2,0,2,0,2,5,7,1,2,5,8,1,6,10,17,7.5,7.5,3.0,M2020-03-18D,Race(6),,
3,0,0,0,0,0,2,0,2,1,0,0,1,1,2,0,3,13,13,0.0,M2020-03-18D,Race(6),,
11,0,3,0,3,0,0,0,0,0,0,2,2,0,3,2,5,13,13,0.0,M2020-03-18D,Race(6),,
2,0,0,0,0,0,0,0,0,0,0,0,0,0,0,0,0,101,101,0.0,M2020-03-18D,Race(6),,
1,2,8,7,17,3,2,15,20,1,1,5,7,6,11,27,44,8.5,8.5,0.0,M2020-03-18D,Race(6),,
10,0,0,0,0,0,0,1,1,1,0,4,5,1,0,5,6,14,18,0.0,M2020-03-18D,Race(6),,
3,0,3,3,6,1,0,5,6,0,0,4,4,1,3,12,16,14,14,0.0,M2020-03-18D,Race(7),,
8,0,0,0,0,0,0,0,0,0,0,0,0,0,0,0,0,61,61,0.0,M2020-03-18D,Race(7),,
4,0,0,0,0,0,0,0,0,0,1,0,1,0,1,0,1,31,31,0.0,M2020-03-18D,Race(7),,
6,0,0,9,9,1,0,1,2,1,0,2,3,2,0,12,14,9,9,2.0,M2020-03-18D,Race(7),,
7,0,2,2,4,0,2,2,4,0,2,4,6,0,6,8,14,16,16,0.0,M2020-03-18D,Race(7),,
10,5,2,7,14,0,0,0,0,1,0,1,2,6,2,8,16,8,8,0.0,M2020-03-18D,Race(7),,
9,0,0,0,0,0,0,0,0,0,0,0,0,0,0,0,0,61,61,0.0,M2020-03-18D,Race(7),,
1,5,14,4,23,3,1,13,17,5,2,8,15,13,17,25,55,6,6,0.0,M2020-03-18D,Race(7),,
11,18,7,5,30,3,20,4,27,5,14,3,22,26,41,12,79,2.5,2.5,0.0,M2020-03-18D,Race(7),,
12,0,0,0,0,0,0,0,0,0,0,0,0,0,0,0,0,13,13,3.0,M2020-03-18D,Race(7),,
5,2,2,0,4,0,1,3,4,0,2,0,2,2,5,3,10,8,8,1.0,M2020-03-18D,Race(7),,
2,0,0,0,0,0,0,0,0,0,0,0,0,0,0,0,0,12,12,0.0,M2020-03-18D,Race(7),,
12,0,0,0,0,0,0,0,0,0,0,1,1,0,0,1,1,31,31,0.0,M2020-03-18D,Race(8),,
3,0,0,0,0,0,1,0,1,1,0,0,1,1,1,0,2,26,26,0.0,M2020-03-18D,Race(8),,
5,0,2,0,2,0,0,0,0,0,2,1,3,0,4,1,5,41,41,0.0,M2020-03-18D,Race(8),,
6,0,0,0,0,0,0,0,0,0,0,1,1,0,0,1,1,19,19,3.0,M2020-03-18D,Race(8),,
7,3,8,10,21,1,2,3,6,1,2,9,12,5,12,22,39,7,7,0.0,M2020-03-18D,Race(8),,
8,2,0,0,2,0,0,0,0,0,0,0,0,2,0,0,2,19,19,0.0,M2020-03-18D,Race(8),,
9,0,0,0,0,0,0,0,0,0,0,0,0,0,0,0,0,61,61,0.0,M2020-03-18D,Race(8),,
10,4,3,0,7,1,1,12,14,0,0,7,7,5,4,19,28,7.5,7.5,0.0,M2020-03-18D,Race(8),,
11,8,7,2,17,1,3,0,4,2,2,1,5,11,12,3,26,6.5,6.5,0.0,M2020-03-18D,Race(8),,
1,5,5,3,13,5,1,5,11,4,0,4,8,14,6,12,32,5,5,0.0,M2020-03-18D,Race(8),,
4,0,5,8,13,5,16,5,26,3,14,2,19,8,35,15,58,6.5,6.5,2.0,M2020-03-18D,Race(8),,
2,8,0,7,15,17,6,5,28,15,6,0,21,40,12,12,64,3.4,3.6,1.0,M2020-03-18D,Race(8),,
6,0,0,0,0,0,0,0,0,0,0,0,0,0,0,0,0,51,51,3.0,M2020-03-22D,Race(1),,
4,2,14,2,18,20,2,6,28,13,2,7,22,35,18,15,68,3.5,3.4,2.0,M2020-03-22D,Race(1),,
5,15,2,5,22,1,7,5,13,3,5,4,12,19,14,14,47,5,5,0.0,M2020-03-22D,Race(1),,
1,3,0,5,8,1,6,4,11,3,10,1,14,7,16,10,33,14,14,0.0,M2020-03-22D,Race(1),,
7,6,5,7,18,6,14,4,24,2,5,10,17,14,24,21,59,4.6,4.6,0.0,M2020-03-22D,Race(1),,
8,0,2,6,8,0,0,0,0,1,1,0,2,1,3,6,10,12,12,0.0,M2020-03-22D,Race(1),,
9,0,0,0,0,0,0,0,0,0,0,0,0,0,0,0,0,151,126,0.0,M2020-03-22D,Race(1),,
10,0,0,0,0,0,0,0,0,0,0,1,1,0,0,1,1,71,81,0.0,M2020-03-22D,Race(1),,
12,0,5,2,7,2,1,10,13,4,1,3,8,6,7,15,28,5.5,5.5,1.0,M2020-03-22D,Race(1),,
13,4,2,0,6,0,0,1,1,0,0,0,0,4,2,1,7,12,12,0.0,M2020-03-22D,Race(1),,
14,0,0,0,0,0,0,0,0,0,0,0,0,0,0,0,0,126,126,0.0,M2020-03-22D,Race(1),,
3,0,0,0,0,0,0,0,0,0,0,0,0,0,0,0,0,81,91,0.0,M2020-03-22D,Race(1),,
11,0,0,0,0,0,0,0,0,0,0,0,0,0,0,0,0,51,61,0.0,M2020-03-22D,Race(1),,
2,0,0,3,3,0,0,0,0,0,2,0,2,0,2,3,5,14,14,0.0,M2020-03-22D,Race(1),,
11,0,3,0,3,1,2,0,3,0,0,0,0,1,5,0,6,26,26,3.0,M2020-03-22D,Race(10),,
1,0,0,0,0,0,0,0,0,0,0,0,0,0,0,0,0,41,41,0.0,M2020-03-22D,Race(10),,
2,0,0,0,0,0,0,1,1,0,0,1,1,0,0,2,2,31,31,0.0,M2020-03-22D,Race(10),,
3,0,0,0,0,0,0,1,1,0,1,1,2,0,1,2,3,34,34,0.0,M2020-03-22D,Race(10),,
4,7,0,16,23,10,10,3,23,9,10,4,23,26,20,23,69,5,4.5,0.0,M2020-03-22D,Race(10),,
5,0,0,0,0,0,0,0,0,0,0,0,0,0,0,0,0,26,34,0.0,M2020-03-22D,Race(10),,
6,0,0,0,0,0,0,0,0,0,0,0,0,0,0,0,0,26,34,2.0,M2020-03-22D,Race(10),,
7,2,0,0,2,0,0,0,0,0,2,0,2,2,2,0,4,21,34,0.0,M2020-03-22D,Race(10),,
13,0,0,0,0,0,0,0,0,0,0,0,0,0,0,0,0,34,51,0.0,M2020-03-22D,Race(10),,
8,4,7,2,13,4,10,8,22,5,6,4,15,13,23,14,50,6.5,6.5,0.0,M2020-03-22D,Race(10),,
10,9,13,4,26,12,4,3,19,9,6,7,22,30,23,14,67,3,2.9,1.0,M2020-03-22D,Race(10),,
14,0,0,0,0,0,0,0,0,0,0,0,0,0,0,0,0,20,26,0.0,M2020-03-22D,Race(10),,
12,8,7,8,23,3,4,14,21,3,1,9,13,14,12,31,57,4.6,3.8,0.0,M2020-03-22D,Race(10),,
9,0,0,0,0,0,0,0,0,0,0,0,0,0,0,0,0,26,41,0.0,M2020-03-22D,Race(10),,
9,0,0,0,0,0,0,0,0,0,0,0,0,0,0,0,0,101,126,0.0,M2020-03-22D,Race(2),,
11,18,2,2,22,14,5,10,29,15,5,5,25,47,12,17,76,2.1,2,3.0,M2020-03-22D,Race(2),,
12,0,0,0,0,0,0,0,0,0,0,0,0,0,0,0,0,31,31,0.0,M2020-03-22D,Race(2),,
13,3,5,0,8,0,3,1,4,0,1,0,1,3,9,1,13,14,15,2.0,M2020-03-22D,Race(2),,
10,0,2,13,15,12,8,6,26,2,4,13,19,14,14,32,60,10,10,0.0,M2020-03-22D,Race(2),,
14,2,0,0,2,0,2,2,4,0,3,1,4,2,5,3,10,26,26,0.0,M2020-03-22D,Race(2),,
7,0,9,2,11,0,0,0,0,1,2,0,3,1,11,2,14,8,8.5,1.0,M2020-03-22D,Race(2),,
8,0,0,0,0,0,0,0,0,0,0,0,0,0,0,0,0,81,81,0.0,M2020-03-22D,Race(2),,
6,2,2,0,4,0,0,0,0,0,0,0,0,2,2,0,4,41,34,0.0,M2020-03-22D,Race(2),,
5,0,3,0,3,0,0,0,0,0,0,0,0,0,3,0,3,16,17,0.0,M2020-03-22D,Race(2),,
4,3,4,6,13,1,9,10,20,6,6,6,18,10,19,22,51,8,8,0.0,M2020-03-22D,Race(2),,
3,0,0,0,0,0,0,0,0,0,0,0,0,0,0,0,0,41,41,0.0,M2020-03-22D,Race(2),,
2,0,0,5,5,1,1,1,3,2,2,1,5,3,3,7,13,21,21,0.0,M2020-03-22D,Race(2),,
1,2,3,2,7,0,2,0,2,0,3,0,3,2,8,2,12,9,8.5,0.0,M2020-03-22D,Race(2),,
14,0,0,0,0,0,0,0,0,0,0,0,0,0,0,0,0,126,151,0.0,M2020-03-22D,Race(3),,
7,0,2,5,7,1,2,13,16,1,3,4,8,2,7,22,31,19,19,3.0,M2020-03-22D,Race(3),,
6,0,0,3,3,0,0,0,0,0,0,0,0,0,0,3,3,126,151,0.0,M2020-03-22D,Race(3),,
5,0,0,0,0,0,0,1,1,0,0,3,3,0,0,4,4,23,26,0.0,M2020-03-22D,Race(3),,
4,15,7,6,28,11,11,7,29,6,11,7,24,32,29,20,81,2.6,2.6,1.0,M2020-03-22D,Race(3),,
2,0,0,0,0,0,0,0,0,1,0,1,2,1,0,1,2,71,81,0.0,M2020-03-22D,Race(3),,
1,0,6,5,11,1,13,4,18,1,8,3,12,2,27,12,41,9,9,0.0,M2020-03-22D,Race(3),,
8,0,0,0,0,0,0,1,1,0,0,0,0,0,0,1,1,41,51,0.0,M2020-03-22D,Race(3),,
9,0,0,0,0,0,0,0,0,0,0,0,0,0,0,0,0,151,201,0.0,M2020-03-22D,Race(3),,
11,0,0,3,3,0,0,0,0,0,0,0,0,0,0,3,3,31,34,0.0,M2020-03-22D,Race(3),,
3,2,5,0,7,0,0,1,1,1,0,0,1,3,5,1,9,12,12,0.0,M2020-03-22D,Race(3),,
12,0,3,6,9,0,0,1,1,0,0,4,4,0,3,11,14,8.5,8.5,0.0,M2020-03-22D,Race(3),,
13,0,0,0,0,0,0,0,0,0,0,0,0,0,0,0,0,71,81,0.0,M2020-03-22D,Race(3),,
10,13,7,2,22,17,4,2,23,16,4,4,24,46,15,8,69,2.5,2.5,2.0,M2020-03-22D,Race(3),,
3,0,7,2,9,2,1,2,5,3,3,2,8,5,11,6,22,6.5,6.5,0.0,M2020-03-22D,Race(4),,
2,0,2,2,4,1,2,1,4,4,1,1,6,5,5,4,14,13,13,0.0,M2020-03-22D,Race(4),,
1,2,0,0,2,3,4,4,11,6,3,1,10,11,7,5,23,8,8,2.0,M2020-03-22D,Race(4),,
4,0,0,0,0,0,0,0,0,0,0,0,0,0,0,0,0,21,21,0.0,M2020-03-22D,Race(4),,
10,12,6,6,24,13,4,2,19,2,7,2,11,27,17,10,54,6,5.5,1.0,M2020-03-22D,Race(4),,
11,6,3,4,13,4,10,3,17,4,1,3,8,14,14,10,38,4.2,4,3.0,M2020-03-22D,Race(4),,
5,7,3,7,17,4,5,11,20,4,4,5,13,15,12,23,50,8,8,0.0,M2020-03-22D,Race(4),,
6,0,0,0,0,0,0,2,2,1,2,3,6,1,2,5,8,20,21,0.0,M2020-03-22D,Race(4),,
7,0,5,0,5,0,0,0,0,0,0,1,1,0,5,1,6,17,19,0.0,M2020-03-22D,Race(4),,
8,0,0,3,3,0,0,0,0,0,0,0,0,0,0,3,3,41,41,0.0,M2020-03-22D,Race(4),,
9,3,0,3,6,0,0,1,1,0,0,1,1,3,0,5,8,18,17,0.0,M2020-03-22D,Race(4),,
12,0,0,0,0,0,0,0,0,0,0,0,0,0,0,0,0,101,126,0.0,M2020-03-22D,Race(4),,
13,0,2,0,2,3,1,1,5,2,1,2,5,5,4,3,12,19,21,0.0,M2020-03-22D,Race(4),,
14,0,2,3,5,0,3,3,6,0,4,5,9,0,9,11,20,14,13,0.0,M2020-03-22D,Race(4),,
13,0,5,0,5,0,0,1,1,0,0,3,3,0,5,4,9,34,41,2.0,M2020-03-22D,Race(5),,
12,18,5,4,27,19,6,3,28,14,3,3,20,51,14,10,75,2.05,2.05,1.0,M2020-03-22D,Race(5),,
10,0,0,0,0,0,0,0,0,0,0,0,0,0,0,0,0,81,101,0.0,M2020-03-22D,Race(5),,
14,0,0,0,0,0,0,0,0,0,0,0,0,0,0,0,0,0,0,0.0,M2020-03-22D,Race(5),,
2,0,0,0,0,0,0,0,0,0,0,0,0,0,0,0,0,71,91,0.0,M2020-03-22D,Race(5),,
11,0,0,0,0,0,0,0,0,0,0,0,0,0,0,0,0,91,151,0.0,M2020-03-22D,Race(5),,
9,7,0,17,24,2,4,14,20,4,6,9,19,13,10,40,63,6,4.6,0.0,M2020-03-22D,Race(5),,
8,0,7,5,12,4,0,7,11,0,0,8,8,4,7,20,31,4.8,5.5,3.0,M2020-03-22D,Race(5),,
1,0,0,0,0,0,0,0,0,0,0,0,0,0,0,0,0,91,81,0.0,M2020-03-22D,Race(5),,
6,3,8,0,11,5,19,4,28,5,15,0,20,13,42,4,59,6,6,0.0,M2020-03-22D,Race(5),,
7,0,0,0,0,0,1,0,1,0,1,0,1,0,2,0,2,34,51,0.0,M2020-03-22D,Race(5),,
4,0,0,2,2,0,0,0,0,1,0,2,3,1,0,4,5,34,41,0.0,M2020-03-22D,Race(5),,
3,0,3,0,3,0,0,1,1,0,0,0,0,0,3,1,4,20,31,0.0,M2020-03-22D,Race(5),,
5,2,2,2,6,0,0,0,0,2,1,1,4,4,3,3,10,17,12,0.0,M2020-03-22D,Race(5),,
10,3,3,5,11,0,0,0,0,0,0,0,0,3,3,5,11,15,14,0.0,M2020-03-22D,Race(6),,
11,3,8,5,16,5,6,16,27,3,7,8,18,11,21,29,61,4.2,3.8,0.0,M2020-03-22D,Race(6),,
14,0,0,0,0,0,0,0,0,0,0,0,0,0,0,0,0,41,61,0.0,M2020-03-22D,Race(6),,
8,2,0,0,2,1,1,1,3,2,1,0,3,5,2,1,8,11,10,0.0,M2020-03-22D,Race(6),,
13,2,0,2,4,0,3,0,3,0,1,3,4,2,4,5,11,20,13,1.0,M2020-03-22D,Race(6),,
12,2,0,3,5,1,1,0,2,2,3,1,6,5,4,4,13,17,15,0.0,M2020-03-22D,Race(6),,
1,0,5,3,8,1,3,3,7,1,3,1,5,2,11,7,20,9,12,0.0,M2020-03-22D,Race(6),,
2,8,9,0,17,15,5,1,21,7,3,2,12,30,17,3,50,7,7,2.0,M2020-03-22D,Race(6),,
5,10,5,4,19,3,10,3,16,5,6,1,12,18,21,8,47,3.8,3.7,3.0,M2020-03-22D,Race(6),,
4,0,0,0,0,0,0,0,0,0,0,0,0,0,0,0,0,41,71,0.0,M2020-03-22D,Race(6),,
3,0,0,0,0,0,0,0,0,0,0,0,0,0,0,0,0,81,101,0.0,M2020-03-22D,Race(6),,
9,0,0,3,3,0,0,0,0,0,0,0,0,0,0,3,3,34,41,0.0,M2020-03-22D,Race(6),,
7,0,0,5,5,4,1,6,11,6,2,9,17,10,3,20,33,7,8,0.0,M2020-03-22D,Race(6),,
6,0,0,0,0,0,0,0,0,0,0,1,1,0,0,1,1,34,67,0.0,M2020-03-22D,Race(6),,
13,0,0,0,0,0,0,0,0,0,0,0,0,0,0,0,0,0,0,0.0,M2020-03-22D,Race(7),,
9,0,0,0,0,0,0,0,0,0,0,0,0,0,0,0,0,151,201,0.0,M2020-03-22D,Race(7),,
10,0,0,0,0,0,0,0,0,0,0,0,0,0,0,0,0,151,201,0.0,M2020-03-22D,Race(7),,
11,6,2,17,25,12,7,6,25,5,7,8,20,23,16,31,70,4.2,4.2,0.0,M2020-03-22D,Race(7),,
12,0,2,0,2,0,0,0,0,0,0,0,0,0,2,0,2,41,51,0.0,M2020-03-22D,Race(7),,
14,0,0,0,0,0,0,0,0,0,0,0,0,0,0,0,0,0,0,0.0,M2020-03-22D,Race(7),,
6,0,0,2,2,0,3,5,8,0,8,3,11,0,11,10,21,21,21,0.0,M2020-03-22D,Race(7),,
1,0,0,3,3,0,0,2,2,0,0,1,1,0,0,6,6,23,26,0.0,M2020-03-22D,Race(7),,
5,15,13,0,28,17,9,3,29,17,3,4,24,49,25,7,81,2.2,2.2,1.0,M2020-03-22D,Race(7),,
4,2,0,0,2,1,3,0,4,2,2,1,5,5,5,1,11,6,6,0.0,M2020-03-22D,Race(7),,
3,0,0,0,0,0,0,0,0,0,0,1,1,0,0,1,1,151,201,0.0,M2020-03-22D,Race(7),,
2,3,10,6,19,0,5,11,16,2,3,5,10,5,18,22,45,7,7,3.0,M2020-03-22D,Race(7),,
7,0,3,0,3,0,0,1,1,0,0,1,1,0,3,2,5,23,26,2.0,M2020-03-22D,Race(7),,
8,4,0,2,6,0,3,2,5,0,3,2,5,4,6,6,16,8.5,8.5,0.0,M2020-03-22D,Race(7),,
5,0,0,0,0,1,1,0,2,0,0,0,0,1,1,0,2,41,67,0.0,M2020-03-22D,Race(8),,
14,0,0,0,0,0,0,0,0,0,0,0,0,0,0,0,0,71,67,0.0,M2020-03-22D,Race(8),,
13,0,0,0,0,0,0,0,0,0,0,0,0,0,0,0,0,101,101,0.0,M2020-03-22D,Race(8),,
12,0,0,2,2,0,0,0,0,0,0,0,0,0,0,2,2,51,34,0.0,M2020-03-22D,Race(8),,
3,6,17,3,26,12,8,9,29,4,9,8,21,22,34,20,76,3.2,3,3.0,M2020-03-22D,Race(8),,
9,2,0,2,4,0,1,2,3,0,3,7,10,2,4,11,17,21,15,0.0,M2020-03-22D,Race(8),,
11,0,2,0,2,0,0,0,0,0,1,1,2,0,3,1,4,34,21,0.0,M2020-03-22D,Race(8),,
4,0,0,0,0,0,0,0,0,0,0,0,0,0,0,0,0,51,34,0.0,M2020-03-22D,Race(8),,
10,0,0,0,0,0,0,0,0,0,0,0,0,0,0,0,0,61,51,0.0,M2020-03-22D,Race(8),,
8,2,0,0,2,0,0,0,0,0,0,0,0,2,0,0,2,21,21,0.0,M2020-03-22D,Race(8),,
7,0,2,5,7,1,0,0,1,2,1,1,4,3,3,6,12,16,15,0.0,M2020-03-22D,Race(8),,
6,0,0,0,0,0,0,0,0,0,0,0,0,0,0,0,0,41,51,2.0,M2020-03-22D,Race(8),,
1,20,6,2,28,16,6,8,30,20,5,1,26,56,17,11,84,2.1,2.3,1.0,M2020-03-22D,Race(8),,
2,0,3,16,19,0,14,11,25,0,7,8,15,0,24,35,59,6,6,0.0,M2020-03-22D,Race(8),,
5,0,0,0,0,0,0,1,1,0,2,0,2,0,2,1,3,13,13,0.0,M2020-03-22D,Race(9),,
6,2,3,10,15,4,6,6,16,3,6,9,18,9,15,25,49,6,6.5,0.0,M2020-03-22D,Race(9),,
7,0,0,2,2,0,0,0,0,0,0,0,0,0,0,2,2,23,26,0.0,M2020-03-22D,Race(9),,
8,0,0,0,0,0,0,1,1,0,1,2,3,0,1,3,4,19,19,0.0,M2020-03-22D,Race(9),,
9,0,0,0,0,0,0,0,0,0,0,0,0,0,0,0,0,34,34,0.0,M2020-03-22D,Race(9),,
10,7,7,6,20,4,10,6,20,4,6,2,12,15,23,14,52,5.5,5.5,0.0,M2020-03-22D,Race(9),,
4,3,7,5,15,14,2,5,21,8,1,5,14,25,10,15,50,7.5,7,0.0,M2020-03-22D,Race(9),,
12,0,0,0,0,0,0,0,0,0,0,0,0,0,0,0,0,23,26,0.0,M2020-03-22D,Race(9),,
13,0,0,0,0,0,0,0,0,0,0,1,1,0,0,1,1,51,61,0.0,M2020-03-22D,Race(9),,
2,3,8,2,13,4,9,9,22,8,8,3,19,15,25,14,54,6,6,1.0,M2020-03-22D,Race(9),,
3,0,0,0,0,0,0,0,0,0,1,0,1,0,1,0,1,61,67,0.0,M2020-03-22D,Race(9),,
1,7,0,2,9,1,3,1,5,0,1,2,3,8,4,5,17,7,6.5,3.0,M2020-03-22D,Race(9),,
11,0,0,0,0,0,0,0,0,0,0,0,0,0,0,0,0,21,23,0.0,M2020-03-22D,Race(9),,
14,8,5,3,16,3,0,1,4,3,0,2,5,14,5,6,25,5.5,6,2.0,M2020-03-22D,Race(9),,
3,4,10,8,22,0,14,7,21,0,4,6,10,4,28,21,53,5,5,0.0,M2020-03-25D,Race(1),,
9,0,0,0,0,0,0,0,0,0,0,0,0,0,0,0,0,61,61,0.0,M2020-03-25D,Race(1),,
8,0,0,0,0,0,0,0,0,0,0,0,0,0,0,0,0,41,41,0.0,M2020-03-25D,Race(1),,
7,0,0,5,5,0,3,2,5,1,4,2,7,1,7,9,17,8,8,1.0,M2020-03-25D,Race(1),,
6,0,0,0,0,0,0,1,1,0,0,0,0,0,0,1,1,34,34,0.0,M2020-03-25D,Race(1),,
5,0,3,0,3,0,2,0,2,1,4,0,5,1,9,0,10,21,21,0.0,M2020-03-25D,Race(1),,
12,2,3,11,16,2,7,13,22,4,6,10,20,8,16,34,58,4.4,4.4,2.0,M2020-03-25D,Race(1),,
2,8,2,3,13,0,4,4,8,2,4,3,9,10,10,10,30,7,7,0.0,M2020-03-25D,Race(1),,
1,16,8,0,24,28,0,2,30,18,4,2,24,62,12,4,78,3,3,3.0,M2020-03-25D,Race(1),,
10,0,0,0,0,0,0,0,0,0,0,1,1,0,0,1,1,26,26,0.0,M2020-03-25D,Race(1),,
11,0,0,0,0,0,0,1,1,0,0,2,2,0,0,3,3,18,18,0.0,M2020-03-25D,Race(1),,
4,0,4,3,7,0,0,0,0,0,0,0,0,0,4,3,7,17,17,0.0,M2020-03-25D,Race(1),,
12,0,0,0,0,0,0,1,1,0,1,1,2,0,1,2,3,13,13,3.0,M2020-03-25D,Race(2),,
1,13,8,0,21,6,17,5,28,7,7,3,17,26,32,8,66,4.6,4.5,1.0,M2020-03-25D,Race(2),,
10,2,2,0,4,1,1,1,3,1,4,1,6,4,7,2,13,17,16,0.0,M2020-03-25D,Race(2),,
11,0,0,0,0,0,0,0,0,0,0,0,0,0,0,0,0,41,41,0.0,M2020-03-25D,Race(2),,
2,0,3,3,6,1,2,2,5,3,3,2,8,4,8,7,19,9,8.5,2.0,M2020-03-25D,Race(2),,
3,5,10,13,28,14,5,5,24,6,3,8,17,25,18,26,69,4,3.9,0.0,M2020-03-25D,Race(2),,
4,0,0,0,0,0,0,0,0,0,0,0,0,0,0,0,0,61,61,0.0,M2020-03-25D,Race(2),,
5,0,3,0,3,0,0,0,0,0,0,0,0,0,3,0,3,8,8,0.0,M2020-03-25D,Race(2),,
6,5,2,0,7,0,0,0,0,0,1,1,2,5,3,1,9,13,13,0.0,M2020-03-25D,Race(2),,
7,0,0,0,0,0,0,0,0,0,0,0,0,0,0,0,0,61,61,0.0,M2020-03-25D,Race(2),,
8,0,2,5,7,2,2,4,8,4,3,4,11,6,7,13,26,9,8.5,0.0,M2020-03-25D,Race(2),,
9,5,0,9,14,6,3,12,21,5,4,6,15,16,7,27,50,6,6,0.0,M2020-03-25D,Race(2),,
11,0,0,3,3,0,1,1,2,0,1,1,2,0,2,5,7,9.5,9,0.0,M2020-03-25D,Race(3),,
2,0,2,0,2,0,0,0,0,0,0,0,0,0,2,0,2,11,10,0.0,M2020-03-25D,Race(3),,
3,5,2,11,18,4,5,14,23,7,9,5,21,16,16,30,62,7,6.5,3.0,M2020-03-25D,Race(3),,
4,13,6,7,26,16,4,5,25,10,3,5,18,39,13,17,69,2.65,2.6,0.0,M2020-03-25D,Race(3),,
5,0,0,0,0,0,0,0,0,0,0,1,1,0,0,1,1,101,91,0.0,M2020-03-25D,Race(3),,
1,3,7,5,15,1,3,5,9,1,2,8,11,5,12,18,35,7.5,7,1.0,M2020-03-25D,Race(3),,
9,5,8,4,17,7,17,1,25,8,8,1,17,20,33,6,59,6,6,0.0,M2020-03-25D,Race(3),,
7,0,0,0,0,0,0,0,0,0,0,0,0,0,0,0,0,101,91,0.0,M2020-03-25D,Race(3),,
8,2,2,0,4,0,0,0,0,0,0,0,0,2,2,0,4,61,51,0.0,M2020-03-25D,Race(3),,
10,2,0,0,2,1,0,0,1,0,1,0,1,3,1,0,4,16,15,0.0,M2020-03-25D,Race(3),,
12,0,3,0,3,1,0,4,5,0,1,5,6,1,4,9,14,9.5,9,2.0,M2020-03-25D,Race(3),,
6,0,0,0,0,0,0,0,0,0,1,0,1,0,1,0,1,51,46,0.0,M2020-03-25D,Race(3),,
11,2,0,16,18,1,5,4,10,4,7,4,15,7,12,24,43,7,7,1.0,M2020-03-25D,Race(4),,
10,0,0,0,0,0,0,1,1,0,0,1,1,0,0,2,2,13,13,2.0,M2020-03-25D,Race(4),,
12,0,0,0,0,0,0,0,0,0,0,0,0,0,0,0,0,41,41,3.0,M2020-03-25D,Race(4),,
9,0,5,0,5,1,1,1,3,0,1,2,3,1,7,3,11,11,11,0.0,M2020-03-25D,Race(4),,
8,0,0,0,0,0,0,2,2,1,1,3,5,1,1,5,7,10,9.5,0.0,M2020-03-25D,Race(4),,
7,0,0,0,0,0,0,0,0,0,0,0,0,0,0,0,0,61,61,0.0,M2020-03-25D,Race(4),,
6,12,8,7,27,20,5,1,26,14,5,3,22,46,18,11,75,4.4,4.4,0.0,M2020-03-25D,Race(4),,
5,0,0,0,0,0,0,0,0,0,0,0,0,0,0,0,0,17,16,0.0,M2020-03-25D,Race(4),,
4,6,7,0,13,5,9,5,19,3,4,4,11,14,20,9,43,7.5,7.5,0.0,M2020-03-25D,Race(4),,
3,3,0,0,3,0,0,2,2,0,1,2,3,3,1,4,8,7.5,7.5,0.0,M2020-03-25D,Race(4),,
2,5,4,2,11,1,4,11,16,2,6,6,14,8,14,19,41,6.5,6.5,0.0,M2020-03-25D,Race(4),,
1,2,6,5,13,2,6,3,11,2,1,1,4,6,13,9,28,10,9.5,0.0,M2020-03-25D,Race(4),,
4,0,2,0,2,0,0,0,0,1,0,0,1,1,2,0,3,21,21,0.0,M2020-03-25D,Race(5),,
5,4,0,0,4,0,0,1,1,0,0,1,1,4,0,2,6,15,15,0.0,M2020-03-25D,Race(5),,
6,8,8,3,19,8,17,1,26,9,6,4,19,25,31,8,64,3.5,3.5,1.0,M2020-03-25D,Race(5),,
3,0,2,14,16,3,7,15,25,5,7,6,18,8,16,35,59,8,8,0.0,M2020-03-25D,Race(5),,
8,0,0,0,0,0,0,0,0,0,0,0,0,0,0,0,0,91,91,0.0,M2020-03-25D,Race(5),,
10,0,3,3,6,1,0,6,7,1,3,6,10,2,6,15,23,6,6,0.0,M2020-03-25D,Race(5),,
12,0,0,0,0,0,0,0,0,0,0,0,0,0,0,0,0,23,23,0.0,M2020-03-25D,Race(5),,
7,0,0,2,2,0,0,0,0,0,0,0,0,0,0,2,2,61,61,0.0,M2020-03-25D,Race(5),,
11,0,0,0,0,0,0,0,0,1,1,0,2,1,1,0,2,23,23,3.0,M2020-03-25D,Race(5),,
9,0,0,0,0,0,0,0,0,0,1,0,1,0,1,0,1,91,91,0.0,M2020-03-25D,Race(5),,
1,2,10,3,15,0,1,1,2,2,1,2,5,4,12,6,22,7,7,0.0,M2020-03-25D,Race(5),,
2,16,5,5,26,18,5,6,29,7,7,7,21,41,17,18,76,3,3,2.0,M2020-03-25D,Race(5),,
5,0,2,2,4,0,1,1,2,0,0,0,0,0,3,3,6,17,17,0.0,M2020-03-25D,Race(6),,
12,0,0,0,0,0,0,0,0,0,0,0,0,0,0,0,0,26,26,0.0,M2020-03-25D,Race(6),,
1,15,5,10,30,26,2,0,28,20,3,1,24,61,10,11,82,2,2,0.0,M2020-03-25D,Race(6),,
11,0,0,0,0,0,0,0,0,0,0,0,0,0,0,0,0,34,34,2.0,M2020-03-25D,Race(6),,
10,0,0,0,0,0,0,0,0,0,0,0,0,0,0,0,0,41,41,0.0,M2020-03-25D,Race(6),,
3,0,0,0,0,0,0,0,0,0,0,0,0,0,0,0,0,91,91,0.0,M2020-03-25D,Race(6),,
2,12,11,3,26,3,19,5,27,4,11,6,21,19,41,14,74,5,5,3.0,M2020-03-25D,Race(6),,
7,3,10,6,19,1,7,18,26,1,7,10,18,5,24,34,63,4.4,4.4,1.0,M2020-03-25D,Race(6),,
6,0,0,0,0,0,0,0,0,0,1,0,1,0,1,0,1,23,23,0.0,M2020-03-25D,Race(6),,
8,0,0,0,0,0,0,0,0,0,0,1,1,0,0,1,1,91,91,0.0,M2020-03-25D,Race(6),,
4,0,2,9,11,0,0,6,6,1,2,8,11,1,4,23,28,11,11,0.0,M2020-03-25D,Race(6),,
9,0,0,0,0,0,1,0,1,0,2,0,2,0,3,0,3,21,21,0.0,M2020-03-25D,Race(6),,
3,12,13,5,30,21,8,1,30,13,9,3,25,46,30,9,85,2.75,2.7,0.0,M2020-03-25D,Race(7),,
4,0,0,0,0,0,0,1,1,0,2,2,4,0,2,3,5,34,34,0.0,M2020-03-25D,Race(7),,
5,2,2,7,11,0,1,1,2,0,0,3,3,2,3,11,16,9,9,3.0,M2020-03-25D,Race(7),,
10,0,0,0,0,0,2,0,2,0,2,0,2,0,4,0,4,21,20,0.0,M2020-03-25D,Race(7),,
11,0,0,0,0,0,0,0,0,0,0,0,0,0,0,0,0,91,91,0.0,M2020-03-25D,Race(7),,
9,2,0,0,2,0,0,0,0,0,0,0,0,2,0,0,2,15,15,0.0,M2020-03-25D,Race(7),,
12,0,0,3,3,0,0,1,1,0,0,0,0,0,0,4,4,17,17,0.0,M2020-03-25D,Race(7),,
2,0,0,0,0,0,0,0,0,1,0,0,1,1,0,0,1,17,13,0.0,M2020-03-25D,Race(7),,
7,11,7,3,21,8,16,4,28,10,8,6,24,29,31,13,73,3.3,3.3,2.0,M2020-03-25D,Race(7),,
6,3,8,12,23,1,3,22,26,2,5,12,19,6,16,46,68,7,7,1.0,M2020-03-25D,Race(7),,
8,0,0,0,0,0,0,0,0,0,0,0,0,0,0,0,0,61,61,0.0,M2020-03-25D,Race(7),,
1,0,0,0,0,0,0,0,0,0,0,0,0,0,0,0,0,23,23,0.0,M2020-03-25D,Race(7),,
10,0,0,0,0,1,0,0,1,0,0,0,0,1,0,0,1,61,61,0.0,M2020-03-25D,Race(8),,
12,0,0,0,0,0,0,0,0,0,0,1,1,0,0,1,1,23,23,0.0,M2020-03-25D,Race(8),,
8,5,2,13,20,3,15,5,23,4,5,9,18,12,22,27,61,6.5,6.5,0.0,M2020-03-25D,Race(8),,
11,0,0,0,0,0,0,0,0,0,0,0,0,0,0,0,0,12,12,0.0,M2020-03-25D,Race(8),,
6,21,7,0,28,22,6,2,30,14,7,2,23,57,20,4,81,2.4,2.35,0.0,M2020-03-25D,Race(8),,
5,0,0,0,0,0,0,1,1,0,1,0,1,0,1,1,2,21,20,0.0,M2020-03-25D,Race(8),,
4,0,0,3,3,0,0,0,0,0,0,0,0,0,0,3,3,23,23,0.0,M2020-03-25D,Race(8),,
3,2,11,5,18,0,4,6,10,1,4,3,8,3,19,14,36,5.5,5.5,1.0,M2020-03-25D,Race(8),,
1,0,0,3,3,0,1,1,2,0,2,1,3,0,3,5,8,17,17,2.0,M2020-03-25D,Race(8),,
2,0,0,0,0,0,1,0,1,2,1,1,4,2,2,1,5,23,23,0.0,M2020-03-25D,Race(8),,
9,0,0,0,0,1,0,0,1,2,0,0,2,3,0,0,3,23,23,0.0,M2020-03-25D,Race(8),,
7,2,10,6,18,3,3,15,21,3,6,9,18,8,19,30,57,7.5,7.5,3.0,M2020-03-25D,Race(8),,
6,2,2,3,7,0,9,13,22,0,7,9,16,2,18,25,45,7.5,8,0.0,M2020-03-29D,Race(1),,
11,0,5,8,13,0,2,1,3,1,0,1,2,1,7,10,18,10,9,0.0,M2020-03-29D,Race(1),,
12,0,0,0,0,0,0,0,0,0,0,0,0,0,0,0,0,151,101,0.0,M2020-03-29D,Race(1),,
13,0,0,2,2,0,0,0,0,0,0,1,1,0,0,3,3,21,21,1.0,M2020-03-29D,Race(1),,
14,0,0,0,0,0,0,0,0,0,1,0,1,0,1,0,1,51,41,0.0,M2020-03-29D,Race(1),,
8,0,3,3,6,0,0,0,0,0,0,0,0,0,3,3,6,9.5,10,3.0,M2020-03-29D,Race(1),,
7,2,0,0,2,2,0,0,2,2,0,0,2,6,0,0,6,26,26,0.0,M2020-03-29D,Race(1),,
9,0,0,0,0,0,0,0,0,0,0,0,0,0,0,0,0,61,51,0.0,M2020-03-29D,Race(1),,
5,0,0,2,2,0,0,2,2,1,0,2,3,1,0,6,7,26,25,0.0,M2020-03-29D,Race(1),,
4,8,5,0,13,0,3,6,9,1,2,6,9,9,10,12,31,9,9,2.0,M2020-03-29D,Race(1),,
3,0,9,0,9,10,3,3,16,5,7,0,12,15,19,3,37,9,9,0.0,M2020-03-29D,Race(1),,
10,0,0,6,6,0,3,3,6,0,4,3,7,0,7,12,19,16,15,0.0,M2020-03-29D,Race(1),,
1,18,6,6,30,18,10,2,30,16,5,3,24,52,21,11,84,2.1,2.05,0.0,M2020-03-29D,Race(1),,
2,0,0,0,0,0,0,0,0,0,0,1,1,0,0,1,1,41,41,0.0,M2020-03-29D,Race(1),,
6,0,0,3,3,0,0,0,0,0,0,0,0,0,0,3,3,23,21,0.0,M2020-03-29D,Race(10),,
14,0,0,0,0,1,0,0,1,0,0,0,0,1,0,0,1,17,15,0.0,M2020-03-29D,Race(10),,
13,0,0,0,0,0,0,0,0,0,0,0,0,0,0,0,0,61,34,0.0,M2020-03-29D,Race(10),,
1,3,0,0,3,0,0,0,0,0,0,0,0,3,0,0,3,11,9,0.0,M2020-03-29D,Race(10),,
2,0,0,0,0,0,0,1,1,0,0,0,0,0,0,1,1,61,34,0.0,M2020-03-29D,Race(10),,
3,6,11,8,25,19,4,2,25,11,5,2,18,36,20,12,68,8,8,0.0,M2020-03-29D,Race(10),,
12,0,0,0,0,0,0,1,1,0,0,0,0,0,0,1,1,14,17,1.0,M2020-03-29D,Race(10),,
10,0,3,7,10,2,1,3,6,5,1,7,13,7,5,17,29,7,6.5,3.0,M2020-03-29D,Race(10),,
9,3,0,0,3,0,0,1,1,1,0,0,1,4,0,1,5,12,11,0.0,M2020-03-29D,Race(10),,
8,0,0,2,2,0,0,0,0,0,0,0,0,0,0,2,2,9.5,8,0.0,M2020-03-29D,Race(10),,
7,8,5,4,17,5,10,11,26,4,6,11,21,17,21,26,64,6,6,2.0,M2020-03-29D,Race(10),,
4,0,0,0,0,0,0,0,0,0,0,0,0,0,0,0,0,19,15,0.0,M2020-03-29D,Race(10),,
5,10,11,6,27,3,15,11,29,5,14,6,25,18,40,23,81,3.9,4,0.0,M2020-03-29D,Race(10),,
11,0,0,0,0,0,0,0,0,0,0,0,0,0,0,0,0,61,41,0.0,M2020-03-29D,Race(10),,
1,0,0,0,0,0,1,1,2,1,0,2,3,1,1,3,5,18,17,0.0,M2020-03-29D,Race(2),,
3,7,8,10,25,15,4,10,29,11,8,2,21,33,20,22,75,3.2,3,1.0,M2020-03-29D,Race(2),,
6,0,0,2,2,0,9,3,12,0,0,5,5,0,9,10,19,12,15,0.0,M2020-03-29D,Race(2),,
2,2,6,0,8,0,0,1,1,0,1,0,1,2,7,1,10,21,17,0.0,M2020-03-29D,Race(2),,
8,0,0,0,0,0,0,0,0,0,0,0,0,0,0,0,0,34,34,0.0,M2020-03-29D,Race(2),,
13,0,0,2,2,0,1,1,2,0,1,3,4,0,2,6,8,26,26,0.0,M2020-03-29D,Race(2),,
12,0,0,0,0,0,0,0,0,0,0,0,0,0,0,0,0,41,41,0.0,M2020-03-29D,Race(2),,
11,2,0,0,2,1,1,2,4,2,2,2,6,5,3,4,12,13,11,2.0,M2020-03-29D,Race(2),,
9,2,4,2,8,0,1,2,3,1,2,1,4,3,7,5,15,8,8,0.0,M2020-03-29D,Race(2),,
7,0,0,3,3,0,1,0,1,0,2,0,2,0,3,3,6,51,51,0.0,M2020-03-29D,Race(2),,
4,8,8,5,21,0,1,7,8,0,0,5,5,8,9,17,34,4.8,5,3.0,M2020-03-29D,Race(2),,
5,9,4,6,19,14,10,2,26,11,8,2,21,34,22,10,66,5,5,0.0,M2020-03-29D,Race(2),,
14,0,0,0,0,0,0,0,0,0,0,0,0,0,0,0,0,71,61,0.0,M2020-03-29D,Race(2),,
10,0,0,0,0,0,1,1,2,0,2,4,6,0,3,5,8,20,21,0.0,M2020-03-29D,Race(2),,
4,0,0,0,0,0,0,0,0,0,0,0,0,0,0,0,0,41,41,0.0,M2020-03-29D,Race(3),,
9,19,11,0,30,20,7,2,29,15,7,3,25,54,25,5,84,1.75,1.65,1.0,M2020-03-29D,Race(3),,
1,0,2,3,5,1,1,6,8,2,0,7,9,3,3,16,22,18,20,0.0,M2020-03-29D,Race(3),,
2,6,5,17,28,2,6,15,23,3,9,8,20,11,20,40,71,7.5,8,0.0,M2020-03-29D,Race(3),,
3,5,10,10,25,6,16,5,27,6,9,4,19,17,35,19,71,3.4,3.5,2.0,M2020-03-29D,Race(3),,
6,0,0,0,0,0,0,0,0,0,0,0,0,0,0,0,0,126,101,0.0,M2020-03-29D,Race(3),,
7,0,0,0,0,1,0,1,2,0,0,2,2,1,0,3,4,61,51,3.0,M2020-03-29D,Race(3),,
5,0,0,0,0,0,0,1,1,0,0,1,1,0,0,2,2,23,26,0.0,M2020-03-29D,Race(3),,
10,0,0,0,0,0,0,0,0,0,1,0,1,0,1,0,1,71,61,0.0,M2020-03-29D,Race(3),,
11,0,0,0,0,0,0,0,0,0,0,1,1,0,0,1,1,126,101,0.0,M2020-03-29D,Race(3),,
12,0,2,0,2,0,0,0,0,0,0,0,0,0,2,0,2,14,13,0.0,M2020-03-29D,Race(3),,
8,0,0,0,0,0,0,0,0,0,0,0,0,0,0,0,0,26,26,0.0,M2020-03-29D,Race(3),,
13,0,3,5,8,8,8,6,22,3,8,5,16,11,19,16,46,7,91,0.0,M2020-03-29D,Race(4),,
5,4,2,3,9,1,1,3,5,3,0,2,5,8,3,8,19,14,13,0.0,M2020-03-29D,Race(4),,
9,0,0,0,0,0,1,1,2,0,2,1,3,0,3,2,5,10,9,0.0,M2020-03-29D,Race(4),,
2,0,0,0,0,0,0,0,0,0,0,0,0,0,0,0,0,101,91,0.0,M2020-03-29D,Race(4),,
14,0,0,2,2,0,0,0,0,0,0,1,1,0,0,3,3,101,91,0.0,M2020-03-29D,Race(4),,
12,3,2,5,10,1,1,8,10,1,2,1,4,5,5,14,24,5,7.5,2.0,M2020-03-29D,Race(4),,
1,3,6,5,14,1,0,3,4,1,0,6,7,5,6,14,25,12,11,3.0,M2020-03-29D,Race(4),,
10,5,2,0,7,0,0,3,3,1,0,5,6,6,2,8,16,8.5,23,1.0,M2020-03-29D,Race(4),,
8,13,10,0,23,18,11,0,29,16,7,2,25,47,28,2,77,3.1,11,0.0,M2020-03-29D,Race(4),,
7,0,0,3,3,0,2,0,2,0,0,0,0,0,2,3,5,21,21,0.0,M2020-03-29D,Race(4),,
6,0,0,2,2,0,0,1,1,0,3,1,4,0,3,4,7,20,7,0.0,M2020-03-29D,Race(4),,
4,2,0,2,4,0,4,5,9,1,3,2,6,3,7,9,19,14,13,0.0,M2020-03-29D,Race(4),,
11,0,2,0,2,1,2,0,3,0,1,0,1,1,5,0,6,31,56,0.0,M2020-03-29D,Race(4),,
3,0,3,3,6,0,0,0,0,0,0,0,0,0,3,3,6,26,23,0.0,M2020-03-29D,Race(4),,
10,0,3,0,3,0,2,0,2,0,4,0,4,0,9,0,9,11,11,0.0,M2020-03-29D,Race(5),,
6,4,0,6,10,0,3,17,20,0,3,10,13,4,6,33,43,11,11,2.0,M2020-03-29D,Race(5),,
2,5,16,2,23,2,1,6,9,4,3,3,10,11,20,11,42,5.5,5.5,1.0,M2020-03-29D,Race(5),,
1,0,0,0,0,0,0,0,0,0,0,0,0,0,0,0,0,34,34,0.0,M2020-03-29D,Race(5),,
11,0,0,0,0,0,0,0,0,0,0,1,1,0,0,1,1,61,61,0.0,M2020-03-29D,Race(5),,
3,0,0,6,6,0,0,0,0,0,0,0,0,0,0,6,6,34,34,0.0,M2020-03-29D,Race(5),,
12,0,3,7,10,0,2,1,3,0,1,3,4,0,6,11,17,11,11,3.0,M2020-03-29D,Race(5),,
5,21,4,3,28,18,12,0,30,18,6,2,26,57,22,5,84,1.95,1.95,0.0,M2020-03-29D,Race(5),,
14,0,0,3,3,0,0,0,0,0,0,0,0,0,0,3,3,13,13,0.0,M2020-03-29D,Race(5),,
7,0,4,3,7,0,0,0,0,1,1,0,2,1,5,3,9,15,15,0.0,M2020-03-29D,Race(5),,
8,0,0,0,0,0,0,0,0,0,0,0,0,0,0,0,0,51,51,0.0,M2020-03-29D,Race(5),,
9,0,0,0,0,0,0,0,0,0,0,0,0,0,0,0,0,34,34,0.0,M2020-03-29D,Race(5),,
4,0,0,0,0,0,0,1,1,0,0,1,1,0,0,2,2,51,51,0.0,M2020-03-29D,Race(5),,
13,0,0,0,0,0,0,0,0,0,0,0,0,0,0,0,0,34,34,0.0,M2020-03-29D,Race(5),,
13,2,2,0,4,1,2,14,17,2,3,6,11,5,7,20,32,4.8,4.4,3.0,M2020-03-29D,Race(6),,
14,0,0,3,3,0,0,0,0,0,0,0,0,0,0,3,3,16,14,0.0,M2020-03-29D,Race(6),,
11,0,0,0,0,0,0,0,0,0,0,0,0,0,0,0,0,51,61,0.0,M2020-03-29D,Race(6),,
10,0,0,0,0,0,0,0,0,0,0,0,0,0,0,0,0,51,61,0.0,M2020-03-29D,Race(6),,
1,25,5,0,30,16,12,2,30,16,7,3,26,57,24,5,86,3.3,3.3,1.0,M2020-03-29D,Race(6),,
2,3,15,8,26,12,11,1,24,5,11,4,20,20,37,13,70,4.8,4.4,0.0,M2020-03-29D,Race(6),,
3,0,2,7,9,1,2,6,9,3,3,5,11,4,7,18,29,12,11,0.0,M2020-03-29D,Race(6),,
4,0,3,0,3,0,0,5,5,0,0,5,5,0,3,10,13,14,11,2.0,M2020-03-29D,Race(6),,
5,0,0,0,0,0,0,0,0,0,0,0,0,0,0,0,0,51,34,0.0,M2020-03-29D,Race(6),,
12,0,0,0,0,0,0,1,1,0,0,0,0,0,0,1,1,26,34,0.0,M2020-03-29D,Race(6),,
6,0,0,0,0,0,0,0,0,0,0,0,0,0,0,0,0,91,91,0.0,M2020-03-29D,Race(6),,
7,0,0,0,0,0,1,1,2,0,2,2,4,0,3,3,6,34,26,0.0,M2020-03-29D,Race(6),,
8,0,3,12,15,0,2,0,2,0,0,1,1,0,5,13,18,10,9,0.0,M2020-03-29D,Race(6),,
9,0,0,0,0,0,0,0,0,0,0,0,0,0,0,0,0,16,14,0.0,M2020-03-29D,Race(6),,
13,14,10,3,27,12,7,3,22,13,7,4,24,39,24,10,73,4,4,1.0,M2020-03-29D,Race(7),,
14,0,0,0,0,0,0,0,0,0,0,1,1,0,0,1,1,34,34,0.0,M2020-03-29D,Race(7),,
9,0,0,0,0,0,0,0,0,0,0,0,0,0,0,0,0,51,51,0.0,M2020-03-29D,Race(7),,
12,0,0,0,0,0,0,0,0,0,0,0,0,0,0,0,0,17,17,0.0,M2020-03-29D,Race(7),,
7,0,3,8,11,2,2,14,18,4,2,5,11,6,7,27,40,6,6,0.0,M2020-03-29D,Race(7),,
11,0,0,0,0,0,0,0,0,0,0,0,0,0,0,0,0,91,91,0.0,M2020-03-29D,Race(7),,
6,0,3,4,7,0,2,2,4,0,1,3,4,0,6,9,15,9,9,2.0,M2020-03-29D,Race(7),,
1,0,0,0,0,0,0,0,0,0,0,0,0,0,0,0,0,91,91,0.0,M2020-03-29D,Race(7),,
4,3,5,5,13,12,3,2,17,4,6,5,15,19,14,12,45,11,11,0.0,M2020-03-29D,Race(7),,
10,0,0,0,0,0,0,0,0,0,0,0,0,0,0,0,0,21,21,0.0,M2020-03-29D,Race(7),,
5,0,2,2,4,0,0,0,0,1,1,0,2,1,3,2,6,6.5,6.5,0.0,M2020-03-29D,Race(7),,
3,3,0,0,3,0,0,0,0,0,0,0,0,3,0,0,3,61,61,0.0,M2020-03-29D,Race(7),,
8,7,4,3,14,3,14,4,21,4,7,5,16,14,25,12,51,5,5,3.0,M2020-03-29D,Race(7),,
2,3,3,5,11,1,2,5,8,0,2,3,5,4,7,13,24,6.5,6.5,0.0,M2020-03-29D,Race(7),,
11,0,0,0,0,0,0,0,0,0,0,0,0,0,0,0,0,91,6,0.0,M2020-03-29D,Race(8),,
12,0,2,3,5,2,12,6,20,2,6,6,14,4,20,15,39,6.5,4,1.0,M2020-03-29D,Race(8),,
13,4,5,5,14,2,3,15,20,5,6,6,17,11,14,26,51,4.2,9,0.0,M2020-03-29D,Race(8),,
14,5,0,2,7,1,1,0,2,1,1,0,2,7,2,2,11,9,9,0.0,M2020-03-29D,Race(8),,
2,0,3,0,3,0,0,1,1,0,0,3,3,0,3,4,7,14,13,0.0,M2020-03-29D,Race(8),,
4,6,6,2,14,10,7,2,19,6,5,1,12,22,18,5,45,4.2,5,2.0,M2020-03-29D,Race(8),,
5,0,0,0,0,0,0,0,0,0,0,0,0,0,0,0,0,81,61,0.0,M2020-03-29D,Race(8),,
6,0,3,6,9,2,1,0,3,3,4,0,7,5,8,6,19,10,10,0.0,M2020-03-29D,Race(8),,
7,0,0,2,2,0,0,0,0,0,0,0,0,0,0,2,2,81,61,0.0,M2020-03-29D,Race(8),,
8,0,0,0,0,0,0,0,0,0,0,0,0,0,0,0,0,126,101,0.0,M2020-03-29D,Race(8),,
9,0,0,0,0,0,0,0,0,0,0,0,0,0,0,0,0,91,101,0.0,M2020-03-29D,Race(8),,
10,0,0,0,0,0,0,0,0,0,0,2,2,0,0,2,2,34,34,0.0,M2020-03-29D,Race(8),,
1,13,9,6,28,13,2,5,20,8,0,7,15,34,11,18,63,4.4,3,3.0,M2020-03-29D,Race(8),,
3,2,2,4,8,0,4,1,5,1,4,1,6,3,10,6,19,11,10,0.0,M2020-03-29D,Race(8),,
14,0,0,0,0,0,0,0,0,0,0,0,0,0,0,0,0,51,41,0.0,M2020-03-29D,Race(9),,
2,5,0,0,5,0,2,0,2,0,1,0,1,5,3,0,8,14,17,3.0,M2020-03-29D,Race(9),,
3,0,0,0,0,0,0,0,0,0,0,0,0,0,0,0,0,26,17,0.0,M2020-03-29D,Race(9),,
4,14,9,0,23,17,4,4,25,7,4,8,19,38,17,12,67,3.7,3.8,1.0,M2020-03-29D,Race(9),,
5,0,3,8,11,1,3,4,8,1,5,0,6,2,11,12,25,8.5,8,0.0,M2020-03-29D,Race(9),,
6,0,0,0,0,1,1,0,2,0,0,0,0,1,1,0,2,18,21,2.0,M2020-03-29D,Race(9),,
7,0,4,13,17,8,8,5,21,11,3,5,19,19,15,23,57,8,6,0.0,M2020-03-29D,Race(9),,
8,0,2,0,2,0,1,0,1,1,2,0,3,1,5,0,6,34,21,0.0,M2020-03-29D,Race(9),,
9,0,0,0,0,2,1,8,11,5,2,0,7,7,3,8,18,10,8,0.0,M2020-03-29D,Race(9),,
10,0,3,0,3,0,3,2,5,1,4,2,7,1,10,4,15,10,9,0.0,M2020-03-29D,Race(9),,
11,0,0,2,2,0,0,1,1,0,0,5,5,0,0,8,8,19,21,0.0,M2020-03-29D,Race(9),,
12,0,0,0,0,0,0,0,0,0,0,0,0,0,0,0,0,61,61,0.0,M2020-03-29D,Race(9),,
1,4,3,0,7,1,2,2,5,0,0,2,2,5,5,4,14,14,14,0.0,M2020-03-29D,Race(9),,
13,7,6,7,20,0,5,4,9,0,5,4,9,7,16,15,38,4.6,5,0.0,M2020-03-29D,Race(9),,
1,0,0,0,0,0,1,0,1,1,2,0,3,1,3,0,4,21,20,3.0,M2020-04-12D,Race(1),,
6,15,10,3,28,12,6,6,24,4,5,6,15,31,21,15,67,2.8,2.6,0.0,M2020-04-12D,Race(1),,
5,5,3,17,25,0,3,7,10,0,5,6,11,5,11,30,46,5.5,5,1.0,M2020-04-12D,Race(1),,
4,8,10,3,21,16,11,3,30,16,4,5,25,40,25,11,76,2.9,2.6,2.0,M2020-04-12D,Race(1),,
3,2,7,7,16,2,9,13,24,4,10,7,21,8,26,27,61,4.4,4,0.0,M2020-04-12D,Race(1),,
2,0,0,0,0,0,0,1,1,1,0,2,3,1,0,3,4,41,41,0.0,M2020-04-12D,Race(1),,
13,11,11,5,27,13,2,0,15,12,4,1,17,36,17,6,59,2.65,2.6,1.0,M2020-04-12D,Race(10),2.7,2.6
3,0,2,0,2,0,0,0,0,1,0,0,1,1,2,0,3,26,26,0.0,M2020-04-12D,Race(10),26,23
6,0,0,3,3,0,1,2,3,0,1,1,2,0,2,6,8,18,18,0.0,M2020-04-12D,Race(10),18,19
9,3,4,15,22,2,12,1,15,3,4,2,9,8,20,18,46,5.5,5.5,0.0,M2020-04-12D,Race(10),4.8,4.5
8,0,0,0,0,0,0,0,0,0,1,0,1,0,1,0,1,71,81,0.0,M2020-04-12D,Race(10),61,61
7,0,0,0,0,0,0,0,0,0,0,2,2,0,0,2,2,17,16,0.0,M2020-04-12D,Race(10),18,20
1,0,0,0,0,0,0,0,0,0,0,0,0,0,0,0,0,91,101,0.0,M2020-04-12D,Race(10),101,101
5,5,8,5,18,11,6,4,21,5,7,4,16,21,21,13,55,8.5,8.5,0.0,M2020-04-12D,Race(10),9,9.5
4,0,0,0,0,2,1,12,15,1,1,6,8,3,2,18,23,19,20,0.0,M2020-04-12D,Race(10),18,17
10,0,0,0,0,0,0,1,1,0,0,0,0,0,0,1,1,16,16,0.0,M2020-04-12D,Race(10),18,20
11,8,2,2,12,1,8,9,18,2,8,9,19,11,18,20,49,7.5,7.5,3.0,M2020-04-12D,Race(10),7.5,7
2,3,3,0,6,1,0,1,2,2,0,1,3,6,3,2,11,7,6.5,2.0,M2020-04-12D,Race(10),7,8
12,0,0,0,0,0,0,0,0,0,0,0,0,0,0,0,0,126,151,0.0,M2020-04-12D,Race(10),101,101
14,0,0,0,0,0,0,0,0,0,0,0,0,0,0,0,0,51,61,0.0,M2020-04-12D,Race(10),51,51
6,0,2,0,2,0,0,0,0,0,0,0,0,0,2,0,2,23,23,0.0,M2020-04-12D,Race(11),26,26
11,4,2,3,9,1,1,10,12,2,3,3,8,7,6,16,29,12,11,0.0,M2020-04-12D,Race(11),9,10
10,0,0,0,0,1,0,2,3,1,0,2,3,2,0,4,6,26,27,0.0,M2020-04-12D,Race(11),31,31
9,0,0,0,0,0,0,0,0,0,1,0,1,0,1,0,1,34,31,0.0,M2020-04-12D,Race(11),51,35
8,0,0,7,7,1,0,5,6,2,0,8,10,3,0,20,23,6.5,8,0.0,M2020-04-12D,Race(11),8.5,9
7,0,0,0,0,0,0,0,0,0,0,0,0,0,0,0,0,51,51,0.0,M2020-04-12D,Race(11),61,51
13,0,0,2,2,0,0,2,2,0,2,2,4,0,2,6,8,23,23,0.0,M2020-04-12D,Race(11),23,23
14,0,0,0,0,0,0,0,0,0,0,0,0,0,0,0,0,8.5,8,1.0,M2020-04-12D,Race(11),8,7.5
4,9,5,6,20,7,10,3,20,3,5,5,13,19,20,14,53,5.5,5.5,0.0,M2020-04-12D,Race(11),4.8,5.5
3,6,9,4,19,10,4,5,19,9,9,2,20,25,22,11,58,5,4.6,3.0,M2020-04-12D,Race(11),4.4,4.5
1,11,7,8,26,7,15,1,23,8,5,3,16,26,27,12,65,4.4,4.2,2.0,M2020-04-12D,Race(11),4.6,4.4
12,0,3,0,3,0,0,0,0,0,0,0,0,0,3,0,3,21,23,0.0,M2020-04-12D,Race(11),31,26
2,0,0,0,0,0,0,1,1,1,0,1,2,1,0,2,3,18,20,0.0,M2020-04-12D,Race(11),21,21
5,0,2,0,2,1,0,1,2,0,1,0,1,1,3,1,5,19,20,0.0,M2020-04-12D,Race(11),19,18
3,0,0,0,0,0,0,0,0,0,0,1,1,0,0,1,1,101,101,0.0,M2020-04-12D,Race(2),,
10,0,0,0,0,0,0,0,0,0,0,0,0,0,0,0,0,26,31,0.0,M2020-04-12D,Race(2),,
6,0,3,0,3,0,0,1,1,0,1,0,1,0,4,1,5,15,15,1.0,M2020-04-12D,Race(2),,
5,0,0,0,0,0,0,0,0,0,0,0,0,0,0,0,0,51,51,0.0,M2020-04-12D,Race(2),,
4,0,2,0,2,1,1,0,2,1,0,0,1,2,3,0,5,26,27,0.0,M2020-04-12D,Race(2),,
9,3,0,2,5,1,2,3,6,2,3,3,8,6,5,8,19,8,7.5,2.0,M2020-04-12D,Race(2),,
13,0,2,10,12,1,1,1,3,1,0,3,4,2,3,14,19,6.5,6,0.0,M2020-04-12D,Race(2),,
7,10,2,6,18,3,3,5,11,3,5,4,12,16,10,15,41,13,12,0.0,M2020-04-12D,Race(2),,
1,8,2,2,12,15,4,4,23,6,4,5,15,29,10,11,50,5.5,5.5,0.0,M2020-04-12D,Race(2),,
14,0,0,0,0,0,0,0,0,0,0,0,0,0,0,0,0,81,81,0.0,M2020-04-12D,Race(2),,
8,0,6,2,8,0,1,2,3,5,1,3,9,5,8,7,20,12,12,0.0,M2020-04-12D,Race(2),,
12,7,11,0,18,5,14,2,21,4,5,4,13,16,30,6,52,3.6,3.5,3.0,M2020-04-12D,Race(2),,
11,2,2,8,12,4,3,12,19,4,6,3,13,10,11,23,44,11,10,0.0,M2020-04-12D,Race(2),,
2,0,0,0,0,0,1,0,1,0,1,0,1,0,2,0,2,10,10,0.0,M2020-04-12D,Race(2),,
12,2,2,0,4,1,0,1,2,0,0,3,3,3,2,4,9,10,9.5,0.0,M2020-04-12D,Race(3),9.5,9.5
11,0,0,2,2,2,1,1,4,3,2,3,8,5,3,6,14,10,9.5,0.0,M2020-04-12D,Race(3),10,10
2,0,0,0,0,1,2,1,4,0,1,0,1,1,3,1,5,31,31,0.0,M2020-04-12D,Race(3),34,34
10,0,0,0,0,0,0,0,0,0,1,0,1,0,1,0,1,41,51,0.0,M2020-04-12D,Race(3),51,51
9,0,0,3,3,0,0,0,0,0,0,0,0,0,0,3,3,21,21,0.0,M2020-04-12D,Race(3),21,21
8,0,0,0,0,0,0,0,0,0,0,0,0,0,0,0,0,19,19,0.0,M2020-04-12D,Race(3),21,21
7,0,0,0,0,0,1,1,2,0,1,0,1,0,2,1,3,41,46,0.0,M2020-04-12D,Race(3),34,34
6,0,0,0,0,0,0,0,0,2,0,0,2,2,0,0,2,34,41,0.0,M2020-04-12D,Race(3),41,41
5,7,2,14,23,1,6,12,19,3,9,2,14,11,17,28,56,6,6,1.0,M2020-04-12D,Race(3),6.5,6.5
4,3,8,2,13,1,0,3,4,0,2,5,7,4,10,10,24,7,7,3.0,M2020-04-12D,Race(3),7.5,7.5
3,11,12,7,30,16,9,3,28,9,8,6,23,36,29,16,81,3.8,3.8,2.0,M2020-04-12D,Race(3),3.2,3.2
13,0,0,0,0,0,0,0,0,0,0,0,0,0,0,0,0,101,101,0.0,M2020-04-12D,Race(3),101,101
1,7,6,2,15,8,12,7,27,9,2,5,16,24,20,14,58,4.6,4.5,0.0,M2020-04-12D,Race(3),5,5
14,0,0,0,0,0,0,1,1,0,0,2,2,0,0,3,3,13,12,0.0,M2020-04-12D,Race(3),13,13
4,7,8,10,25,1,12,8,21,0,1,11,12,8,21,29,58,7.5,7.5,0.0,M2020-04-12D,Race(4),8.5,8.5
5,0,0,6,6,1,2,11,14,0,3,3,6,1,5,20,26,8,8,2.0,M2020-04-12D,Race(4),9,9
6,0,0,0,0,0,0,0,0,0,0,0,0,0,0,0,0,,,0.0,M2020-04-12D,Race(4),,
8,2,0,5,7,0,3,0,3,0,4,0,4,2,7,5,14,7.5,7,0.0,M2020-04-12D,Race(4),9.5,10
9,0,0,0,0,0,0,0,0,0,0,0,0,0,0,0,0,61,71,0.0,M2020-04-12D,Race(4),91,101
7,0,0,0,0,0,0,0,0,0,0,2,2,0,0,2,2,12,12,0.0,M2020-04-12D,Race(4),13,14
11,0,5,0,5,0,0,2,2,0,0,3,3,0,5,5,10,18,18,0.0,M2020-04-12D,Race(4),13,13
12,0,0,0,0,0,1,0,1,0,1,0,1,0,2,0,2,26,31,0.0,M2020-04-12D,Race(4),26,31
2,15,8,4,27,19,1,2,22,20,5,0,25,54,14,6,74,2.25,2.25,1.0,M2020-04-12D,Race(4),2.1,2.05
1,3,9,3,15,9,10,4,23,5,10,2,17,17,29,9,55,6.5,6.5,3.0,M2020-04-12D,Race(4),5.5,5.5
10,0,0,0,0,0,1,0,1,0,2,1,3,0,3,1,4,34,26,0.0,M2020-04-12D,Race(4),34,41
3,3,0,2,5,0,0,3,3,1,0,4,5,4,0,9,13,17,18,0.0,M2020-04-12D,Race(4),19,21
2,2,6,6,14,17,6,3,26,10,8,1,19,29,20,10,59,14,15,0.0,M2020-04-12D,Race(5),14,13
7,0,0,0,0,0,0,0,0,0,0,0,0,0,0,0,0,34,41,0.0,M2020-04-12D,Race(5),31,23
13,2,0,3,5,4,0,11,15,3,2,4,9,9,2,18,29,8.5,8,0.0,M2020-04-12D,Race(5),7.5,7.5
12,13,7,3,23,0,1,1,2,0,2,4,6,13,10,8,31,5.5,5.5,1.0,M2020-04-12D,Race(5),6,6
11,0,0,0,0,0,0,0,0,0,0,0,0,0,0,0,0,34,41,0.0,M2020-04-12D,Race(5),41,41
10,0,0,0,0,0,0,0,0,0,0,1,1,0,0,1,1,26,26,3.0,M2020-04-12D,Race(5),23,23
9,0,0,0,0,0,1,0,1,0,3,0,3,0,4,0,4,34,41,0.0,M2020-04-12D,Race(5),34,41
8,0,5,0,5,0,2,0,2,0,2,0,2,0,9,0,9,23,26,0.0,M2020-04-12D,Race(5),26,26
6,0,2,0,2,2,1,0,3,2,0,1,3,4,3,1,8,21,21,0.0,M2020-04-12D,Race(5),21,23
5,0,6,6,12,4,12,3,19,4,2,2,8,8,20,11,39,4.8,4.6,2.0,M2020-04-12D,Race(5),4.6,4.2
4,3,0,4,7,0,1,1,2,0,0,2,2,3,1,7,11,19,20,0.0,M2020-04-12D,Race(5),20,20
1,0,0,0,0,1,2,2,5,1,1,3,5,2,3,5,10,16,17,0.0,M2020-04-12D,Race(5),15,15
3,3,2,0,5,2,0,5,7,4,0,4,8,9,2,9,20,6,5.5,0.0,M2020-04-12D,Race(5),6.5,6.5
14,7,2,8,17,0,4,4,8,2,6,4,12,9,12,16,37,4.8,4.8,0.0,M2020-04-12D,Race(5),4.8,4.8
5,20,3,5,28,15,15,0,30,10,14,1,25,45,32,6,83,1.8,1.75,0.0,M2020-04-12D,Race(6),1.75,1.75
2,0,5,0,5,0,1,2,3,1,1,3,5,1,7,5,13,10,10,0.0,M2020-04-12D,Race(6),12,12
9,0,0,0,0,0,0,1,1,0,0,2,2,0,0,3,3,11,11,0.0,M2020-04-12D,Race(6),15,15
3,0,0,0,0,0,0,0,0,0,0,0,0,0,0,0,0,31,31,2.0,M2020-04-12D,Race(6),51,51
7,0,0,0,0,0,0,0,0,0,0,0,0,0,0,0,0,34,41,0.0,M2020-04-12D,Race(6),31,31
8,2,2,0,4,0,0,0,0,0,0,0,0,2,2,0,4,23,26,0.0,M2020-04-12D,Race(6),19,19
11,0,0,0,0,0,0,1,1,0,0,0,0,0,0,1,1,19,19,0.0,M2020-04-12D,Race(6),18,18
12,0,0,0,0,0,0,0,0,0,0,0,0,0,0,0,0,91,91,0.0,M2020-04-12D,Race(6),101,101
6,0,0,0,0,1,0,0,1,2,0,2,4,3,0,2,5,16,16,3.0,M2020-04-12D,Race(6),34,34
1,8,11,11,30,13,9,6,28,10,7,5,22,31,27,22,80,6,6,1.0,M2020-04-12D,Race(6),6,6
4,0,9,10,19,1,4,18,23,3,4,7,14,4,17,35,56,12,12,0.0,M2020-04-12D,Race(6),13,13
10,0,0,4,4,0,1,2,3,0,0,6,6,0,1,12,13,21,21,0.0,M2020-04-12D,Race(6),31,31
2,0,0,0,0,0,0,0,0,0,0,0,0,0,0,0,0,41,51,0.0,M2020-04-12D,Race(7),51,51
3,0,11,3,14,2,4,4,10,3,1,3,7,5,16,10,31,9,9.5,0.0,M2020-04-12D,Race(7),9,9
8,7,5,0,12,5,0,10,15,5,2,3,10,17,7,13,37,7.5,6,2.0,M2020-04-12D,Race(7),7,7.5
11,0,0,0,0,0,0,0,0,1,0,0,1,1,0,0,1,26,31,0.0,M2020-04-12D,Race(7),34,41
12,0,0,0,0,0,0,0,0,0,0,0,0,0,0,0,0,101,126,0.0,M2020-04-12D,Race(7),81,81
1,0,0,0,0,0,0,0,0,0,0,0,0,0,0,0,0,91,101,0.0,M2020-04-12D,Race(7),151,201
14,0,0,0,0,0,0,0,0,0,0,0,0,0,0,0,0,101,126,0.0,M2020-04-12D,Race(7),101,126
4,3,6,2,11,4,12,6,22,2,8,4,14,9,26,12,47,5,5.5,0.0,M2020-04-12D,Race(7),7,6.5
5,7,0,3,10,0,6,3,9,2,5,5,12,9,11,11,31,6.5,6.5,0.0,M2020-04-12D,Race(7),7,7.5
13,0,4,4,8,1,2,2,5,0,5,3,8,1,11,9,21,5.5,5,1.0,M2020-04-12D,Race(7),6,6
7,8,2,8,18,17,5,2,24,9,4,3,16,34,11,13,58,4.4,4.2,0.0,M2020-04-12D,Race(7),3,3
9,5,0,7,12,0,1,1,2,2,0,4,6,7,1,12,20,12,13,3.0,M2020-04-12D,Race(7),11,12
10,0,2,0,2,1,0,1,2,2,1,1,4,3,3,2,8,13,14,0.0,M2020-04-12D,Race(7),15,15
6,0,0,3,3,0,0,1,1,0,0,0,0,0,0,4,4,26,31,0.0,M2020-04-12D,Race(7),31,31
7,0,0,0,0,0,0,0,0,0,0,1,1,0,0,1,1,71,71,0.0,M2020-04-12D,Race(8),81,81
1,0,15,2,17,4,5,3,12,6,4,3,13,10,24,8,42,7.5,7,0.0,M2020-04-12D,Race(8),7,7
2,0,0,0,0,0,0,2,2,0,0,1,1,0,0,3,3,19,18,3.0,M2020-04-12D,Race(8),21,23
3,2,0,3,5,1,2,1,4,0,2,1,3,3,4,5,12,16,16,0.0,M2020-04-12D,Race(8),16,16
4,9,0,5,14,3,1,3,7,5,2,0,7,17,3,8,28,5.5,6,0.0,M2020-04-12D,Race(8),5.5,5
5,0,0,0,0,0,0,0,0,0,0,2,2,0,0,2,2,34,41,0.0,M2020-04-12D,Race(8),41,41
6,0,4,6,10,2,3,9,14,1,3,2,6,3,10,17,30,5,5,0.0,M2020-04-12D,Race(8),5,5
9,0,2,0,2,0,0,2,2,1,0,4,5,1,2,6,9,14,15,0.0,M2020-04-12D,Race(8),13,13
8,5,9,4,18,6,12,4,22,8,7,2,17,19,28,10,57,6.5,6,2.0,M2020-04-12D,Race(8),5.5,5
10,14,0,10,24,14,7,5,26,4,7,8,19,32,14,23,69,3.2,3,1.0,M2020-04-12D,Race(8),3.2,3.2
11,0,0,0,0,0,0,1,1,1,1,2,4,1,1,3,5,17,21,0.0,M2020-04-12D,Race(8),21,21
4,0,0,0,0,0,0,0,0,0,0,0,0,0,0,0,0,41,51,0.0,M2020-04-12D,Race(9),41,46
2,0,0,11,11,2,2,12,16,3,2,6,11,5,4,29,38,6,5.5,0.0,M2020-04-12D,Race(9),6,6
3,0,0,0,0,0,0,0,0,0,0,0,0,0,0,0,0,101,151,0.0,M2020-04-12D,Race(9),126,101
13,0,0,0,0,0,0,0,0,0,2,1,3,0,2,1,3,101,151,0.0,M2020-04-12D,Race(9),81,71
12,4,2,0,6,0,0,0,0,0,1,0,1,4,3,0,7,5.5,5.5,0.0,M2020-04-12D,Race(9),6.5,6.5
11,0,0,0,0,0,0,0,0,0,0,0,0,0,0,0,0,101,126,0.0,M2020-04-12D,Race(9),101,101
10,0,0,0,0,0,0,0,0,0,0,0,0,0,0,0,0,101,151,0.0,M2020-04-12D,Race(9),101,126
6,0,0,0,0,0,0,0,0,0,0,0,0,0,0,0,0,14,15,0.0,M2020-04-12D,Race(9),21,23
9,0,0,2,2,1,2,2,5,2,2,3,7,3,4,7,14,14,15,0.0,M2020-04-12D,Race(9),12,11
8,6,8,7,21,6,17,6,29,6,9,4,19,18,34,17,69,5,5,0.0,M2020-04-12D,Race(9),5.5,5.5
7,13,7,0,20,10,1,6,17,2,1,6,9,25,9,12,46,6,5.5,2.0,M2020-04-12D,Race(9),5.5,5
5,0,2,0,2,0,1,1,2,0,2,2,4,0,5,3,8,11,11,1.0,M2020-04-12D,Race(9),11,11
1,7,11,10,28,11,7,3,21,13,7,3,23,31,25,16,72,3.8,3.8,3.0,M2020-04-12D,Race(9),3.6,3.5
14,0,0,0,0,0,0,0,0,0,0,1,1,0,0,1,1,101,151,0.0,M2020-04-12D,Race(9),101,126
9,4,0,0,4,0,1,0,1,0,0,1,1,4,1,1,6,13,13,0.0,M2020-04-15D,Race(1),13,12
6,4,0,8,12,2,0,2,4,2,0,3,5,8,0,13,21,7.5,7.5,1.0,M2020-04-15D,Race(1),8.5,7.5
5,0,5,3,8,0,0,0,0,0,0,0,0,0,5,3,8,12,12,0.0,M2020-04-15D,Race(1),13,13
3,3,3,3,9,1,3,3,7,2,3,3,8,6,9,9,24,9.5,10,2.0,M2020-04-15D,Race(1),12,11
2,0,5,2,7,4,3,13,20,9,4,4,17,13,12,19,44,12,12,0.0,M2020-04-15D,Race(1),14,13
1,12,6,7,25,16,6,6,28,5,9,6,20,33,21,19,73,3.9,3.8,0.0,M2020-04-15D,Race(1),3.9,3.8
8,0,0,0,0,0,0,0,0,0,0,0,0,0,0,0,0,20,20,0.0,M2020-04-15D,Race(1),19,18
7,0,0,0,0,0,0,0,0,1,1,0,2,1,1,0,2,23,26,0.0,M2020-04-15D,Race(1),21,21
4,0,0,0,0,0,0,0,0,0,0,0,0,0,0,0,0,14,13,3.0,M2020-04-15D,Race(1),23,23
12,0,0,0,0,0,1,1,2,0,0,2,2,0,1,3,4,20,20,0.0,M2020-04-15D,Race(1),26,21
10,5,11,5,21,7,16,5,28,6,9,7,22,18,36,17,71,4.2,4,0.0,M2020-04-15D,Race(1),4.2,4
11,2,0,2,4,0,0,0,0,1,0,0,1,3,0,2,5,12,11,0.0,M2020-04-15D,Race(1),9.5,9.5
6,0,0,0,0,0,0,0,0,1,0,0,1,1,0,0,1,23,26,0.0,M2020-04-15D,Race(2),26,31
4,3,6,0,9,0,3,2,5,1,3,2,6,4,12,4,20,9,9.5,0.0,M2020-04-15D,Race(2),12,14
3,0,3,2,5,0,1,3,4,2,1,7,10,2,5,12,19,9.5,10,0.0,M2020-04-15D,Race(2),11,11
8,15,3,10,28,21,1,5,27,16,1,5,22,52,5,20,77,4.2,3.8,2.0,M2020-04-15D,Race(2),3.4,3.4
10,10,10,7,27,4,20,1,25,2,14,2,18,16,44,10,70,2.9,2.8,1.0,M2020-04-15D,Race(2),2.4,2.3
2,0,8,6,14,3,2,16,21,2,3,4,9,5,13,26,44,9,8.5,3.0,M2020-04-15D,Race(2),10,10
1,0,0,2,2,2,2,1,5,2,2,1,5,4,4,4,12,8.5,8.5,0.0,M2020-04-15D,Race(2),15,14
5,2,0,3,5,0,1,2,3,0,2,2,4,2,3,7,12,9.5,10,0.0,M2020-04-15D,Race(2),9.5,10
11,0,0,0,0,0,0,0,0,0,0,0,0,0,0,0,0,41,51,0.0,M2020-04-15D,Race(2),61,61
9,0,0,0,0,0,0,0,0,0,0,0,0,0,0,0,0,26,31,0.0,M2020-04-15D,Race(2),26,23
7,0,0,0,0,0,0,0,0,0,0,0,0,0,0,0,0,101,126,0.0,M2020-04-15D,Race(2),151,151
12,0,0,0,0,0,0,0,0,0,0,0,0,0,0,0,0,34,35,0.0,M2020-04-15D,Race(2),41,51
3,4,8,7,19,21,5,2,28,15,7,2,24,40,20,11,71,3,2.8,2.0,M2020-04-15D,Race(3),3.1,3
2,16,7,3,26,3,3,14,20,4,0,8,12,23,10,25,58,4.6,4.4,0.0,M2020-04-15D,Race(3),3.9,3.8
4,0,0,0,0,0,0,0,0,0,0,0,0,0,0,0,0,101,101,0.0,M2020-04-15D,Race(3),101,126
5,3,2,13,18,4,16,4,24,4,12,3,19,11,30,20,61,6,6,3.0,M2020-04-15D,Race(3),6.5,6.5
10,0,3,0,3,0,0,1,1,0,0,1,1,0,3,2,5,16,16,0.0,M2020-04-15D,Race(3),16,17
7,0,0,0,0,0,0,0,0,0,0,1,1,0,0,1,1,15,15,1.0,M2020-04-15D,Race(3),13,13
6,2,0,0,2,0,0,0,0,0,0,0,0,2,0,0,2,34,41,0.0,M2020-04-15D,Race(3),41,51
11,0,0,0,0,0,0,0,0,0,0,0,0,0,0,0,0,16,16,0.0,M2020-04-15D,Race(3),17,18
12,0,5,2,7,1,4,3,8,1,5,4,10,2,14,9,25,7,6.5,0.0,M2020-04-15D,Race(3),7,6.5
1,0,5,0,5,0,0,0,0,0,0,2,2,0,5,2,7,34,35,0.0,M2020-04-15D,Race(3),26,21
9,5,0,5,10,1,2,6,9,2,2,5,9,8,4,16,28,7.5,8,0.0,M2020-04-15D,Race(3),7.5,7.5
8,0,0,0,0,0,0,0,0,0,0,0,0,0,0,0,0,71,81,0.0,M2020-04-15D,Race(3),81,91
4,0,5,3,8,0,0,0,0,0,0,0,0,0,5,3,8,10,10,0.0,M2020-04-15D,Race(4),11,10
1,14,6,5,25,21,4,5,30,15,4,5,24,50,14,15,79,4.4,4.2,0.0,M2020-04-15D,Race(4),4.2,4.4
5,0,0,0,0,0,0,1,1,0,0,1,1,0,0,2,2,61,67,0.0,M2020-04-15D,Race(4),61,67
2,11,9,5,25,2,7,13,22,2,9,5,16,15,25,23,63,3,3.1,0.0,M2020-04-15D,Race(4),3,3
6,0,0,0,0,0,0,0,0,1,0,0,1,1,0,0,1,26,31,0.0,M2020-04-15D,Race(4),34,41
12,0,0,0,0,0,0,0,0,0,0,0,0,0,0,0,0,91,101,0.0,M2020-04-15D,Race(4),41,23
11,0,0,0,0,0,0,0,0,0,0,0,0,0,0,0,0,51,61,1.0,M2020-04-15D,Race(4),34,26
10,0,3,5,8,2,2,4,8,1,3,6,10,3,8,15,26,5,4.8,3.0,M2020-04-15D,Race(4),5,5
8,0,4,0,4,0,0,0,0,0,0,0,0,0,4,0,4,34,41,0.0,M2020-04-15D,Race(4),41,41
7,0,3,10,13,3,14,4,21,7,7,1,15,10,24,15,49,7,7,0.0,M2020-04-15D,Race(4),7.5,7.5
3,5,0,2,7,2,2,2,6,0,2,4,6,7,4,8,19,6.5,6.5,2.0,M2020-04-15D,Race(4),7,7
9,0,0,0,0,0,1,1,2,0,1,4,5,0,2,5,7,34,35,0.0,M2020-04-15D,Race(4),26,26
9,0,0,0,0,0,1,1,2,0,0,0,0,0,1,1,2,12,12,0.0,M2020-04-15D,Race(5),19,15
11,11,6,8,25,15,7,5,27,6,9,7,22,32,22,20,74,3.4,3.5,0.0,M2020-04-15D,Race(5),3.1,3
10,0,0,0,0,0,0,0,0,0,0,0,0,0,0,0,0,126,201,0.0,M2020-04-15D,Race(5),151,201
7,0,0,0,0,0,0,0,0,0,0,0,0,0,0,0,0,41,51,0.0,M2020-04-15D,Race(5),51,61
6,14,3,5,22,5,2,12,19,5,7,6,18,24,12,23,59,2.75,2.6,1.0,M2020-04-15D,Race(5),2.8,2.7
5,0,0,2,2,0,0,0,0,0,0,1,1,0,0,3,3,21,27,0.0,M2020-04-15D,Race(5),26,31
4,0,0,0,0,0,0,0,0,0,0,0,0,0,0,0,0,81,91,0.0,M2020-04-15D,Race(5),101,101
3,0,2,3,5,3,15,6,24,10,5,5,20,13,22,14,49,11,10,2.0,M2020-04-15D,Race(5),9.5,10
12,2,15,6,23,1,1,0,2,0,1,3,4,3,17,9,29,9,10,3.0,M2020-04-15D,Race(5),10,11
2,0,2,3,5,2,1,3,6,1,1,1,3,3,4,7,14,12,10,0.0,M2020-04-15D,Race(5),11,11
1,0,0,3,3,0,1,1,2,0,0,0,0,0,1,4,5,14,13,0.0,M2020-04-15D,Race(5),14,14
8,3,2,0,5,4,2,2,8,4,3,3,10,11,7,5,23,12,11,0.0,M2020-04-15D,Race(5),8.5,9
3,16,5,4,25,22,6,1,29,11,11,2,24,49,22,7,78,4.4,4.2,3.0,M2020-04-15D,Race(6),4.6,4.4
4,0,0,2,2,1,1,1,3,1,1,1,3,2,2,4,8,10,11,0.0,M2020-04-15D,Race(6),13,13
5,0,0,0,0,0,0,1,1,0,1,0,1,0,1,1,2,7.5,7,0.0,M2020-04-15D,Race(6),10,10
7,3,2,11,16,0,0,7,7,0,1,6,7,3,3,24,30,6.5,6,1.0,M2020-04-15D,Race(6),6.5,6.5
12,0,0,0,0,0,0,0,0,0,0,0,0,0,0,0,0,21,26,0.0,M2020-04-15D,Race(6),34,41
6,2,0,0,2,0,1,0,1,0,0,0,0,2,1,0,3,11,12,0.0,M2020-04-15D,Race(6),15,15
8,0,0,0,0,0,0,0,0,0,0,0,0,0,0,0,0,101,126,0.0,M2020-04-15D,Race(6),151,151
10,0,0,0,0,0,0,0,0,0,0,0,0,0,0,0,0,61,71,0.0,M2020-04-15D,Race(6),61,61
9,0,0,0,0,0,0,0,0,0,0,0,0,0,0,0,0,61,81,0.0,M2020-04-15D,Race(6),101,101
11,5,8,5,18,1,2,1,4,3,1,2,6,9,11,8,28,4.6,4.4,0.0,M2020-04-15D,Race(6),4.4,4.2
2,4,15,8,27,4,15,5,24,8,6,6,20,16,36,19,71,4.2,3.9,2.0,M2020-04-15D,Race(6),2.8,2.8
1,0,0,0,0,0,0,0,0,0,0,0,0,0,0,0,0,34,41,0.0,M2020-04-15D,Race(6),41,51
8,0,0,0,0,0,0,0,0,0,0,0,0,0,0,0,0,17,18,0.0,M2020-04-15D,Race(7),23,23
4,0,0,2,2,0,0,0,0,0,0,2,2,0,0,4,4,17,17,2.0,M2020-04-15D,Race(7),15,16
5,2,13,7,22,4,3,8,15,2,3,3,8,8,19,18,45,5,5,1.0,M2020-04-15D,Race(7),5.5,5.5
7,9,10,5,24,4,8,5,17,5,5,5,15,18,23,15,56,3.6,3.4,0.0,M2020-04-15D,Race(7),3.6,3.7
9,12,2,3,17,16,4,4,24,11,6,3,20,39,12,10,61,4.4,4.4,0.0,M2020-04-15D,Race(7),4.4,4.6
10,0,0,0,0,0,0,0,0,0,0,0,0,0,0,0,0,126,201,0.0,M2020-04-15D,Race(7),151,201
11,0,0,5,5,0,2,1,3,0,3,3,6,0,5,9,14,10,11,0.0,M2020-04-15D,Race(7),10,8.5
12,0,0,0,0,0,0,0,0,0,0,0,0,0,0,0,0,26,34,3.0,M2020-04-15D,Race(7),41,46
3,5,2,5,12,3,9,4,16,6,7,3,16,14,18,12,44,7,7,0.0,M2020-04-15D,Race(7),5,4.8
6,0,0,0,0,2,3,6,11,2,2,4,8,4,5,10,19,12,13,0.0,M2020-04-15D,Race(7),12,11
2,0,0,0,0,0,0,0,0,0,0,0,0,0,0,0,0,34,41,0.0,M2020-04-15D,Race(7),51,51
1,2,3,3,8,0,0,1,1,0,0,3,3,2,3,7,12,17,18,0.0,M2020-04-15D,Race(7),17,16
11,0,0,0,0,0,0,1,1,0,0,1,1,0,0,2,2,34,41,0.0,M2020-04-15D,Race(8),41,41
10,0,3,3,6,0,0,3,3,1,0,2,3,1,3,8,12,14,13,0.0,M2020-04-15D,Race(8),11,9
9,0,0,0,0,0,0,0,0,0,0,0,0,0,0,0,0,13,15,0.0,M2020-04-15D,Race(8),13,11
8,9,8,7,24,2,0,11,13,0,0,8,8,11,8,26,45,3.7,3.5,3.0,M2020-04-15D,Race(8),4,4.4
2,4,0,0,4,0,0,0,0,0,0,0,0,4,0,0,4,8,8,0.0,M2020-04-15D,Race(8),11,12
5,2,2,0,4,1,3,1,5,0,2,2,4,3,7,3,13,21,20,0.0,M2020-04-15D,Race(8),15,14
7,0,7,9,16,1,13,6,20,1,8,5,14,2,28,20,50,7,6.5,1.0,M2020-04-15D,Race(8),7,6
12,2,0,2,4,0,1,4,5,0,1,1,2,2,2,7,11,10,9.5,0.0,M2020-04-15D,Race(8),8,8.5
1,11,6,6,23,2,6,3,11,5,8,2,15,18,20,11,49,5,4.6,2.0,M2020-04-15D,Race(8),4,4.6
3,0,0,0,0,0,0,0,0,0,2,2,4,0,2,2,4,34,35,0.0,M2020-04-15D,Race(8),26,23
4,0,0,0,0,0,0,0,0,0,0,0,0,0,0,0,0,20,23,0.0,M2020-04-15D,Race(8),26,31
6,2,4,3,9,1,1,1,3,2,0,3,5,5,5,7,17,8,8.5,0.0,M2020-04-15D,Race(8),7,6
3,3,0,0,3,3,2,1,6,3,2,2,7,9,4,3,16,5,5,0.0,M2020-04-15D,Race(9),4.8,4.4
4,11,4,8,23,2,3,1,6,4,6,1,11,17,13,10,40,6.5,6.5,1.0,M2020-04-15D,Race(9),7.5,7.5
2,0,2,5,7,6,2,13,21,4,0,7,11,10,4,25,39,15,14,0.0,M2020-04-15D,Race(9),9.5,8.5
7,3,4,0,7,1,2,2,5,0,1,1,2,4,7,3,14,7.5,7,0.0,M2020-04-15D,Race(9),8,8
1,0,0,0,0,0,1,1,2,0,2,1,3,0,3,2,5,23,31,0.0,M2020-04-15D,Race(9),34,34
12,0,0,0,0,0,0,0,0,0,0,0,0,0,0,0,0,41,51,0.0,M2020-04-15D,Race(9),41,41
11,0,0,0,0,1,0,1,2,0,1,1,2,1,1,2,4,18,17,3.0,M2020-04-15D,Race(9),17,18
10,0,0,0,0,0,0,0,0,0,1,0,1,0,1,0,1,26,31,0.0,M2020-04-15D,Race(9),34,26
9,9,0,0,9,14,7,5,26,6,4,5,15,29,11,10,50,4.4,4.6,2.0,M2020-04-15D,Race(9),4.8,4.8
8,2,3,10,15,2,2,3,7,4,4,4,12,8,9,17,34,8.5,7.5,0.0,M2020-04-15D,Race(9),8.5,8.5
6,0,0,2,2,0,0,0,0,0,0,1,1,0,0,3,3,15,16,0.0,M2020-04-15D,Race(9),16,17
5,2,17,5,24,1,11,3,15,5,5,3,13,8,33,11,52,6.5,6,0.0,M2020-04-15D,Race(9),5.5,5
10,4,3,2,9,0,0,1,1,2,1,3,6,6,4,6,16,10,10,0.0,M2020-04-19D,Race(1),8,8
9,2,3,8,13,0,0,1,1,0,0,3,3,2,3,12,17,6,6,1.0,M2020-04-19D,Race(1),7,7
14,0,0,0,0,0,0,0,0,0,0,0,0,0,0,0,0,18,21,0.0,M2020-04-19D,Race(1),19,19
13,0,0,0,0,0,0,0,0,0,0,1,1,0,0,1,1,71,81,0.0,M2020-04-19D,Race(1),101,101
12,0,0,0,0,0,0,0,0,0,1,0,1,0,1,0,1,71,81,0.0,M2020-04-19D,Race(1),101,101
5,0,0,0,0,0,0,0,0,0,0,0,0,0,0,0,0,51,61,0.0,M2020-04-19D,Race(1),41,51
1,19,6,5,30,10,9,10,29,10,8,4,22,39,23,19,81,2.6,2.5,3.0,M2020-04-19D,Race(1),2.9,2.8
11,0,0,0,0,0,0,0,0,0,0,0,0,0,0,0,0,101,126,0.0,M2020-04-19D,Race(1),151,126
3,0,5,7,12,10,13,2,25,8,5,2,15,18,23,11,52,7,6.5,0.0,M2020-04-19D,Race(1),7,7
4,0,6,3,9,9,1,8,18,2,3,9,14,11,10,20,41,8,9,2.0,M2020-04-19D,Race(1),9,8.5
6,0,0,0,0,0,0,0,0,0,0,0,0,0,0,0,0,31,41,0.0,M2020-04-19D,Race(1),31,35
7,0,0,0,0,0,0,0,0,0,0,0,0,0,0,0,0,71,81,0.0,M2020-04-19D,Race(1),81,71
8,0,4,0,4,0,0,2,2,0,1,0,1,0,5,2,7,21,21,0.0,M2020-04-19D,Race(1),23,23
2,5,3,5,13,1,7,6,14,4,7,4,15,10,17,15,42,6.5,6,0.0,M2020-04-19D,Race(1),6,6
4,0,0,0,0,0,3,5,8,1,4,6,11,1,7,11,19,23,26,2.0,M2020-04-19D,Race(10),20,19
1,0,3,3,6,0,1,11,12,0,0,5,5,0,4,19,23,9,11,0.0,M2020-04-19D,Race(10),14,15
3,0,0,0,0,0,0,0,0,0,1,0,1,0,1,0,1,51,81,0.0,M2020-04-19D,Race(10),61,61
5,0,4,5,9,0,2,1,3,0,2,0,2,0,8,6,14,14,15,0.0,M2020-04-19D,Race(10),16,16
2,20,8,2,30,22,0,1,23,25,1,0,26,67,9,3,79,2,1.85,1.0,M2020-04-19D,Race(10),1.9,1.9
7,0,0,0,0,0,0,0,0,0,0,0,0,0,0,0,0,91,151,0.0,M2020-04-19D,Race(10),101,126
8,10,9,9,28,8,14,5,27,0,15,8,23,18,38,22,78,4,3.6,0.0,M2020-04-19D,Race(10),3.4,3.2
9,0,0,3,3,0,0,2,2,0,0,1,1,0,0,6,6,21,26,0.0,M2020-04-19D,Race(10),23,23
10,0,0,0,0,0,0,0,0,0,0,0,0,0,0,0,0,81,101,0.0,M2020-04-19D,Race(10),91,101
14,0,2,0,2,0,0,0,0,0,0,0,0,0,2,0,2,26,34,3.0,M2020-04-19D,Race(10),31,35
11,0,0,0,0,0,0,0,0,0,0,1,1,0,0,1,1,34,41,0.0,M2020-04-19D,Race(10),34,34
13,0,0,0,0,0,0,0,0,0,0,0,0,0,0,0,0,151,201,0.0,M2020-04-19D,Race(10),151,151
12,0,4,8,12,0,10,5,15,0,3,5,8,0,17,18,35,8.5,8.5,0.0,M2020-04-19D,Race(10),8.5,8
6,0,0,0,0,0,0,0,0,0,0,0,0,0,0,0,0,41,51,0.0,M2020-04-19D,Race(10),61,61
8,0,3,5,8,0,1,1,2,0,0,2,2,0,4,8,12,9.5,9,0.0,M2020-04-19D,Race(2),8.5,8.5
11,0,0,0,0,0,2,4,6,0,2,7,9,0,4,11,15,10,10,2.0,M2020-04-19D,Race(2),11,11
7,12,4,5,21,15,7,6,28,6,7,8,21,33,18,19,70,4.2,4,0.0,M2020-04-19D,Race(2),3.9,3.8
6,0,0,0,0,0,0,0,0,0,0,0,0,0,0,0,0,31,34,0.0,M2020-04-19D,Race(2),34,35
5,6,0,6,12,4,5,13,22,3,12,3,18,13,17,22,52,8.5,9.5,3.0,M2020-04-19D,Race(2),9.5,9.5
1,0,0,0,0,0,0,0,0,0,0,0,0,0,0,0,0,34,41,0.0,M2020-04-19D,Race(2),34,34
3,5,3,0,8,0,1,1,2,1,1,2,4,6,5,3,14,9.5,11,0.0,M2020-04-19D,Race(2),10,10
12,0,0,0,0,0,0,0,0,0,0,0,0,0,0,0,0,34,41,0.0,M2020-04-19D,Race(2),34,35
9,0,0,0,0,0,0,0,0,0,0,0,0,0,0,0,0,31,34,0.0,M2020-04-19D,Race(2),26,27
13,0,0,0,0,0,0,0,0,0,0,0,0,0,0,0,0,23,26,0.0,M2020-04-19D,Race(2),21,23
14,0,2,2,4,0,0,0,0,0,0,1,1,0,2,3,5,12,13,0.0,M2020-04-19D,Race(2),15,16
2,5,11,5,21,8,12,4,24,11,2,2,15,24,25,11,60,6,5.5,1.0,M2020-04-19D,Race(2),6.5,6.5
4,0,7,7,14,3,1,1,5,5,2,0,7,8,10,8,26,6.5,6,0.0,M2020-04-19D,Race(2),7,7
10,2,0,0,2,0,1,0,1,0,0,1,1,2,1,1,4,21,21,0.0,M2020-04-19D,Race(2),19,19
4,3,0,0,3,0,1,1,2,0,0,1,1,3,1,2,6,21,21,0.0,M2020-04-19D,Race(3),21,23
6,2,9,7,18,3,13,6,22,3,2,11,16,8,24,24,56,6,5.5,2.0,M2020-04-19D,Race(3),6,6
5,3,0,6,9,1,2,2,5,2,4,0,6,6,6,8,20,12,10,0.0,M2020-04-19D,Race(3),12,13
1,5,6,5,16,12,4,10,26,10,7,0,17,27,17,15,59,4.4,4.6,3.0,M2020-04-19D,Race(3),4.8,4.8
2,0,0,0,0,0,0,0,0,0,0,0,0,0,0,0,0,71,101,0.0,M2020-04-19D,Race(3),101,126
12,2,2,0,4,0,0,2,2,0,0,2,2,2,2,4,8,11,12,1.0,M2020-04-19D,Race(3),9.5,9.5
8,3,2,2,7,2,1,0,3,2,2,1,5,7,5,3,15,10,10,0.0,M2020-04-19D,Race(3),10,9.5
7,0,0,3,3,0,0,1,1,0,1,2,3,0,1,6,7,14,13,0.0,M2020-04-19D,Race(3),13,13
10,0,0,0,0,0,0,0,0,0,0,0,0,0,0,0,0,51,81,0.0,M2020-04-19D,Race(3),61,71
11,2,3,0,5,0,3,1,4,0,1,4,5,2,7,5,14,17,19,0.0,M2020-04-19D,Race(3),14,14
9,0,0,0,0,0,0,0,0,0,0,0,0,0,0,0,0,71,101,0.0,M2020-04-19D,Race(3),81,91
13,2,0,0,2,0,0,0,0,0,0,0,0,2,0,0,2,14,14,0.0,M2020-04-19D,Race(3),14,13
14,8,8,7,23,12,5,2,19,9,7,1,17,29,20,10,59,3.6,3.6,0.0,M2020-04-19D,Race(3),3.6,3.6
3,0,0,0,0,0,0,0,0,0,1,0,1,0,1,0,1,21,26,0.0,M2020-04-19D,Race(3),21,23
5,2,0,2,4,0,0,0,0,2,0,0,2,4,0,2,6,11,13,0.0,M2020-04-19D,Race(4),11,11
4,0,0,0,0,0,0,0,0,1,0,0,1,1,0,0,1,34,31,0.0,M2020-04-19D,Race(4),41,51
8,6,6,6,18,1,8,15,24,3,7,9,19,10,21,30,61,6,5,0.0,M2020-04-19D,Race(4),6,6
3,6,2,2,10,1,0,1,2,2,0,1,3,9,2,4,15,12,12,3.0,M2020-04-19D,Race(4),11,11
1,0,8,5,13,1,3,5,9,1,4,7,12,2,15,17,34,9,10,0.0,M2020-04-19D,Race(4),11,12
6,0,2,3,5,0,2,0,2,2,2,1,5,2,6,4,12,6.5,6,0.0,M2020-04-19D,Race(4),6,6
7,0,0,0,0,0,0,0,0,0,1,0,1,0,1,0,1,101,126,0.0,M2020-04-19D,Race(4),126,151
9,0,0,0,0,0,0,0,0,0,0,0,0,0,0,0,0,101,126,0.0,M2020-04-19D,Race(4),101,126
10,0,0,0,0,0,0,0,0,0,0,0,0,0,0,0,0,101,126,0.0,M2020-04-19D,Race(4),101,126
11,2,5,3,10,2,8,2,12,1,2,4,7,5,15,9,29,13,13,0.0,M2020-04-19D,Race(4),16,16
12,0,0,0,0,0,0,0,0,0,0,0,0,0,0,0,0,51,61,2.0,M2020-04-19D,Race(4),61,61
13,0,0,0,0,0,0,0,0,0,0,0,0,0,0,0,0,81,101,0.0,M2020-04-19D,Race(4),101,101
14,14,2,6,22,15,5,1,21,12,8,2,22,41,15,9,65,2.4,2.4,1.0,M2020-04-19D,Race(4),2.5,2.3
2,0,5,3,8,10,4,6,20,2,2,2,6,12,11,11,34,13,13,0.0,M2020-04-19D,Race(4),8,6.5
6,8,15,2,25,7,14,4,25,9,9,3,21,24,38,9,71,4,4,2.0,M2020-04-19D,Race(5),4,3.9
7,0,0,5,5,0,1,1,2,0,3,3,6,0,4,9,13,21,21,0.0,M2020-04-19D,Race(5),20,20
3,0,0,0,0,0,0,0,0,1,0,0,1,1,0,0,1,26,31,0.0,M2020-04-19D,Race(5),26,26
10,3,4,0,7,1,0,0,1,0,0,1,1,4,4,1,9,9,9,0.0,M2020-04-19D,Race(5),9.5,9
9,2,0,0,2,0,4,5,9,0,0,2,2,2,4,7,13,15,15,0.0,M2020-04-19D,Race(5),15,15
12,0,0,2,2,0,0,0,0,0,0,0,0,0,0,2,2,14,19,0.0,M2020-04-19D,Race(5),18,18
8,0,0,0,0,0,0,1,1,0,0,2,2,0,0,3,3,51,67,0.0,M2020-04-19D,Race(5),61,67
11,0,0,0,0,2,0,8,10,1,0,3,4,3,0,11,14,9.5,10,0.0,M2020-04-19D,Race(5),11,10
1,15,5,3,23,20,7,2,29,10,10,1,21,45,22,6,73,2.9,2.8,1.0,M2020-04-19D,Race(5),3,2.9
2,2,6,5,13,0,1,4,5,1,0,5,6,3,7,14,24,8.5,8.5,0.0,M2020-04-19D,Race(5),8.5,8
4,0,0,11,11,0,3,5,8,4,3,6,13,4,6,22,32,14,11,3.0,M2020-04-19D,Race(5),11,11
5,0,0,2,2,0,0,0,0,0,1,0,1,0,1,2,3,23,26,0.0,M2020-04-19D,Race(5),23,23
2,0,0,0,0,0,0,0,0,0,0,0,0,0,0,0,0,101,126,0.0,M2020-04-19D,Race(6),101,101
3,0,0,2,2,1,1,2,4,1,0,3,4,2,1,7,10,14,14,0.0,M2020-04-19D,Race(6),18,20
4,6,3,3,12,3,2,15,20,4,2,7,13,13,7,25,45,4.8,4.8,1.0,M2020-04-19D,Race(6),5,5
5,22,3,5,30,17,9,1,27,6,14,3,23,45,26,9,80,2.05,1.9,0.0,M2020-04-19D,Race(6),2.1,2.1
6,2,14,5,21,1,6,6,13,1,7,5,13,4,27,16,47,6,6.5,0.0,M2020-04-19D,Race(6),5,4.6
7,0,0,0,0,0,0,0,0,0,0,0,0,0,0,0,0,126,201,0.0,M2020-04-19D,Race(6),151,151
8,0,0,0,0,0,0,0,0,0,0,0,0,0,0,0,0,61,81,0.0,M2020-04-19D,Race(6),51,46
9,0,0,0,0,0,0,0,0,0,0,1,1,0,0,1,1,101,126,0.0,M2020-04-19D,Race(6),126,101
10,0,0,0,0,0,0,0,0,0,0,0,0,0,0,0,0,26,201,0.0,M2020-04-19D,Race(6),126,126
13,0,3,2,5,0,1,1,2,1,1,3,5,1,5,6,12,19,26,0.0,M2020-04-19D,Race(6),19,21
14,0,2,0,2,0,0,0,0,0,0,1,1,0,2,1,3,81,101,0.0,M2020-04-19D,Race(6),91,91
1,0,5,13,18,8,11,5,24,13,2,2,17,21,18,20,59,7,7,3.0,M2020-04-19D,Race(6),7.5,7
12,0,0,0,0,0,0,0,0,0,0,1,1,0,0,1,1,17,19,2.0,M2020-04-19D,Race(6),14,15
11,0,0,0,0,0,0,0,0,0,0,0,0,0,0,0,0,23,26,0.0,M2020-04-19D,Race(6),26,26
12,0,0,0,0,0,0,0,0,0,0,0,0,0,0,0,0,61,81,0.0,M2020-04-19D,Race(7),71,81
11,2,5,9,16,0,3,1,4,0,3,4,7,2,11,14,27,6,5,0.0,M2020-04-19D,Race(7),5.5,5.5
10,6,0,9,15,0,2,4,6,0,4,3,7,6,6,16,28,9,8,3.0,M2020-04-19D,Race(7),8.5,8.5
8,0,0,0,0,0,1,1,2,0,2,0,2,0,3,1,4,23,26,0.0,M2020-04-19D,Race(7),19,16
2,2,8,5,15,9,13,4,26,6,8,5,19,17,29,14,60,7,8,0.0,M2020-04-19D,Race(7),7.5,7.5
6,0,0,0,0,0,0,1,1,0,0,3,3,0,0,4,4,26,31,0.0,M2020-04-19D,Race(7),31,31
5,0,0,0,0,0,0,0,0,0,0,0,0,0,0,0,0,26,31,0.0,M2020-04-19D,Race(7),26,31
1,0,0,0,0,1,0,9,10,0,0,2,2,1,0,11,12,31,34,2.0,M2020-04-19D,Race(7),34,35
3,0,2,3,5,0,0,2,2,1,0,0,1,1,2,5,8,17,19,0.0,M2020-04-19D,Race(7),15,14
4,18,8,2,28,20,1,0,21,19,7,0,26,57,16,2,75,2.05,2.1,1.0,M2020-04-19D,Race(7),2.2,2.2
7,0,0,2,2,0,0,0,0,0,0,0,0,0,0,2,2,61,81,0.0,M2020-04-19D,Race(7),71,71
9,2,7,0,9,0,10,8,18,0,2,9,11,2,19,17,38,8,7,0.0,M2020-04-19D,Race(7),6.5,6.5
2,17,7,3,27,16,6,0,22,17,7,1,25,50,20,4,74,3.5,3.2,3.0,M2020-04-19D,Race(8),3.2,3.1
3,0,0,3,3,0,0,1,1,0,0,1,1,0,0,5,5,14,14,1.0,M2020-04-19D,Race(8),15,15
4,6,10,8,24,3,8,16,27,2,8,9,19,11,26,33,70,3.7,3.6,2.0,M2020-04-19D,Race(8),4.2,4.2
5,2,3,0,5,0,1,1,2,0,1,2,3,2,5,3,10,9,9,0.0,M2020-04-19D,Race(8),9,9
1,3,6,7,16,9,5,4,18,2,6,2,10,14,17,13,44,7.5,7.5,0.0,M2020-04-19D,Race(8),8,8.5
6,0,0,0,0,0,0,0,0,0,0,0,0,0,0,0,0,34,41,0.0,M2020-04-19D,Race(8),34,35
7,0,0,0,0,0,0,1,1,0,0,1,1,0,0,2,2,34,34,0.0,M2020-04-19D,Race(8),34,35
8,0,0,0,0,0,0,0,0,0,0,1,1,0,0,1,1,101,151,0.0,M2020-04-19D,Race(8),105,101
9,0,2,4,6,0,2,1,3,1,2,4,7,1,6,9,16,15,17,0.0,M2020-04-19D,Race(8),9.5,8.5
10,0,0,3,3,0,0,2,2,0,0,1,1,0,0,6,6,15,16,0.0,M2020-04-19D,Race(8),12,11
11,0,0,0,0,0,0,0,0,0,0,0,0,0,0,0,0,31,41,0.0,M2020-04-19D,Race(8),34,41
12,2,2,2,6,2,8,4,14,4,2,4,10,8,12,10,30,6.5,6,0.0,M2020-04-19D,Race(8),6.5,7
2,11,2,4,17,3,11,2,16,5,2,0,7,19,15,6,40,4.4,4.4,0.0,M2020-04-19D,Race(9),5,5
3,0,3,0,3,1,0,0,1,0,1,0,1,1,4,0,5,41,51,0.0,M2020-04-19D,Race(9),51,61
4,0,0,12,12,1,4,3,8,0,6,7,13,1,10,22,33,8.5,8.5,0.0,M2020-04-19D,Race(9),9,9
5,4,0,0,4,3,2,8,13,2,0,1,3,9,2,9,20,9,8.5,0.0,M2020-04-19D,Race(9),13,14
6,0,0,0,0,0,0,0,0,0,0,0,0,0,0,0,0,81,101,0.0,M2020-04-19D,Race(9),81,81
9,0,0,3,3,2,3,2,7,2,5,2,9,4,8,7,19,12,11,1.0,M2020-04-19D,Race(9),12,12
8,0,0,0,0,0,0,2,2,0,1,2,3,0,1,4,5,19,19,0.0,M2020-04-19D,Race(9),20,20
10,0,0,6,6,0,0,1,1,1,0,1,2,1,0,8,9,16,18,0.0,M2020-04-19D,Race(9),19,20
11,2,0,0,2,0,0,0,0,0,0,0,0,2,0,0,2,61,81,0.0,M2020-04-19D,Race(9),71,71
12,7,15,3,25,10,4,6,20,12,5,4,21,29,24,13,66,3.3,3.6,3.0,M2020-04-19D,Race(9),2.05,2.05
7,0,0,0,0,0,0,0,0,0,0,0,0,0,0,0,0,61,81,0.0,M2020-04-19D,Race(9),81,81
1,6,10,2,18,10,6,6,22,4,6,9,19,20,22,17,59,3.9,3.5,2.0,M2020-04-19D,Race(9),6,5.5
11,3,3,5,11,2,2,8,12,1,3,4,8,6,8,17,31,6.5,6.5,2.0,M2020-04-22D,Race(1),7.5,8
4,0,2,6,8,1,1,4,6,2,1,1,4,3,4,11,18,10,11,0.0,M2020-04-22D,Race(1),14,14
5,0,2,0,2,0,0,0,0,1,0,1,2,1,2,1,4,17,16,0.0,M2020-04-22D,Race(1),14,11
12,0,0,0,0,0,0,0,0,0,0,0,0,0,0,0,0,31,34,0.0,M2020-04-22D,Race(1),51,51
6,13,5,2,20,1,1,7,9,1,2,6,9,15,8,15,38,3.7,3.7,3.0,M2020-04-22D,Race(1),3.6,3.5
7,2,3,0,5,1,0,1,2,0,2,3,5,3,5,4,12,12,11,0.0,M2020-04-22D,Race(1),11,11
8,0,5,4,9,1,2,2,5,2,3,1,6,3,10,7,20,10,10,1.0,M2020-04-22D,Race(1),8.5,9
9,2,2,6,10,16,7,3,26,10,6,4,20,28,15,13,56,6.5,6.5,0.0,M2020-04-22D,Race(1),7,7.5
3,2,0,0,2,1,0,0,1,2,0,1,3,5,0,1,6,13,13,0.0,M2020-04-22D,Race(1),10,9.5
2,8,6,7,21,6,16,5,27,5,7,4,16,19,29,16,64,6,6,0.0,M2020-04-22D,Race(1),6,6
10,0,0,0,0,0,0,0,0,0,1,1,2,0,1,1,2,31,31,0.0,M2020-04-22D,Race(1),51,51
1,0,2,0,2,1,1,0,2,2,1,0,3,3,4,0,7,17,17,0.0,M2020-04-22D,Race(1),26,26
1,0,0,3,3,3,14,2,19,3,10,0,13,6,24,5,35,11,11,0.0,M2020-04-22D,Race(2),10,9
2,3,5,7,15,0,3,1,4,1,2,2,5,4,10,10,24,6,6,0.0,M2020-04-22D,Race(2),7,8
3,9,2,5,16,4,1,13,18,7,4,6,17,20,7,24,51,4.8,5,0.0,M2020-04-22D,Race(2),4.4,4.6
4,5,3,0,8,3,7,5,15,3,6,4,13,11,16,9,36,6,6,0.0,M2020-04-22D,Race(2),6,6
5,2,9,3,14,4,0,4,8,0,0,6,6,6,9,13,28,6.5,6,1.0,M2020-04-22D,Race(2),5.5,5
6,0,0,0,0,0,0,0,0,1,1,0,2,1,1,0,2,18,18,0.0,M2020-04-22D,Race(2),19,20
7,0,2,0,2,0,0,0,0,0,0,0,0,0,2,0,2,16,17,0.0,M2020-04-22D,Race(2),23,23
8,0,0,0,0,0,0,1,1,0,0,3,3,0,0,4,4,17,15,2.0,M2020-04-22D,Race(2),26,26
9,2,0,0,2,0,0,0,0,0,0,0,0,2,0,0,2,10,11,0.0,M2020-04-22D,Race(2),12,13
10,0,0,0,0,0,0,0,0,0,0,0,0,0,0,0,0,34,34,0.0,M2020-04-22D,Race(2),71,67
11,9,9,12,30,16,5,4,25,11,3,5,19,36,17,21,74,4.2,4.2,0.0,M2020-04-22D,Race(2),4.6,4.6
12,0,0,0,0,0,0,0,0,0,0,0,0,0,0,0,0,31,31,3.0,M2020-04-22D,Race(2),61,71
1,0,0,0,0,0,0,1,1,1,1,2,4,1,1,3,5,14,14,0.0,M2020-04-22D,Race(3),21,23
2,0,2,5,7,0,0,1,1,0,0,1,1,0,2,7,9,11,11,0.0,M2020-04-22D,Race(3),16,16
3,2,0,0,2,1,3,4,8,2,4,2,8,5,7,6,18,19,20,0.0,M2020-04-22D,Race(3),18,16
4,2,3,9,14,1,1,16,18,3,4,8,15,6,8,33,47,6.5,6.5,0.0,M2020-04-22D,Race(3),7.5,7
5,0,8,5,13,0,2,0,2,1,1,1,3,1,11,6,18,11,11,1.0,M2020-04-22D,Race(3),12,11
6,13,7,5,25,6,19,3,28,5,13,6,24,24,39,14,77,4.2,4.2,3.0,M2020-04-22D,Race(3),4,3.9
7,0,2,2,4,0,1,3,4,0,0,2,2,0,3,7,10,10,10,2.0,M2020-04-22D,Race(3),16,14
8,13,8,4,25,22,4,2,28,14,3,4,21,49,15,10,74,2.5,2.5,0.0,M2020-04-22D,Race(3),1.95,1.95
9,0,0,0,0,0,0,0,0,0,0,0,0,0,0,0,0,21,21,0.0,M2020-04-22D,Race(3),51,41
10,0,0,0,0,0,0,0,0,0,0,0,0,0,0,0,0,15,15,0.0,M2020-04-22D,Race(3),23,26
1,0,0,2,2,1,0,0,1,1,1,0,2,2,1,2,5,12,13,2.0,M2020-04-22D,Race(4),15,14
2,4,3,6,13,2,9,2,13,5,2,4,11,11,14,12,37,8,7.5,0.0,M2020-04-22D,Race(4),6.5,6.5
3,0,0,2,2,0,0,0,0,0,0,0,0,0,0,2,2,10,9.5,0.0,M2020-04-22D,Race(4),14,15
4,0,2,2,4,0,7,2,9,2,3,0,5,2,12,4,18,10,10,0.0,M2020-04-22D,Race(4),15,14
5,2,3,5,10,12,4,3,19,9,7,0,16,23,14,8,45,4.8,4.5,0.0,M2020-04-22D,Race(4),5.5,6
6,0,0,0,0,0,0,0,0,0,0,0,0,0,0,0,0,11,11,0.0,M2020-04-22D,Race(4),9.5,8.5
7,8,7,6,21,0,3,2,5,0,4,2,6,8,14,10,32,5,4.8,0.0,M2020-04-22D,Race(4),7,6.5
8,0,0,0,0,0,0,0,0,0,0,0,0,0,0,0,0,61,67,3.0,M2020-04-22D,Race(4),51,61
9,8,8,5,21,2,3,15,20,2,2,8,12,12,13,28,53,4.4,4.2,1.0,M2020-04-22D,Race(4),4,3.9
10,0,0,2,2,0,0,0,0,0,0,0,0,0,0,2,2,15,15,0.0,M2020-04-22D,Race(4),31,27
11,8,7,0,15,4,1,1,6,0,2,4,6,12,10,5,27,6,6,0.0,M2020-04-22D,Race(4),5.5,5.5
12,0,0,0,0,0,0,0,0,1,0,1,2,1,0,1,2,51,61,0.0,M2020-04-22D,Race(4),101,91
1,5,11,11,27,8,17,4,29,9,8,5,22,22,36,20,78,4.2,4.6,0.0,M2020-04-22D,Race(5),6.5,6
2,2,0,0,2,0,0,0,0,0,0,0,0,2,0,0,2,34,41,0.0,M2020-04-22D,Race(5),41,31
3,3,3,0,6,0,0,0,0,2,1,1,4,5,4,1,10,8,8.5,0.0,M2020-04-22D,Race(5),10,9
4,2,0,0,2,0,0,0,0,0,0,1,1,2,0,1,3,23,26,0.0,M2020-04-22D,Race(5),31,31
5,10,5,5,20,4,6,20,30,6,5,10,21,20,16,35,71,2.8,2.9,0.0,M2020-04-22D,Race(5),2.45,2.45
6,0,0,0,0,0,0,0,0,0,0,0,0,0,0,0,0,81,91,0.0,M2020-04-22D,Race(5),126,151
7,0,5,4,9,0,0,0,0,2,2,1,5,2,7,5,14,12,13,3.0,M2020-04-22D,Race(5),16,15
8,0,0,0,0,1,0,0,1,0,0,1,1,1,0,1,2,20,23,1.0,M2020-04-22D,Race(5),34,41
9,8,6,4,18,16,7,6,29,6,9,7,22,30,22,17,69,3.8,4.2,2.0,M2020-04-22D,Race(5),3.4,3.4
10,0,0,3,3,0,0,0,0,0,1,0,1,0,1,3,4,17,19,0.0,M2020-04-22D,Race(5),26,23
11,0,0,3,3,1,0,0,1,1,0,0,1,2,0,3,5,9.5,11,0.0,M2020-04-22D,Race(5),12,11
12,0,0,0,0,0,0,0,0,0,0,0,0,0,0,0,0,26,31,0.0,M2020-04-22D,Race(5),26,27
1,0,3,0,3,2,4,2,8,1,3,5,9,3,10,7,20,5.5,5.5,0.0,M2020-04-22D,Race(6),8,8
2,16,8,0,24,17,8,3,28,10,8,1,19,43,24,4,71,3.1,3.2,1.0,M2020-04-22D,Race(6),3.5,3.3
3,0,2,5,7,1,0,0,1,2,2,0,4,3,4,5,12,10,10,0.0,M2020-04-22D,Race(6),8,7.5
4,2,0,2,4,1,0,0,1,2,0,0,2,5,0,2,7,10,10,0.0,M2020-04-22D,Race(6),8.5,8.5
5,2,2,3,7,2,1,5,8,3,2,6,11,7,5,14,26,11,11,3.0,M2020-04-22D,Race(6),11,11
6,6,12,8,26,6,14,6,26,7,5,5,17,19,31,19,69,6.5,6.5,2.0,M2020-04-22D,Race(6),6,5.5
7,4,3,10,17,1,3,13,17,1,6,5,12,6,12,28,46,5.5,5.5,0.0,M2020-04-22D,Race(6),5,5
8,0,0,0,0,0,0,1,1,0,0,4,4,0,0,5,5,16,16,0.0,M2020-04-22D,Race(6),31,31
9,0,0,0,0,0,0,0,0,0,0,0,0,0,0,0,0,34,35,0.0,M2020-04-22D,Race(6),51,51
10,0,0,0,0,0,0,0,0,0,0,0,0,0,0,0,0,34,35,0.0,M2020-04-22D,Race(6),34,41
11,0,0,0,0,0,0,0,0,0,0,0,0,0,0,0,0,61,67,0.0,M2020-04-22D,Race(6),101,126
12,0,0,2,2,0,0,0,0,0,0,0,0,0,0,2,2,19,20,0.0,M2020-04-22D,Race(6),14,13
1,0,0,0,0,1,1,2,4,2,1,4,7,3,2,6,11,9.5,10,0.0,M2020-04-22D,Race(7),14,15
2,15,6,7,28,19,7,2,28,14,8,0,22,48,21,9,78,3.8,3.9,0.0,M2020-04-22D,Race(7),3.5,3.4
3,0,2,0,2,0,0,3,3,1,0,3,4,1,2,6,9,23,23,0.0,M2020-04-22D,Race(7),18,17
4,9,8,8,25,3,9,5,17,6,8,3,17,18,25,16,59,3.2,3.3,3.0,M2020-04-22D,Race(7),3.6,3.4
5,0,3,3,6,0,3,0,3,0,3,1,4,0,9,4,13,9.5,10,0.0,M2020-04-22D,Race(7),6.5,6.5
6,0,2,2,4,2,6,4,12,0,3,9,12,2,11,15,28,14,14,0.0,M2020-04-22D,Race(7),13,13
7,0,0,0,0,0,0,0,0,0,0,0,0,0,0,0,0,71,71,0.0,M2020-04-22D,Race(7),126,126
8,0,2,0,2,0,1,0,1,0,0,1,1,0,3,1,4,20,21,2.0,M2020-04-22D,Race(7),18,18
9,0,2,0,2,0,0,0,0,0,0,1,1,0,2,1,3,21,21,0.0,M2020-04-22D,Race(7),34,35
10,6,5,10,21,5,3,14,22,3,3,4,10,14,11,28,53,4.4,4.5,1.0,M2020-04-22D,Race(7),4.8,4.8
11,0,0,0,0,0,0,0,0,0,0,0,0,0,0,0,0,34,35,0.0,M2020-04-22D,Race(7),51,51
12,0,0,0,0,0,0,0,0,0,0,0,0,0,0,0,0,19,20,0.0,M2020-04-22D,Race(7),21,20
1,17,9,4,30,18,9,3,30,11,10,4,25,46,28,11,85,2.25,2.3,3.0,M2020-04-22D,Race(8),2,1.85
2,0,11,3,14,1,3,1,5,4,5,0,9,5,19,4,28,9.5,10,2.0,M2020-04-22D,Race(8),8.5,8.5
3,2,2,7,11,0,0,4,4,0,0,5,5,2,2,16,20,6,6.5,1.0,M2020-04-22D,Race(8),7,7
4,0,0,0,0,0,0,0,0,0,2,1,3,0,2,1,3,34,41,0.0,M2020-04-22D,Race(8),61,71
5,8,0,16,24,5,15,5,25,9,6,7,22,22,21,28,71,4.2,4.4,0.0,M2020-04-22D,Race(8),5.5,5.5
6,0,0,0,0,0,0,0,0,0,0,0,0,0,0,0,0,81,91,0.0,M2020-04-22D,Race(8),151,201
7,3,8,0,11,5,3,17,25,2,2,8,12,10,13,25,48,5.5,5.5,0.0,M2020-04-22D,Race(8),5.5,6
8,0,0,0,0,0,0,0,0,0,1,0,1,0,1,0,1,21,23,0.0,M2020-04-22D,Race(8),51,61
9,0,0,0,0,0,0,0,0,0,0,0,0,0,0,0,0,51,61,0.0,M2020-04-22D,Race(8),81,91
10,0,0,0,0,0,0,0,0,0,0,0,0,0,0,0,0,61,71,0.0,M2020-04-22D,Race(8),101,101
11,0,0,0,0,1,0,0,1,0,0,1,1,1,0,1,2,13,13,0.0,M2020-04-22D,Race(8),23,26
1,5,7,0,12,0,4,4,8,1,4,3,8,6,15,7,28,8.5,8.5,0.0,M2020-04-22D,Race(9),8,8.5
2,0,0,0,0,0,0,0,0,0,0,0,0,0,0,0,0,61,61,0.0,M2020-04-22D,Race(9),51,34
3,0,4,6,10,0,2,8,10,0,2,4,6,0,8,18,26,6.5,6.5,1.0,M2020-04-22D,Race(9),6.5,6.5
4,12,9,7,28,25,3,2,30,20,3,1,24,57,15,10,82,3.8,3.8,2.0,M2020-04-22D,Race(9),3,2.7
5,6,5,0,11,4,14,3,21,2,5,4,11,12,24,7,43,6.5,6.5,0.0,M2020-04-22D,Race(9),8.5,8.5
6,0,0,0,0,1,0,1,2,0,0,0,0,1,0,1,2,21,21,0.0,M2020-04-22D,Race(9),23,23
7,5,0,4,9,0,3,1,4,3,6,0,9,8,9,5,22,3.9,3.9,0.0,M2020-04-22D,Race(9),6,5.5
8,0,3,8,11,0,3,3,6,0,6,4,10,0,12,15,27,7.5,7.5,3.0,M2020-04-22D,Race(9),6,7.5
9,0,2,0,2,0,0,0,0,0,0,0,0,0,2,0,2,26,26,0.0,M2020-04-22D,Race(9),26,27
10,0,0,5,5,0,1,8,9,0,0,9,9,0,1,22,23,19,19,0.0,M2020-04-22D,Race(9),17,15
11,2,0,0,2,0,0,0,0,0,0,1,1,2,0,1,3,21,21,0.0,M2020-04-22D,Race(9),19,20
12,0,0,0,0,0,0,0,0,0,0,0,0,0,0,0,0,71,71,0.0,M2020-04-22D,Race(9),126,126
9,0,0,0,0,0,0,0,0,0,1,0,1,0,1,0,1,61,91,0.0,M2020-04-26D,Race(1),126,151
13,0,3,2,5,1,2,4,7,1,3,5,9,2,8,11,21,9,12,0.0,M2020-04-26D,Race(1),10,8.5
8,0,2,0,2,0,1,0,1,1,0,1,2,1,3,1,5,12,13,0.0,M2020-04-26D,Race(1),13,14
7,0,0,0,0,0,0,0,0,0,0,0,0,0,0,0,0,101,151,0.0,M2020-04-26D,Race(1),151,201
6,2,3,5,10,10,0,3,13,4,3,3,10,16,6,11,33,7,7.5,0.0,M2020-04-26D,Race(1),8.5,8
5,0,2,0,2,0,0,2,2,1,0,2,3,1,2,4,7,19,23,0.0,M2020-04-26D,Race(1),31,34
4,6,2,2,10,1,1,5,7,3,1,6,10,10,4,13,27,5,5,0.0,M2020-04-26D,Race(1),4.8,4.8
3,9,3,8,20,6,11,10,27,7,11,2,20,22,25,20,67,8.5,6,3.0,M2020-04-26D,Race(1),6.5,7
2,0,0,0,0,0,0,0,0,0,0,0,0,0,0,0,0,101,151,0.0,M2020-04-26D,Race(1),151,251
1,8,10,8,26,12,11,3,26,9,3,5,17,29,24,16,69,4.2,4.5,1.0,M2020-04-26D,Race(1),4.8,4.8
14,0,2,0,2,0,1,1,2,0,0,0,0,0,3,1,4,11,10,2.0,M2020-04-26D,Race(1),13,13
10,0,0,0,0,0,2,1,3,0,4,0,4,0,6,1,7,8,9,0.0,M2020-04-26D,Race(1),9,9.5
12,5,3,5,13,0,0,1,1,0,0,2,2,5,3,8,16,8,8.5,0.0,M2020-04-26D,Race(1),7,7
11,0,0,0,0,0,1,0,1,0,0,0,0,0,1,0,1,31,51,0.0,M2020-04-26D,Race(1),71,81
2,0,2,7,9,2,8,3,13,2,3,1,6,4,13,11,28,16,16,2.0,M2020-04-26D,Race(10),17,15
14,0,0,0,0,0,0,0,0,0,0,0,0,0,0,0,0,61,91,0.0,M2020-04-26D,Race(10),91,91
13,2,5,5,12,0,1,3,4,0,1,5,6,2,7,13,22,6.5,6.5,0.0,M2020-04-26D,Race(10),7.5,7.5
1,15,0,2,17,9,6,13,28,13,2,7,22,37,8,22,67,4.2,4.2,0.0,M2020-04-26D,Race(10),4.6,4.8
10,0,0,0,0,0,0,0,0,0,1,0,1,0,1,0,1,34,41,0.0,M2020-04-26D,Race(10),41,41
9,0,3,0,3,0,2,0,2,0,3,1,4,0,8,1,9,10,9.5,0.0,M2020-04-26D,Race(10),10,11
12,0,2,2,4,1,1,2,4,2,3,4,9,3,6,8,17,10,14,1.0,M2020-04-26D,Race(10),9,8
7,0,2,0,2,1,3,2,6,2,2,2,6,3,7,4,14,11,8,0.0,M2020-04-26D,Race(10),9.5,11
6,2,8,3,13,9,2,4,15,4,1,2,7,15,11,9,35,11,17,0.0,M2020-04-26D,Race(10),12,11
5,0,0,2,2,0,0,0,0,0,1,0,1,0,1,2,3,34,34,0.0,M2020-04-26D,Race(10),34,41
4,0,0,3,3,0,1,1,2,0,1,2,3,0,2,6,8,9,7,0.0,M2020-04-26D,Race(10),8.5,7.5
3,7,8,6,21,8,6,1,15,3,8,0,11,18,22,7,47,4.2,4.5,0.0,M2020-04-26D,Race(10),4.4,3.8
8,2,0,0,2,0,0,1,1,0,0,2,2,2,0,3,5,31,71,3.0,M2020-04-26D,Race(10),51,51
11,2,0,0,2,0,0,0,0,0,0,0,0,2,0,0,2,17,27,0.0,M2020-04-26D,Race(10),26,31
8,0,0,0,0,0,0,0,0,0,0,1,1,0,0,1,1,21,31,0.0,M2020-04-26D,Race(2),26,31
7,0,0,0,0,0,0,0,0,0,0,0,0,0,0,0,0,41,67,0.0,M2020-04-26D,Race(2),71,81
9,2,0,5,7,1,1,3,5,2,0,7,9,5,1,15,21,9,8.5,0.0,M2020-04-26D,Race(2),9,8
1,12,5,8,25,11,9,9,29,10,7,5,22,33,21,22,76,4.8,4.6,0.0,M2020-04-26D,Race(2),4.8,4.8
2,11,3,4,18,10,1,5,16,1,2,2,5,22,6,11,39,6.5,5.5,2.0,M2020-04-26D,Race(2),6.5,5
10,0,0,0,0,0,0,0,0,0,0,0,0,0,0,0,0,51,91,0.0,M2020-04-26D,Race(2),91,101
3,0,0,0,0,0,0,0,0,0,0,0,0,0,0,0,0,61,151,0.0,M2020-04-26D,Race(2),151,201
6,2,13,2,17,7,14,7,28,11,6,4,21,20,33,13,66,6.5,5.5,3.0,M2020-04-26D,Race(2),4.6,4.5
5,0,0,0,0,0,0,0,0,1,0,0,1,1,0,0,1,34,61,0.0,M2020-04-26D,Race(2),51,51
4,0,2,0,2,0,0,0,0,0,0,1,1,0,2,1,3,26,27,0.0,M2020-04-26D,Race(2),26,26
14,0,0,0,0,0,0,0,0,0,0,0,0,0,0,0,0,19,31,0.0,M2020-04-26D,Race(2),23,31
11,3,0,11,14,0,1,3,4,0,2,3,5,3,3,17,23,3.1,3.9,0.0,M2020-04-26D,Race(2),3.9,4
13,0,3,0,3,0,0,0,0,0,0,1,1,0,3,1,4,13,23,1.0,M2020-04-26D,Race(2),23,26
12,0,4,0,4,1,4,3,8,1,9,2,12,2,17,5,24,8,8,0.0,M2020-04-26D,Race(2),8.5,9
8,4,5,8,17,9,3,1,13,1,2,4,7,14,10,13,37,4.8,4.2,0.0,M2020-04-26D,Race(3),4.6,4.6
2,6,0,3,9,1,14,7,22,1,7,2,10,8,21,12,41,13,19,0.0,M2020-04-26D,Race(3),10,9.5
6,3,5,4,12,1,7,4,12,0,12,4,16,4,24,12,40,7.5,7,0.0,M2020-04-26D,Race(3),8,8
4,0,5,10,15,0,2,5,7,0,2,9,11,0,9,24,33,6.5,6.5,0.0,M2020-04-26D,Race(3),6.5,6.5
7,5,0,0,5,0,0,0,0,0,1,1,2,5,1,1,7,18,21,0.0,M2020-04-26D,Race(3),26,27
5,0,0,0,0,0,0,0,0,0,0,0,0,0,0,0,0,34,46,0.0,M2020-04-26D,Race(3),81,101
3,0,0,0,0,0,0,0,0,0,0,0,0,0,0,0,0,51,71,0.0,M2020-04-26D,Race(3),91,101
13,0,0,0,0,0,0,0,0,0,0,0,0,0,0,0,0,81,126,0.0,M2020-04-26D,Race(3),151,201
9,0,0,0,0,0,1,3,4,0,0,3,3,0,1,6,7,18,26,3.0,M2020-04-26D,Race(3),26,27
14,0,0,0,0,0,0,0,0,0,0,0,0,0,0,0,0,41,81,0.0,M2020-04-26D,Race(3),71,81
10,0,2,0,2,0,0,0,0,0,0,0,0,0,2,0,2,17,16,1.0,M2020-04-26D,Race(3),14,13
1,10,13,5,28,18,3,8,29,22,1,0,23,50,17,13,80,2.6,2.8,2.0,M2020-04-26D,Race(3),2.65,2.5
12,0,0,0,0,0,0,0,0,0,0,0,0,0,0,0,0,61,71,0.0,M2020-04-26D,Race(3),101,151
11,2,0,0,2,1,0,2,3,2,1,3,6,5,1,5,11,8,8.5,0.0,M2020-04-26D,Race(3),8.5,8.5
5,0,0,3,3,0,0,0,0,0,0,0,0,0,0,3,3,26,27,0.0,M2020-04-26D,Race(4),34,35
6,0,2,3,5,2,3,4,9,4,3,4,11,6,8,11,25,10,13,0.0,M2020-04-26D,Race(4),11,11
7,0,0,0,0,0,0,0,0,0,0,0,0,0,0,0,0,51,71,0.0,M2020-04-26D,Race(4),71,81
4,0,4,0,4,0,0,2,2,0,1,3,4,0,5,5,10,11,11,0.0,M2020-04-26D,Race(4),13,14
9,0,0,0,0,0,0,1,1,0,0,1,1,0,0,2,2,21,31,0.0,M2020-04-26D,Race(4),31,34
10,5,9,9,23,3,10,7,20,2,4,4,10,10,23,20,53,5,4.4,0.0,M2020-04-26D,Race(4),4.2,4
11,3,0,3,6,0,0,0,0,0,1,2,3,3,1,5,9,18,19,2.0,M2020-04-26D,Race(4),14,13
12,0,0,0,0,0,0,0,0,0,0,0,0,0,0,0,0,51,71,0.0,M2020-04-26D,Race(4),34,41
14,2,3,5,10,0,1,2,3,1,1,3,5,3,5,10,18,10,10,0.0,M2020-04-26D,Race(4),11,12
8,3,3,0,6,0,1,0,1,0,2,1,3,3,6,1,10,10,8,0.0,M2020-04-26D,Race(4),7.5,7
13,17,2,0,19,10,9,8,27,9,8,3,20,36,19,11,66,2.7,3.2,3.0,M2020-04-26D,Race(4),3.3,3.2
3,0,2,0,2,0,1,0,1,2,0,0,2,2,3,0,5,14,16,0.0,M2020-04-26D,Race(4),16,16
2,0,5,7,12,15,5,6,26,8,6,5,19,23,16,18,57,7.5,7,1.0,M2020-04-26D,Race(4),8.5,9.5
1,0,0,0,0,0,0,0,0,0,0,0,0,0,0,0,0,81,126,0.0,M2020-04-26D,Race(4),126,151
3,0,2,7,9,1,0,1,2,2,1,0,3,3,3,8,14,10,10,0.0,M2020-04-26D,Race(5),18,17
4,0,0,0,0,0,0,0,0,0,0,0,0,0,0,0,0,26,26,1.0,M2020-04-26D,Race(5),41,61
5,0,0,0,0,0,0,0,0,0,0,0,0,0,0,0,0,34,34,0.0,M2020-04-26D,Race(5),23,23
6,0,0,0,0,0,0,0,0,1,0,1,2,1,0,1,2,31,31,0.0,M2020-04-26D,Race(5),23,26
7,0,5,7,12,2,9,6,17,2,6,5,13,4,20,18,42,9,9,0.0,M2020-04-26D,Race(5),12,13
2,3,10,8,21,2,2,15,19,3,2,9,14,8,14,32,54,9,9,3.0,M2020-04-26D,Race(5),10,11
8,0,0,0,0,0,0,0,0,0,0,0,0,0,0,0,0,31,31,0.0,M2020-04-26D,Race(5),34,41
1,22,5,3,30,13,10,0,23,13,10,2,25,48,25,5,78,2.6,2.5,0.0,M2020-04-26D,Race(5),2.8,2.8
11,5,8,3,16,12,9,8,29,5,7,9,21,22,24,20,66,2.65,2.5,0.0,M2020-04-26D,Race(5),2.6,2.45
9,0,0,0,0,0,0,0,0,0,0,0,0,0,0,0,0,34,41,2.0,M2020-04-26D,Race(5),18,17
10,0,0,2,2,0,0,0,0,0,0,0,0,0,0,2,2,101,101,0.0,M2020-04-26D,Race(5),61,71
8,0,0,0,0,0,0,0,0,0,0,0,0,0,0,0,0,41,61,2.0,M2020-04-26D,Race(6),51,61
13,2,0,0,2,0,0,0,0,0,0,0,0,2,0,0,2,23,31,0.0,M2020-04-26D,Race(6),26,26
3,2,5,11,18,1,7,5,13,1,8,8,17,4,20,24,48,8,7,0.0,M2020-04-26D,Race(6),7,7
6,0,2,7,9,2,1,6,9,4,3,4,11,6,6,17,29,8.5,8.5,0.0,M2020-04-26D,Race(6),9,9.5
7,0,0,0,0,0,0,0,0,0,0,0,0,0,0,0,0,20,21,0.0,M2020-04-26D,Race(6),21,23
5,0,2,0,2,0,0,0,0,0,0,0,0,0,2,0,2,26,26,0.0,M2020-04-26D,Race(6),31,35
4,0,0,0,0,0,0,0,0,0,0,0,0,0,0,0,0,41,46,3.0,M2020-04-26D,Race(6),51,67
14,0,0,0,0,0,0,0,0,1,0,0,1,1,0,0,1,126,201,0.0,M2020-04-26D,Race(6),151,151
12,0,0,0,0,0,0,0,0,0,0,0,0,0,0,0,0,151,251,0.0,M2020-04-26D,Race(6),151,251
11,3,2,0,5,2,8,5,15,1,3,4,8,6,13,9,28,11,12,0.0,M2020-04-26D,Race(6),13,15
10,0,14,10,24,11,7,6,24,3,5,6,14,14,26,22,62,5.5,5,1.0,M2020-04-26D,Race(6),6.5,7
9,0,0,0,0,0,0,0,0,0,0,0,0,0,0,0,0,41,41,0.0,M2020-04-26D,Race(6),31,41
1,23,5,2,30,14,7,8,29,15,5,3,23,52,17,13,82,1.9,1.9,0.0,M2020-04-26D,Race(6),1.7,1.65
2,0,0,0,0,0,0,0,0,1,2,0,3,1,2,0,3,34,46,0.0,M2020-04-26D,Race(6),41,51
5,0,2,7,9,0,0,9,9,0,1,4,5,0,3,20,23,12,11,1.0,M2020-04-26D,Race(7),18,20
7,0,0,0,0,0,0,0,0,0,0,0,0,0,0,0,0,0,0,0.0,M2020-04-26D,Race(7),0,
8,0,0,0,0,0,0,0,0,0,0,0,0,0,0,0,0,71,67,0.0,M2020-04-26D,Race(7),81,81
6,0,3,5,8,0,0,2,2,0,3,5,8,0,6,12,18,8.5,8,0.0,M2020-04-26D,Race(7),9,8.5
4,0,0,0,0,0,0,0,0,0,0,0,0,0,0,0,0,23,15,0.0,M2020-04-26D,Race(7),41,51
3,2,7,16,25,0,14,14,28,0,8,13,21,2,29,43,74,9,10,0.0,M2020-04-26D,Race(7),7.5,7.5
1,25,5,0,30,19,4,0,23,22,4,0,26,66,13,0,79,1.8,1.75,2.0,M2020-04-26D,Race(7),1.75,1.75
9,0,0,0,0,0,0,0,0,0,0,0,0,0,0,0,0,61,41,0.0,M2020-04-26D,Race(7),71,61
2,3,13,2,18,11,11,5,27,4,10,4,18,18,34,11,63,3.7,3.5,3.0,M2020-04-26D,Race(7),3.7,3.5
3,2,15,6,23,1,3,14,18,0,4,5,9,3,22,25,50,8,9,2.0,M2020-04-26D,Race(8),6,6
2,4,11,10,25,11,11,7,29,3,11,7,21,18,33,24,75,5.5,5,0.0,M2020-04-26D,Race(8),5.5,5.5
6,0,0,8,8,1,9,5,15,2,3,5,10,3,12,18,33,31,34,0.0,M2020-04-26D,Race(8),13,14
5,0,0,0,0,0,0,0,0,0,0,1,1,0,0,1,1,26,26,0.0,M2020-04-26D,Race(8),51,51
4,0,0,0,0,0,0,0,0,0,1,1,2,0,1,1,2,23,21,3.0,M2020-04-26D,Race(8),26,26
7,0,0,6,6,1,1,3,5,0,2,7,9,1,3,16,20,41,51,0.0,M2020-04-26D,Race(8),16,18
1,24,4,0,28,16,6,1,23,21,5,0,26,61,15,1,77,1.4,1.35,1.0,M2020-04-26D,Race(8),1.65,1.55
1,0,0,2,2,0,0,0,0,1,2,1,4,1,2,3,6,16,19,0.0,M2020-04-26D,Race(9),19,20
2,4,0,2,6,1,0,3,4,1,1,3,5,6,1,8,15,15,15,0.0,M2020-04-26D,Race(9),16,15
8,0,0,0,0,0,0,0,0,0,0,0,0,0,0,0,0,81,81,0.0,M2020-04-26D,Race(9),81,91
14,0,0,0,0,0,0,0,0,0,0,0,0,0,0,0,0,91,151,0.0,M2020-04-26D,Race(9),101,126
4,14,10,4,28,17,10,2,29,19,3,4,26,50,23,10,83,2.65,2.5,1.0,M2020-04-26D,Race(9),2.6,2.5
9,0,0,0,0,0,0,0,0,0,0,0,0,0,0,0,0,71,91,0.0,M2020-04-26D,Race(9),91,101
5,0,0,0,0,0,0,0,0,0,0,0,0,0,0,0,0,61,67,0.0,M2020-04-26D,Race(9),61,71
6,0,0,3,3,10,1,4,15,2,2,2,6,12,3,9,24,8.5,9.5,0.0,M2020-04-26D,Race(9),9,8.5
7,10,8,7,25,0,7,8,15,1,4,12,17,11,19,27,57,3.8,3.6,3.0,M2020-04-26D,Race(9),3.6,3.5
12,2,5,3,10,2,9,12,23,2,10,4,16,6,24,19,49,8.5,8.5,0.0,M2020-04-26D,Race(9),9,10
11,0,2,0,2,0,1,0,1,0,2,0,2,0,5,0,5,8.5,11,2.0,M2020-04-26D,Race(9),11,12
10,0,3,6,9,0,1,1,2,0,2,0,2,0,6,7,13,20,26,0.0,M2020-04-26D,Race(9),19,18
3,0,2,3,5,0,1,0,1,0,0,0,0,0,3,3,6,19,21,0.0,M2020-04-26D,Race(9),21,23
13,0,0,0,0,0,0,0,0,0,0,0,0,0,0,0,0,20,26,0.0,M2020-04-26D,Race(9),23,23
